"DATA/CZAS";"TYP";"ZLECENIE#";"TRANSAKCJA#";"ZLECENIE POWIĄZANE#";"INSTRUMENT";"JEDNOSTKI/IL.";"CENA";"TOLERANCJA CENA";"STOP LOSS";"TAKE PROFIT";"DEPOZYT ZABEZPIECZAJĄCY (PLN)";"KURS WYMIANY";"WARTOŚĆ POZYCJI (PLN)";"ZAKSIĘGOWANA KWOTA (PLN)";"SALDO (PLN)";"WARTOŚĆ WYŁĄCZAJĄC OPŁATĘ";"OPŁATA";"KOSZTY UTRZYMANIA POZYCJI - WARTOŚĆ POZYCJI";"STAWKA ZA UTRZYMANIE POZYCJI";"KOSZTY UTRZYMANIA POZYCJI (PLN)";"KOSZTY UTRZYMANIA POZYCJI - SUMA (PLN)";"OPŁATA";"ZWROT %";"KIERUNEK";"WYPŁATA GDY ZYSK";"WYPŁATA GDY BEZ ZMIANY";"OTWARCIE";"WYGAŚNIĘCIE";"ROZLICZENIE";"CENA ROZLICZENIA";"WYNIK";"WYPŁATA";"TYP";"WYGAŚNIĘCIE";"CENA WYKONAWCZA";"ROZLICZENIE";"CENA ROZLICZENIA";"ZYSK";"STRATA"
"28 List 2024 23:27:36";"Transakcja Sprzedaży";"O2-DC-9D08VV";"T2-DC-5P7GCB";"-";"USD/JPY";"44 000 Jednost.";"151,512";"-";"-";"-";"-";"4,101546";"180 468,02";"0,00";"-";"-";"-";"-";"-";"-";"-";"-";"-";"-";"-";"-";"-";"-";"-";"-";"-";"-";"-";"-";"-";"-";"-";"-";"-"
"28 List 2024 23:02:06";"Koszty Utrzymania Pozycji";"1391698115";"-";"-";"Rachunek";"-";"-";"-";"-";"-";"-";"-";"-";"-52,44";"29 624,27";"-";"-";"-";"-";"-";"-52,44";"-";"-";"-";"-";"-";"-";"-";"-";"-";"-";"-";"-";"-";"-";"-";"-";"-";"-"
"28 List 2024 23:02:06";"Koszty Utrzymania Pozycji";"O2-DC-9CW8WR";"-";"-";"USD/JPY";"-";"-";"-";"-";"-";"-";"-";"-";"-";"-";"-";"-";"90 000,00";"5,53252%";"-55,94";"0,00";"-";"-";"-";"-";"-";"-";"-";"-";"-";"-";"-";"-";"-";"-";"-";"-";"-";"-"
"28 List 2024 23:02:06";"Koszty Utrzymania Pozycji";"O2-DC-9CX5JR";"-";"-";"USD/JPY";"-";"-";"-";"-";"-";"-";"-";"-";"-";"-";"-";"-";"14 000,00";"5,53252%";"-8,70";"0,00";"-";"-";"-";"-";"-";"-";"-";"-";"-";"-";"-";"-";"-";"-";"-";"-";"-";"-"
"28 List 2024 23:02:06";"Koszty Utrzymania Pozycji";"O2-DB-9C9X8L";"-";"-";"USD/JPY";"-";"-";"-";"-";"-";"-";"-";"-";"-";"-";"-";"-";"20 000,00";"3,47811%";"7,74";"0,00";"-";"-";"-";"-";"-";"-";"-";"-";"-";"-";"-";"-";"-";"-";"-";"-";"-";"-"
"28 List 2024 23:02:06";"Koszty Utrzymania Pozycji";"O2-DB-9CQYNM";"-";"-";"USD/JPY";"-";"-";"-";"-";"-";"-";"-";"-";"-";"-";"-";"-";"100 000,00";"3,47811%";"38,69";"0,00";"-";"-";"-";"-";"-";"-";"-";"-";"-";"-";"-";"-";"-";"-";"-";"-";"-";"-"
"28 List 2024 23:02:06";"Koszty Utrzymania Pozycji";"O2-DC-9CTNWE";"-";"-";"USD/JPY";"-";"-";"-";"-";"-";"-";"-";"-";"-";"-";"-";"-";"100 000,00";"3,47811%";"38,69";"0,00";"-";"-";"-";"-";"-";"-";"-";"-";"-";"-";"-";"-";"-";"-";"-";"-";"-";"-"
"28 List 2024 23:02:06";"Koszty Utrzymania Pozycji";"O2-D9-9BS5RZ";"-";"-";"USD/JPY";"-";"-";"-";"-";"-";"-";"-";"-";"-";"-";"-";"-";"22 000,00";"5,53252%";"-13,68";"0,00";"-";"-";"-";"-";"-";"-";"-";"-";"-";"-";"-";"-";"-";"-";"-";"-";"-";"-"
"28 List 2024 23:02:06";"Koszty Utrzymania Pozycji";"O2-DB-9CKXH9";"-";"-";"USD/JPY";"-";"-";"-";"-";"-";"-";"-";"-";"-";"-";"-";"-";"90 000,00";"3,47811%";"34,82";"0,00";"-";"-";"-";"-";"-";"-";"-";"-";"-";"-";"-";"-";"-";"-";"-";"-";"-";"-"
"28 List 2024 23:02:06";"Koszty Utrzymania Pozycji";"O2-DB-9C9XVJ";"-";"-";"USD/JPY";"-";"-";"-";"-";"-";"-";"-";"-";"-";"-";"-";"-";"30 000,00";"3,47811%";"11,61";"0,00";"-";"-";"-";"-";"-";"-";"-";"-";"-";"-";"-";"-";"-";"-";"-";"-";"-";"-"
"28 List 2024 23:02:06";"Koszty Utrzymania Pozycji";"O2-DC-9CYZSX";"-";"-";"USD/JPY";"-";"-";"-";"-";"-";"-";"-";"-";"-";"-";"-";"-";"70 000,00";"5,53252%";"-43,51";"0,00";"-";"-";"-";"-";"-";"-";"-";"-";"-";"-";"-";"-";"-";"-";"-";"-";"-";"-"
"28 List 2024 23:02:06";"Koszty Utrzymania Pozycji";"O2-DC-9CWHJE";"-";"-";"USD/JPY";"-";"-";"-";"-";"-";"-";"-";"-";"-";"-";"-";"-";"100 000,00";"5,53252%";"-62,16";"0,00";"-";"-";"-";"-";"-";"-";"-";"-";"-";"-";"-";"-";"-";"-";"-";"-";"-";"-"
"28 List 2024 16:09:46";"Stop Loss";"O2-DC-9D0101";"T2-DC-5P7B2Q";"-";"USD/JPY";"80 000 Jednost.";"151,460";"-";"-";"-";"-";"0,026797";"327 937,76";"124,34";"29 676,71";"-";"-";"-";"-";"-";"-";"-";"-";"-";"-";"-";"-";"-";"-";"-";"-";"-";"-";"-";"-";"-";"-";"-";"-"
"28 List 2024 16:09:41";"Zmodyfikowano Stop Loss";"O2-DC-9D0101";"-";"O2-DC-9D02GC";"USD/JPY";"80 000 Jednost.";"151,518";"-";"151,460";"-";"-";"-";"-";"-";"-";"-";"-";"-";"-";"-";"-";"-";"-";"-";"-";"-";"-";"-";"-";"-";"-";"-";"-";"-";"-";"-";"-";"-";"-"
"28 List 2024 16:07:52";"Zmodyfikowano Stop Loss";"O2-DC-9D0101";"-";"O2-DC-9D02GC";"USD/JPY";"80 000 Jednost.";"151,518";"-";"151,480";"-";"-";"-";"-";"-";"-";"-";"-";"-";"-";"-";"-";"-";"-";"-";"-";"-";"-";"-";"-";"-";"-";"-";"-";"-";"-";"-";"-";"-";"-"
"28 List 2024 16:06:47";"Zmodyfikowano Transakcję Sprzedaży";"O2-DC-9D0101";"T2-DC-5P78R9";"-";"USD/JPY";"80 000 Jednost.";"151,518";"-";"151,490";"-";"-";"-";"-";"0,00";"-";"-";"-";"-";"-";"-";"-";"-";"-";"-";"-";"-";"-";"-";"-";"-";"-";"-";"-";"-";"-";"-";"-";"-";"-"
"28 List 2024 15:36:42";"Transakcja Sprzedaży";"O2-DC-9D0101";"T2-DC-5P78R9";"-";"USD/JPY";"80 000 Jednost.";"151,518";"-";"-";"-";"-";"4,107238";"328 579,04";"0,00";"-";"-";"-";"-";"-";"-";"-";"-";"-";"-";"-";"-";"-";"-";"-";"-";"-";"-";"-";"-";"-";"-";"-";"-";"-"
"28 List 2024 15:32:18";"Stop Loss";"O2-DC-9D00L5";"T2-DC-5P78LC";"-";"USD/JPY";"80 000 Jednost.";"151,510";"-";"-";"-";"-";"0,026831";"328 466,80";"42,93";"29 552,37";"-";"-";"-";"-";"-";"-";"-";"-";"-";"-";"-";"-";"-";"-";"-";"-";"-";"-";"-";"-";"-";"-";"-";"-"
"28 List 2024 15:32:05";"Zmodyfikowano Transakcję Sprzedaży";"O2-DC-9D00L5";"T2-DC-5P78E4";"-";"USD/JPY";"80 000 Jednost.";"151,530";"-";"151,510";"-";"-";"-";"-";"0,00";"-";"-";"-";"-";"-";"-";"-";"-";"-";"-";"-";"-";"-";"-";"-";"-";"-";"-";"-";"-";"-";"-";"-";"-";"-"
"28 List 2024 15:29:49";"Transakcja Sprzedaży";"O2-DC-9D00L5";"T2-DC-5P78E4";"-";"USD/JPY";"80 000 Jednost.";"151,530";"-";"-";"-";"-";"4,106717";"328 537,36";"0,00";"-";"-";"-";"-";"-";"-";"-";"-";"-";"-";"-";"-";"-";"-";"-";"-";"-";"-";"-";"-";"-";"-";"-";"-";"-"
"28 List 2024 15:24:20";" Zamknięcie Transakcji";"O2-DC-9D00EC";"T2-DC-5P788M";"O2-DC-9CZZDW";"USD/JPY";"80 000 Jednost.";"151,602";"-";"-";"-";"-";"0,026841";"328 770,56";"73,01";"29 509,44";"-";"-";"-";"-";"-";"-";"-";"-";"-";"-";"-";"-";"-";"-";"-";"-";"-";"-";"-";"-";"-";"-";"-";"-"
"28 List 2024 14:57:57";"Zmodyfikowano Transakcję Sprzedaży";"O2-DC-9CZZDW";"T2-DC-5P77FV";"-";"USD/JPY";"80 000 Jednost.";"151,636";"-";"151,630";"-";"-";"-";"-";"0,00";"-";"-";"-";"-";"-";"-";"-";"-";"-";"-";"-";"-";"-";"-";"-";"-";"-";"-";"-";"-";"-";"-";"-";"-";"-"
"28 List 2024 14:53:52";"Transakcja Sprzedaży";"O2-DC-9CZZDW";"T2-DC-5P77FV";"-";"USD/JPY";"80 000 Jednost.";"151,636";"-";"-";"-";"-";"4,112548";"329 003,84";"0,00";"-";"-";"-";"-";"-";"-";"-";"-";"-";"-";"-";"-";"-";"-";"-";"-";"-";"-";"-";"-";"-";"-";"-";"-";"-"
"28 List 2024 14:48:42";"Stop Loss";"O2-DC-9CZY10";"T2-DC-5P77C4";"-";"USD/JPY";"80 000 Jednost.";"151,654";"-";"-";"-";"-";"0,026846";"328 914,88";"15,03";"29 436,43";"-";"-";"-";"-";"-";"-";"-";"-";"-";"-";"-";"-";"-";"-";"-";"-";"-";"-";"-";"-";"-";"-";"-";"-"
"28 List 2024 14:46:35";"Zmodyfikowano Transakcję Sprzedaży";"O2-DC-9CZY10";"T2-DC-5P76C2";"-";"USD/JPY";"80 000 Jednost.";"151,661";"-";"151,650";"-";"-";"-";"-";"0,00";"-";"-";"-";"-";"-";"-";"-";"-";"-";"-";"-";"-";"-";"-";"-";"-";"-";"-";"-";"-";"-";"-";"-";"-";"-"
"28 List 2024 14:10:16";"Transakcja Sprzedaży";"O2-DC-9CZY10";"T2-DC-5P76C2";"-";"USD/JPY";"80 000 Jednost.";"151,661";"-";"-";"-";"-";"4,108811";"328 704,88";"0,00";"-";"-";"-";"-";"-";"-";"-";"-";"-";"-";"-";"-";"-";"-";"-";"-";"-";"-";"-";"-";"-";"-";"-";"-";"-"
"28 List 2024 13:54:35";" Zamknięcie Transakcji";"O2-DC-9CZXN2";"T2-DC-5P7619";"O2-DC-9CZTRG";"USD/JPY";"80 000 Jednost.";"151,760";"-";"-";"-";"-";"0,026798";"328 616,72";"2,14";"29 421,40";"-";"-";"-";"-";"-";"-";"-";"-";"-";"-";"-";"-";"-";"-";"-";"-";"-";"-";"-";"-";"-";"-";"-";"-"
"28 List 2024 12:05:40";"Transakcja Sprzedaży";"O2-DC-9CZTRG";"T2-DC-5P73VH";"-";"USD/JPY";"80 000 Jednost.";"151,761";"-";"-";"-";"-";"4,10818";"328 654,40";"0,00";"-";"-";"-";"-";"-";"-";"-";"-";"-";"-";"-";"-";"-";"-";"-";"-";"-";"-";"-";"-";"-";"-";"-";"-";"-"
"28 List 2024 09:46:36";" Zamknięcie Transakcji";"O2-DC-9CZN8P";"T2-DC-5P6ZE4";"O2-DC-9CXB58";"USD/JPY";"5 000 Jednost.";"151,874";"-";"-";"-";"-";"0,026745";"20 513,59";"107,78";"29 419,26";"-";"-";"-";"-";"-";"-";"-";"-";"-";"-";"-";"-";"-";"-";"-";"-";"-";"-";"-";"-";"-";"-";"-";"-"
"28 List 2024 08:46:48";" Zamknięcie Transakcji";"O2-DC-9CZK69";"T2-DC-5P6WXG";"O2-DC-9CXB58";"USD/JPY";"5 000 Jednost.";"151,752";"-";"-";"-";"-";"0,026819";"20 552,77";"124,44";"29 311,48";"-";"-";"-";"-";"-";"-";"-";"-";"-";"-";"-";"-";"-";"-";"-";"-";"-";"-";"-";"-";"-";"-";"-";"-"
"28 List 2024 08:46:22";" Zamknięcie Transakcji";"O2-DC-9CZK5P";"T2-DC-5P6WX0";"O2-DC-9CXB58";"USD/JPY";"4 000 Jednost.";"151,741";"-";"-";"-";"-";"0,026815";"16 439,85";"100,72";"29 187,04";"-";"-";"-";"-";"-";"-";"-";"-";"-";"-";"-";"-";"-";"-";"-";"-";"-";"-";"-";"-";"-";"-";"-";"-"
"28 List 2024 08:03:00";" Zamknięcie Transakcji";"O2-DC-9CZHVW";"T2-DC-5P6VT7";"O2-DC-9CXB58";"USD/JPY";"6 000 Jednost.";"151,631";"-";"-";"-";"-";"0,026812";"24 639,51";"168,75";"29 086,32";"-";"-";"-";"-";"-";"-";"-";"-";"-";"-";"-";"-";"-";"-";"-";"-";"-";"-";"-";"-";"-";"-";"-";"-"
"28 List 2024 08:01:29";" Zamknięcie Transakcji";"O2-DC-9CZHTD";"T2-DC-5P6VS7";"O2-DC-9CXB58";"USD/JPY";"50 000 Jednost.";"151,575";"-";"-";"-";"-";"0,026815";"205 273,70";"1 481,53";"28 917,57";"-";"-";"-";"-";"-";"-";"-";"-";"-";"-";"-";"-";"-";"-";"-";"-";"-";"-";"-";"-";"-";"-";"-";"-"
"28 List 2024 07:57:51";"Stop Loss";"O2-DC-9CYR48";"T2-DC-5P6VNM";"-";"USD/JPY";"60 000 Jednost.";"151,550";"-";"-";"-";"-";"0,02681";"246 258,72";"963,55";"27 436,04";"-";"-";"-";"-";"-";"-";"-";"-";"-";"-";"-";"-";"-";"-";"-";"-";"-";"-";"-";"-";"-";"-";"-";"-"
"28 List 2024 07:56:54";"Zmodyfikowano Stop Loss";"O2-DC-9CYR48";"-";"O2-DC-9CZHNC";"USD/JPY";"60 000 Jednost.";"150,951";"-";"151,550";"-";"-";"-";"-";"-";"-";"-";"-";"-";"-";"-";"-";"-";"-";"-";"-";"-";"-";"-";"-";"-";"-";"-";"-";"-";"-";"-";"-";"-";"-"
"28 List 2024 07:56:28";"Zmodyfikowano Stop Loss";"O2-DC-9CYR48";"-";"O2-DC-9CZHNC";"USD/JPY";"60 000 Jednost.";"150,951";"-";"151,530";"-";"-";"-";"-";"-";"-";"-";"-";"-";"-";"-";"-";"-";"-";"-";"-";"-";"-";"-";"-";"-";"-";"-";"-";"-";"-";"-";"-";"-";"-"
"28 List 2024 07:55:49";" Zmodyfikowano Transakcję Kupna";"O2-DC-9CYR48";"T2-DC-5P66KJ";"-";"USD/JPY";"60 000 Jednost.";"150,951";"-";"151,520";"-";"-";"-";"-";"0,00";"-";"-";"-";"-";"-";"-";"-";"-";"-";"-";"-";"-";"-";"-";"-";"-";"-";"-";"-";"-";"-";"-";"-";"-";"-"
"28 List 2024 07:54:34";" Zamknięcie Transakcji";"O2-DC-9CZHMY";"T2-DC-5P6VMB";"O2-D9-9BB04B";"USD/JPY";"34 000 Jednost.";"151,519";"-";"-";"-";"-";"0,026818";"139 543,20";"269,90";"26 472,49";"-";"-";"-";"-";"-";"-";"-";"-";"-";"-";"-";"-";"-";"-";"-";"-";"-";"-";"-";"-";"-";"-";"-";"-"
"28 List 2024 07:54:22";" Zamknięcie Transakcji";"O2-DC-9CZHMX";"T2-DC-5P6VM9";"O2-D9-9BJZX7";"USD/JPY";"30 000 Jednost.";"151,521";"-";"-";"-";"-";"0,026817";"123 118,23";"353,18";"26 202,59";"-";"-";"-";"-";"-";"-";"-";"-";"-";"-";"-";"-";"-";"-";"-";"-";"-";"-";"-";"-";"-";"-";"-";"-"
"27 List 2024 23:02:03";"Koszty Utrzymania Pozycji";"1391489095";"-";"-";"Rachunek";"-";"-";"-";"-";"-";"-";"-";"-";"-336,89";"25 849,41";"-";"-";"-";"-";"-";"-336,89";"-";"-";"-";"-";"-";"-";"-";"-";"-";"-";"-";"-";"-";"-";"-";"-";"-";"-"
"27 List 2024 23:02:03";"Koszty Utrzymania Pozycji";"O2-DC-9CW8WR";"-";"-";"USD/JPY";"-";"-";"-";"-";"-";"-";"-";"-";"-";"-";"-";"-";"90 000,00";"5,53252%";"-167,49";"0,00";"-";"-";"-";"-";"-";"-";"-";"-";"-";"-";"-";"-";"-";"-";"-";"-";"-";"-"
"27 List 2024 23:02:03";"Koszty Utrzymania Pozycji";"O2-DC-9CX5JR";"-";"-";"USD/JPY";"-";"-";"-";"-";"-";"-";"-";"-";"-";"-";"-";"-";"14 000,00";"5,53252%";"-26,05";"0,00";"-";"-";"-";"-";"-";"-";"-";"-";"-";"-";"-";"-";"-";"-";"-";"-";"-";"-"
"27 List 2024 23:02:03";"Koszty Utrzymania Pozycji";"O2-D9-9BJZX7";"-";"-";"USD/JPY";"-";"-";"-";"-";"-";"-";"-";"-";"-";"-";"-";"-";"30 000,00";"5,53252%";"-55,83";"0,00";"-";"-";"-";"-";"-";"-";"-";"-";"-";"-";"-";"-";"-";"-";"-";"-";"-";"-"
"27 List 2024 23:02:03";"Koszty Utrzymania Pozycji";"O2-D9-9BB04B";"-";"-";"USD/JPY";"-";"-";"-";"-";"-";"-";"-";"-";"-";"-";"-";"-";"34 000,00";"5,53252%";"-63,27";"0,00";"-";"-";"-";"-";"-";"-";"-";"-";"-";"-";"-";"-";"-";"-";"-";"-";"-";"-"
"27 List 2024 23:02:03";"Koszty Utrzymania Pozycji";"O2-DB-9C9X8L";"-";"-";"USD/JPY";"-";"-";"-";"-";"-";"-";"-";"-";"-";"-";"-";"-";"20 000,00";"3,47811%";"23,17";"0,00";"-";"-";"-";"-";"-";"-";"-";"-";"-";"-";"-";"-";"-";"-";"-";"-";"-";"-"
"27 List 2024 23:02:03";"Koszty Utrzymania Pozycji";"O2-DB-9CQYNM";"-";"-";"USD/JPY";"-";"-";"-";"-";"-";"-";"-";"-";"-";"-";"-";"-";"100 000,00";"3,47811%";"115,83";"0,00";"-";"-";"-";"-";"-";"-";"-";"-";"-";"-";"-";"-";"-";"-";"-";"-";"-";"-"
"27 List 2024 23:02:03";"Koszty Utrzymania Pozycji";"O2-DC-9CYR48";"-";"-";"USD/JPY";"-";"-";"-";"-";"-";"-";"-";"-";"-";"-";"-";"-";"60 000,00";"3,47811%";"69,50";"0,00";"-";"-";"-";"-";"-";"-";"-";"-";"-";"-";"-";"-";"-";"-";"-";"-";"-";"-"
"27 List 2024 23:02:03";"Koszty Utrzymania Pozycji";"O2-DC-9CTNWE";"-";"-";"USD/JPY";"-";"-";"-";"-";"-";"-";"-";"-";"-";"-";"-";"-";"100 000,00";"3,47811%";"115,83";"0,00";"-";"-";"-";"-";"-";"-";"-";"-";"-";"-";"-";"-";"-";"-";"-";"-";"-";"-"
"27 List 2024 23:02:03";"Koszty Utrzymania Pozycji";"O2-DC-9CXB58";"-";"-";"USD/JPY";"-";"-";"-";"-";"-";"-";"-";"-";"-";"-";"-";"-";"70 000,00";"5,53252%";"-130,27";"0,00";"-";"-";"-";"-";"-";"-";"-";"-";"-";"-";"-";"-";"-";"-";"-";"-";"-";"-"
"27 List 2024 23:02:03";"Koszty Utrzymania Pozycji";"O2-D9-9BS5RZ";"-";"-";"USD/JPY";"-";"-";"-";"-";"-";"-";"-";"-";"-";"-";"-";"-";"22 000,00";"5,53252%";"-40,94";"0,00";"-";"-";"-";"-";"-";"-";"-";"-";"-";"-";"-";"-";"-";"-";"-";"-";"-";"-"
"27 List 2024 23:02:03";"Koszty Utrzymania Pozycji";"O2-DB-9CKXH9";"-";"-";"USD/JPY";"-";"-";"-";"-";"-";"-";"-";"-";"-";"-";"-";"-";"90 000,00";"3,47811%";"104,25";"0,00";"-";"-";"-";"-";"-";"-";"-";"-";"-";"-";"-";"-";"-";"-";"-";"-";"-";"-"
"27 List 2024 23:02:03";"Koszty Utrzymania Pozycji";"O2-DB-9C9XVJ";"-";"-";"USD/JPY";"-";"-";"-";"-";"-";"-";"-";"-";"-";"-";"-";"-";"30 000,00";"3,47811%";"34,75";"0,00";"-";"-";"-";"-";"-";"-";"-";"-";"-";"-";"-";"-";"-";"-";"-";"-";"-";"-"
"27 List 2024 23:02:03";"Koszty Utrzymania Pozycji";"O2-DC-9CYZSX";"-";"-";"USD/JPY";"-";"-";"-";"-";"-";"-";"-";"-";"-";"-";"-";"-";"70 000,00";"5,53252%";"-130,27";"0,00";"-";"-";"-";"-";"-";"-";"-";"-";"-";"-";"-";"-";"-";"-";"-";"-";"-";"-"
"27 List 2024 23:02:03";"Koszty Utrzymania Pozycji";"O2-DC-9CWHJE";"-";"-";"USD/JPY";"-";"-";"-";"-";"-";"-";"-";"-";"-";"-";"-";"-";"100 000,00";"5,53252%";"-186,10";"0,00";"-";"-";"-";"-";"-";"-";"-";"-";"-";"-";"-";"-";"-";"-";"-";"-";"-";"-"
"27 List 2024 19:45:14";"Transakcja Sprzedaży";"O2-DC-9CYZSX";"T2-DC-5P6ED9";"-";"USD/JPY";"70 000 Jednost.";"150,812";"-";"-";"-";"-";"4,091326";"286 392,82";"0,00";"-";"-";"-";"-";"-";"-";"-";"-";"-";"-";"-";"-";"-";"-";"-";"-";"-";"-";"-";"-";"-";"-";"-";"-";"-"
"27 List 2024 19:38:18";"Stop Loss";"O2-DC-9CYZ4M";"T2-DC-5P6E4L";"-";"USD/JPY";"61 000 Jednost.";"150,750";"-";"-";"-";"-";"0,026861";"249 494,45";"34,41";"26 186,30";"-";"-";"-";"-";"-";"-";"-";"-";"-";"-";"-";"-";"-";"-";"-";"-";"-";"-";"-";"-";"-";"-";"-";"-"
"27 List 2024 19:38:18";"Stop Loss";"O2-DC-9CYZ47";"T2-DC-5P6E4K";"-";"USD/JPY";"7 000 Jednost.";"150,750";"-";"-";"-";"-";"0,026861";"28 630,51";"6,77";"26 151,89";"-";"-";"-";"-";"-";"-";"-";"-";"-";"-";"-";"-";"-";"-";"-";"-";"-";"-";"-";"-";"-";"-";"-";"-"
"27 List 2024 19:37:42";"Zmodyfikowano Transakcję Sprzedaży";"O2-DC-9CYZ4M";"T2-DC-5P6DRL";"-";"USD/JPY";"61 000 Jednost.";"150,771";"-";"150,750";"-";"-";"-";"-";"0,00";"-";"-";"-";"-";"-";"-";"-";"-";"-";"-";"-";"-";"-";"-";"-";"-";"-";"-";"-";"-";"-";"-";"-";"-";"-"
"27 List 2024 19:37:22";"Zmodyfikowano Transakcję Sprzedaży";"O2-DC-9CYZ47";"T2-DC-5P6DR7";"-";"USD/JPY";"7 000 Jednost.";"150,786";"-";"150,750";"-";"-";"-";"-";"0,00";"-";"-";"-";"-";"-";"-";"-";"-";"-";"-";"-";"-";"-";"-";"-";"-";"-";"-";"-";"-";"-";"-";"-";"-";"-"
"27 List 2024 19:30:32";"Transakcja Sprzedaży";"O2-DC-9CYZ4M";"T2-DC-5P6DRL";"-";"USD/JPY";"61 000 Jednost.";"150,771";"-";"-";"-";"-";"4,091176";"249 561,73";"0,00";"-";"-";"-";"-";"-";"-";"-";"-";"-";"-";"-";"-";"-";"-";"-";"-";"-";"-";"-";"-";"-";"-";"-";"-";"-"
"27 List 2024 19:30:17";"Transakcja Sprzedaży";"O2-DC-9CYZ47";"T2-DC-5P6DR7";"-";"USD/JPY";"7 000 Jednost.";"150,786";"-";"-";"-";"-";"4,091526";"28 640,68";"0,00";"-";"-";"-";"-";"-";"-";"-";"-";"-";"-";"-";"-";"-";"-";"-";"-";"-";"-";"-";"-";"-";"-";"-";"-";"-"
"27 List 2024 17:35:30";" Transakcja Kupna";"O2-DC-9CYR48";"T2-DC-5P66KJ";"-";"USD/JPY";"60 000 Jednost.";"150,951";"-";"-";"-";"-";"4,093901";"245 634,06";"0,00";"-";"-";"-";"-";"-";"-";"-";"-";"-";"-";"-";"-";"-";"-";"-";"-";"-";"-";"-";"-";"-";"-";"-";"-";"-"
"27 List 2024 17:17:03";" Zamknięcie Transakcji";"O2-DC-9CYPYN";"T2-DC-5P65KM";"O2-DC-9CXXPP";"USD/JPY";"20 000 Jednost.";"151,335";"-";"-";"-";"-";"0,026808";"81 956,58";"58,98";"26 145,12";"-";"-";"-";"-";"-";"-";"-";"-";"-";"-";"-";"-";"-";"-";"-";"-";"-";"-";"-";"-";"-";"-";"-";"-"
"27 List 2024 17:03:42";"Stop Loss";"O2-DC-9CYMP3";"T2-DC-5P64QP";"-";"USD/JPY";"70 000 Jednost.";"151,280";"-";"-";"-";"-";"0,026807";"286 755,42";"82,57";"26 086,14";"-";"-";"-";"-";"-";"-";"-";"-";"-";"-";"-";"-";"-";"-";"-";"-";"-";"-";"-";"-";"-";"-";"-";"-"
"27 List 2024 17:03:29";" Zmodyfikowano Transakcję Kupna";"O2-DC-9CYMP3";"T2-DC-5P63L6";"-";"USD/JPY";"70 000 Jednost.";"151,236";"-";"151,280";"-";"-";"-";"-";"0,00";"-";"-";"-";"-";"-";"-";"-";"-";"-";"-";"-";"-";"-";"-";"-";"-";"-";"-";"-";"-";"-";"-";"-";"-";"-"
"27 List 2024 16:52:22";" Transakcja Kupna";"O2-DC-9CYMP3";"T2-DC-5P63L6";"-";"USD/JPY";"70 000 Jednost.";"151,236";"-";"-";"-";"-";"4,097208";"286 804,56";"0,00";"-";"-";"-";"-";"-";"-";"-";"-";"-";"-";"-";"-";"-";"-";"-";"-";"-";"-";"-";"-";"-";"-";"-";"-";"-"
"27 List 2024 16:18:01";"Stop Loss";"O2-DC-9CYHDK";"T2-DC-5P6072";"-";"USD/JPY";"70 000 Jednost.";"151,760";"-";"-";"-";"-";"0,026811";"287 696,71";"20,64";"26 003,57";"-";"-";"-";"-";"-";"-";"-";"-";"-";"-";"-";"-";"-";"-";"-";"-";"-";"-";"-";"-";"-";"-";"-";"-"
"27 List 2024 16:17:21";" Zmodyfikowano Transakcję Kupna";"O2-DC-9CYHDK";"T2-DC-5P5ZZE";"-";"USD/JPY";"70 000 Jednost.";"151,749";"-";"151,760";"-";"-";"-";"-";"0,00";"-";"-";"-";"-";"-";"-";"-";"-";"-";"-";"-";"-";"-";"-";"-";"-";"-";"-";"-";"-";"-";"-";"-";"-";"-"
"27 List 2024 16:16:22";" Transakcja Kupna";"O2-DC-9CYHDK";"T2-DC-5P5ZZE";"-";"USD/JPY";"70 000 Jednost.";"151,749";"-";"-";"-";"-";"4,109953";"287 696,71";"0,00";"-";"-";"-";"-";"-";"-";"-";"-";"-";"-";"-";"-";"-";"-";"-";"-";"-";"-";"-";"-";"-";"-";"-";"-";"-"
"27 List 2024 10:55:35";"Transakcja Sprzedaży";"O2-DC-9CXXPP";"T2-DC-5P5H18";"-";"USD/JPY";"20 000 Jednost.";"151,445";"-";"-";"-";"-";"4,117178";"82 343,56";"0,00";"-";"-";"-";"-";"-";"-";"-";"-";"-";"-";"-";"-";"-";"-";"-";"-";"-";"-";"-";"-";"-";"-";"-";"-";"-"
"27 List 2024 10:43:04";"Stop Loss";"O2-DC-9CXQ0X";"T2-DC-5P5GGX";"-";"USD/JPY";"20 000 Jednost.";"151,490";"-";"-";"-";"-";"0,026895";"82 291,04";"23,13";"25 982,93";"-";"-";"-";"-";"-";"-";"-";"-";"-";"-";"-";"-";"-";"-";"-";"-";"-";"-";"-";"-";"-";"-";"-";"-"
"27 List 2024 10:42:37";"Zmodyfikowano Transakcję Sprzedaży";"O2-DC-9CXQ0X";"T2-DC-5P5BE5";"-";"USD/JPY";"20 000 Jednost.";"151,533";"-";"151,490";"-";"-";"-";"-";"0,00";"-";"-";"-";"-";"-";"-";"-";"-";"-";"-";"-";"-";"-";"-";"-";"-";"-";"-";"-";"-";"-";"-";"-";"-";"-"
"27 List 2024 09:21:04";"Transakcja Sprzedaży";"O2-DC-9CXQ0X";"T2-DC-5P5BE5";"-";"USD/JPY";"20 000 Jednost.";"151,533";"-";"-";"-";"-";"4,101376";"82 027,52";"0,00";"-";"-";"-";"-";"-";"-";"-";"-";"-";"-";"-";"-";"-";"-";"-";"-";"-";"-";"-";"-";"-";"-";"-";"-";"-"
"27 List 2024 09:18:08";" Zamknięcie Transakcji";"O2-DC-9CXPMD";"T2-DC-5P59ZE";"O2-DC-9CXNSF";"USD/JPY";"20 000 Jednost.";"151,566";"-";"-";"-";"-";"0,026853";"82 229,92";"5,91";"25 959,80";"-";"-";"-";"-";"-";"-";"-";"-";"-";"-";"-";"-";"-";"-";"-";"-";"-";"-";"-";"-";"-";"-";"-";"-"
"27 List 2024 09:08:15";"Transakcja Sprzedaży";"O2-DC-9CXNSF";"T2-DC-5P59BK";"-";"USD/JPY";"20 000 Jednost.";"151,577";"-";"-";"-";"-";"4,113159";"82 263,18";"0,00";"-";"-";"-";"-";"-";"-";"-";"-";"-";"-";"-";"-";"-";"-";"-";"-";"-";"-";"-";"-";"-";"-";"-";"-";"-"
"27 List 2024 09:07:31";"Odrzucono Zlecenie: brak wystarczających środków";"O2-DC-9CXNPY";"-";"-";"USD/JPY";"30 000 Jednost.";"-";"-";"-";"-";"-";"-";"-";"-";"-";"-";"-";"-";"-";"-";"-";"-";"-";"-";"-";"-";"-";"-";"-";"-";"-";"-";"-";"-";"-";"-";"-";"-";"-"
"27 List 2024 02:36:35";" Zmodyfikowano Transakcję Kupna";"O2-DC-9CTNWE";"T2-DC-5P2R5Y";"-";"USD/JPY";"100 000 Jednost.";"154,369";"-";"-";"-";"-";"-";"-";"0,00";"-";"-";"-";"-";"-";"-";"-";"-";"-";"-";"-";"-";"-";"-";"-";"-";"-";"-";"-";"-";"-";"-";"-";"-";"-"
"27 List 2024 02:36:06";"Transakcja Sprzedaży";"O2-DC-9CXB58";"T2-DC-5P4ZE2";"-";"USD/JPY";"70 000 Jednost.";"152,680";"-";"-";"-";"-";"4,124592";"288 721,44";"0,00";"-";"-";"-";"-";"-";"-";"-";"-";"-";"-";"-";"-";"-";"-";"-";"-";"-";"-";"-";"-";"-";"-";"-";"-";"-"
"26 List 2024 23:02:09";"Koszty Utrzymania Pozycji";"1391158258";"-";"-";"Rachunek";"-";"-";"-";"-";"-";"-";"-";"-";"-49,02";"25 953,89";"-";"-";"-";"-";"-";"-49,02";"-";"-";"-";"-";"-";"-";"-";"-";"-";"-";"-";"-";"-";"-";"-";"-";"-";"-"
"26 List 2024 23:02:09";"Koszty Utrzymania Pozycji";"O2-DC-9CW8WR";"-";"-";"USD/JPY";"-";"-";"-";"-";"-";"-";"-";"-";"-";"-";"-";"-";"90 000,00";"5,53252%";"-56,27";"0,00";"-";"-";"-";"-";"-";"-";"-";"-";"-";"-";"-";"-";"-";"-";"-";"-";"-";"-"
"26 List 2024 23:02:09";"Koszty Utrzymania Pozycji";"O2-DC-9CX5JR";"-";"-";"USD/JPY";"-";"-";"-";"-";"-";"-";"-";"-";"-";"-";"-";"-";"14 000,00";"5,53252%";"-8,75";"0,00";"-";"-";"-";"-";"-";"-";"-";"-";"-";"-";"-";"-";"-";"-";"-";"-";"-";"-"
"26 List 2024 23:02:09";"Koszty Utrzymania Pozycji";"O2-D9-9BJZX7";"-";"-";"USD/JPY";"-";"-";"-";"-";"-";"-";"-";"-";"-";"-";"-";"-";"30 000,00";"5,53252%";"-18,76";"0,00";"-";"-";"-";"-";"-";"-";"-";"-";"-";"-";"-";"-";"-";"-";"-";"-";"-";"-"
"26 List 2024 23:02:09";"Koszty Utrzymania Pozycji";"O2-D9-9BB04B";"-";"-";"USD/JPY";"-";"-";"-";"-";"-";"-";"-";"-";"-";"-";"-";"-";"34 000,00";"5,53252%";"-21,26";"0,00";"-";"-";"-";"-";"-";"-";"-";"-";"-";"-";"-";"-";"-";"-";"-";"-";"-";"-"
"26 List 2024 23:02:09";"Koszty Utrzymania Pozycji";"O2-DB-9C9X8L";"-";"-";"USD/JPY";"-";"-";"-";"-";"-";"-";"-";"-";"-";"-";"-";"-";"20 000,00";"3,47811%";"7,78";"0,00";"-";"-";"-";"-";"-";"-";"-";"-";"-";"-";"-";"-";"-";"-";"-";"-";"-";"-"
"26 List 2024 23:02:09";"Koszty Utrzymania Pozycji";"O2-DB-9CQYNM";"-";"-";"USD/JPY";"-";"-";"-";"-";"-";"-";"-";"-";"-";"-";"-";"-";"100 000,00";"3,47811%";"38,91";"0,00";"-";"-";"-";"-";"-";"-";"-";"-";"-";"-";"-";"-";"-";"-";"-";"-";"-";"-"
"26 List 2024 23:02:09";"Koszty Utrzymania Pozycji";"O2-DC-9CTNWE";"-";"-";"USD/JPY";"-";"-";"-";"-";"-";"-";"-";"-";"-";"-";"-";"-";"100 000,00";"3,47811%";"38,91";"0,00";"-";"-";"-";"-";"-";"-";"-";"-";"-";"-";"-";"-";"-";"-";"-";"-";"-";"-"
"26 List 2024 23:02:09";"Koszty Utrzymania Pozycji";"O2-D9-9BS5RZ";"-";"-";"USD/JPY";"-";"-";"-";"-";"-";"-";"-";"-";"-";"-";"-";"-";"22 000,00";"5,53252%";"-13,75";"0,00";"-";"-";"-";"-";"-";"-";"-";"-";"-";"-";"-";"-";"-";"-";"-";"-";"-";"-"
"26 List 2024 23:02:09";"Koszty Utrzymania Pozycji";"O2-DB-9CKXH9";"-";"-";"USD/JPY";"-";"-";"-";"-";"-";"-";"-";"-";"-";"-";"-";"-";"90 000,00";"3,47811%";"35,02";"0,00";"-";"-";"-";"-";"-";"-";"-";"-";"-";"-";"-";"-";"-";"-";"-";"-";"-";"-"
"26 List 2024 23:02:09";"Koszty Utrzymania Pozycji";"O2-DB-9C9XVJ";"-";"-";"USD/JPY";"-";"-";"-";"-";"-";"-";"-";"-";"-";"-";"-";"-";"30 000,00";"3,47811%";"11,67";"0,00";"-";"-";"-";"-";"-";"-";"-";"-";"-";"-";"-";"-";"-";"-";"-";"-";"-";"-"
"26 List 2024 23:02:09";"Koszty Utrzymania Pozycji";"O2-DC-9CWHJE";"-";"-";"USD/JPY";"-";"-";"-";"-";"-";"-";"-";"-";"-";"-";"-";"-";"100 000,00";"5,53252%";"-62,52";"0,00";"-";"-";"-";"-";"-";"-";"-";"-";"-";"-";"-";"-";"-";"-";"-";"-";"-";"-"
"26 List 2024 22:40:06";"Transakcja Sprzedaży";"O2-DC-9CX5JR";"T2-DC-5P4VT8";"-";"USD/JPY";"14 000 Jednost.";"153,046";"-";"-";"-";"-";"4,123981";"57 735,73";"0,00";"-";"-";"-";"-";"-";"-";"-";"-";"-";"-";"-";"-";"-";"-";"-";"-";"-";"-";"-";"-";"-";"-";"-";"-";"-"
"26 List 2024 21:59:00";"Take Profit";"O2-DC-9CX1LS";"T2-DC-5P4TZP";"-";"USD/JPY";"100 000 Jednost.";"153,085";"-";"-";"-";"-";"0,026705";"412 967,20";"29,38";"26 002,91";"-";"-";"-";"-";"-";"-";"-";"-";"-";"-";"-";"-";"-";"-";"-";"-";"-";"-";"-";"-";"-";"-";"-";"-"
"26 List 2024 21:45:34";"Zmodyfikowano Transakcję Sprzedaży";"O2-DC-9CX1LS";"T2-DC-5P4R8G";"-";"USD/JPY";"100 000 Jednost.";"153,096";"-";"-";"153,085";"-";"-";"-";"0,00";"-";"-";"-";"-";"-";"-";"-";"-";"-";"-";"-";"-";"-";"-";"-";"-";"-";"-";"-";"-";"-";"-";"-";"-";"-"
"26 List 2024 21:00:21";"Transakcja Sprzedaży";"O2-DC-9CX1LS";"T2-DC-5P4R8G";"-";"USD/JPY";"100 000 Jednost.";"153,096";"-";"-";"-";"-";"4,134242";"413 424,20";"0,00";"-";"-";"-";"-";"-";"-";"-";"-";"-";"-";"-";"-";"-";"-";"-";"-";"-";"-";"-";"-";"-";"-";"-";"-";"-"
"26 List 2024 18:37:41";"Stop Loss";"O2-DC-9CWTJF";"T2-DC-5P4K4P";"-";"USD/JPY";"100 000 Jednost.";"153,310";"-";"-";"-";"-";"0,026712";"413 665,60";"85,48";"25 973,53";"-";"-";"-";"-";"-";"-";"-";"-";"-";"-";"-";"-";"-";"-";"-";"-";"-";"-";"-";"-";"-";"-";"-";"-"
"26 List 2024 18:37:40";"Zmodyfikowano Stop Loss";"O2-DC-9CWTJF";"-";"O2-DC-9CWTK9";"USD/JPY";"100 000 Jednost.";"153,342";"-";"153,310";"-";"-";"-";"-";"-";"-";"-";"-";"-";"-";"-";"-";"-";"-";"-";"-";"-";"-";"-";"-";"-";"-";"-";"-";"-";"-";"-";"-";"-";"-"
"26 List 2024 18:37:14";"Zmodyfikowano Transakcję Sprzedaży";"O2-DC-9CWTJF";"T2-DC-5P4K3R";"-";"USD/JPY";"100 000 Jednost.";"153,342";"-";"153,320";"-";"-";"-";"-";"0,00";"-";"-";"-";"-";"-";"-";"-";"-";"-";"-";"-";"-";"-";"-";"-";"-";"-";"-";"-";"-";"-";"-";"-";"-";"-"
"26 List 2024 18:36:39";"Transakcja Sprzedaży";"O2-DC-9CWTJF";"T2-DC-5P4K3R";"-";"USD/JPY";"100 000 Jednost.";"153,342";"-";"-";"-";"-";"4,136706";"413 670,60";"0,00";"-";"-";"-";"-";"-";"-";"-";"-";"-";"-";"-";"-";"-";"-";"-";"-";"-";"-";"-";"-";"-";"-";"-";"-";"-"
"26 List 2024 18:13:04";"Stop Loss";"O2-DC-9CWS9L";"T2-DC-5P4J7M";"-";"USD/JPY";"100 000 Jednost.";"153,310";"-";"-";"-";"-";"0,026704";"413 484,30";"149,54";"25 888,05";"-";"-";"-";"-";"-";"-";"-";"-";"-";"-";"-";"-";"-";"-";"-";"-";"-";"-";"-";"-";"-";"-";"-";"-"
"26 List 2024 18:12:58";"Zmodyfikowano Stop Loss";"O2-DC-9CWS9L";"-";"O2-DC-9CWSCK";"USD/JPY";"100 000 Jednost.";"153,366";"-";"153,310";"-";"-";"-";"-";"-";"-";"-";"-";"-";"-";"-";"-";"-";"-";"-";"-";"-";"-";"-";"-";"-";"-";"-";"-";"-";"-";"-";"-";"-";"-"
"26 List 2024 18:12:25";"Zmodyfikowano Transakcję Sprzedaży";"O2-DC-9CWS9L";"T2-DC-5P4J5C";"-";"USD/JPY";"100 000 Jednost.";"153,366";"-";"153,330";"-";"-";"-";"-";"0,00";"-";"-";"-";"-";"-";"-";"-";"-";"-";"-";"-";"-";"-";"-";"-";"-";"-";"-";"-";"-";"-";"-";"-";"-";"-"
"26 List 2024 18:10:35";"Transakcja Sprzedaży";"O2-DC-9CWS9L";"T2-DC-5P4J5C";"-";"USD/JPY";"100 000 Jednost.";"153,366";"-";"-";"-";"-";"4,135344";"413 534,40";"0,00";"-";"-";"-";"-";"-";"-";"-";"-";"-";"-";"-";"-";"-";"-";"-";"-";"-";"-";"-";"-";"-";"-";"-";"-";"-"
"26 List 2024 17:57:49";" Zamknięcie Transakcji";"O2-DC-9CWRM3";"T2-DC-5P4HLE";"O2-DC-9CW8WR";"USD/JPY";"10 000 Jednost.";"153,441";"-";"-";"-";"-";"0,026667";"41 326,38";"10,67";"25 738,51";"-";"-";"-";"-";"-";"-";"-";"-";"-";"-";"-";"-";"-";"-";"-";"-";"-";"-";"-";"-";"-";"-";"-";"-"
"26 List 2024 17:56:54";"Stop Loss";"O2-DC-9CWQME";"T2-DC-5P4HK8";"-";"USD/JPY";"100 000 Jednost.";"153,445";"-";"-";"-";"-";"0,026663";"413 233,80";"95,99";"25 727,84";"-";"-";"-";"-";"-";"-";"-";"-";"-";"-";"-";"-";"-";"-";"-";"-";"-";"-";"-";"-";"-";"-";"-";"-"
"26 List 2024 17:56:54";"Zmodyfikowano Transakcję Sprzedaży";"O2-DC-9CWQME";"T2-DC-5P4GTB";"-";"USD/JPY";"100 000 Jednost.";"153,481";"-";"153,445";"-";"-";"-";"-";"0,00";"-";"-";"-";"-";"-";"-";"-";"-";"-";"-";"-";"-";"-";"-";"-";"-";"-";"-";"-";"-";"-";"-";"-";"-";"-"
"26 List 2024 17:39:12";"Transakcja Sprzedaży";"O2-DC-9CWQME";"T2-DC-5P4GTB";"-";"USD/JPY";"100 000 Jednost.";"153,481";"-";"-";"-";"-";"4,131676";"413 167,60";"0,00";"-";"-";"-";"-";"-";"-";"-";"-";"-";"-";"-";"-";"-";"-";"-";"-";"-";"-";"-";"-";"-";"-";"-";"-";"-"
"26 List 2024 17:31:53";"Stop Loss";"O2-DC-9CWNQ5";"T2-DC-5P4GGV";"-";"USD/JPY";"100 000 Jednost.";"153,540";"-";"-";"-";"-";"0,026662";"413 467,20";"178,64";"25 631,85";"-";"-";"-";"-";"-";"-";"-";"-";"-";"-";"-";"-";"-";"-";"-";"-";"-";"-";"-";"-";"-";"-";"-";"-"
"26 List 2024 17:31:47";"Zmodyfikowano Stop Loss";"O2-DC-9CWNQ5";"-";"O2-DC-9CWQ6P";"USD/JPY";"100 000 Jednost.";"153,607";"-";"153,540";"-";"-";"-";"-";"-";"-";"-";"-";"-";"-";"-";"-";"-";"-";"-";"-";"-";"-";"-";"-";"-";"-";"-";"-";"-";"-";"-";"-";"-";"-"
"26 List 2024 17:31:24";"Zmodyfikowano Transakcję Sprzedaży";"O2-DC-9CWNQ5";"T2-DC-5P4F83";"-";"USD/JPY";"100 000 Jednost.";"153,607";"-";"153,590";"-";"-";"-";"-";"0,00";"-";"-";"-";"-";"-";"-";"-";"-";"-";"-";"-";"-";"-";"-";"-";"-";"-";"-";"-";"-";"-";"-";"-";"-";"-"
"26 List 2024 17:09:00";"Transakcja Sprzedaży";"O2-DC-9CWNQ5";"T2-DC-5P4F83";"-";"USD/JPY";"100 000 Jednost.";"153,607";"-";"-";"-";"-";"4,132408";"413 240,80";"0,00";"-";"-";"-";"-";"-";"-";"-";"-";"-";"-";"-";"-";"-";"-";"-";"-";"-";"-";"-";"-";"-";"-";"-";"-";"-"
"26 List 2024 17:01:00";"Stop Loss";"O2-DC-9CWMNZ";"T2-DC-5P4ENJ";"-";"USD/JPY";"100 000 Jednost.";"153,470";"-";"-";"-";"-";"0,026619";"412 555,40";"18,63";"25 453,21";"-";"-";"-";"-";"-";"-";"-";"-";"-";"-";"-";"-";"-";"-";"-";"-";"-";"-";"-";"-";"-";"-";"-";"-"
"26 List 2024 17:00:58";"Zmodyfikowano Transakcję Sprzedaży";"O2-DC-9CWMNZ";"T2-DC-5P4EEY";"-";"USD/JPY";"100 000 Jednost.";"153,477";"-";"153,470";"-";"-";"-";"-";"0,00";"-";"-";"-";"-";"-";"-";"-";"-";"-";"-";"-";"-";"-";"-";"-";"-";"-";"-";"-";"-";"-";"-";"-";"-";"-"
"26 List 2024 16:59:20";"Transakcja Sprzedaży";"O2-DC-9CWMNZ";"T2-DC-5P4EEY";"-";"USD/JPY";"100 000 Jednost.";"153,477";"-";"-";"-";"-";"4,128019";"412 801,90";"0,00";"-";"-";"-";"-";"-";"-";"-";"-";"-";"-";"-";"-";"-";"-";"-";"-";"-";"-";"-";"-";"-";"-";"-";"-";"-"
"26 List 2024 16:47:26";"Stop Loss";"O2-DC-9CWL5W";"T2-DC-5P4DH8";"-";"USD/JPY";"100 000 Jednost.";"153,510";"-";"-";"-";"-";"0,026612";"412 584,50";"188,95";"25 434,58";"-";"-";"-";"-";"-";"-";"-";"-";"-";"-";"-";"-";"-";"-";"-";"-";"-";"-";"-";"-";"-";"-";"-";"-"
"26 List 2024 16:46:46";"Zmodyfikowano Stop Loss";"O2-DC-9CWL5W";"-";"O2-DC-9CWLHX";"USD/JPY";"100 000 Jednost.";"153,581";"-";"153,510";"-";"-";"-";"-";"-";"-";"-";"-";"-";"-";"-";"-";"-";"-";"-";"-";"-";"-";"-";"-";"-";"-";"-";"-";"-";"-";"-";"-";"-";"-"
"26 List 2024 16:46:24";"Zmodyfikowano Stop Loss";"O2-DC-9CWL5W";"-";"O2-DC-9CWLHX";"USD/JPY";"100 000 Jednost.";"153,581";"-";"153,520";"-";"-";"-";"-";"-";"-";"-";"-";"-";"-";"-";"-";"-";"-";"-";"-";"-";"-";"-";"-";"-";"-";"-";"-";"-";"-";"-";"-";"-";"-"
"26 List 2024 16:45:54";"Zmodyfikowano Transakcję Sprzedaży";"O2-DC-9CWL5W";"T2-DC-5P4D07";"-";"USD/JPY";"100 000 Jednost.";"153,581";"-";"153,570";"-";"-";"-";"-";"0,00";"-";"-";"-";"-";"-";"-";"-";"-";"-";"-";"-";"-";"-";"-";"-";"-";"-";"-";"-";"-";"-";"-";"-";"-";"-"
"26 List 2024 16:42:13";"Transakcja Sprzedaży";"O2-DC-9CWL5W";"T2-DC-5P4D07";"-";"USD/JPY";"100 000 Jednost.";"153,581";"-";"-";"-";"-";"4,126286";"412 628,60";"0,00";"-";"-";"-";"-";"-";"-";"-";"-";"-";"-";"-";"-";"-";"-";"-";"-";"-";"-";"-";"-";"-";"-";"-";"-";"-"
"26 List 2024 16:22:44";" Zamknięcie Transakcji";"O2-DC-9CWJ36";"T2-DC-5P4B98";"O2-DC-9CVR1F";"USD/JPY";"90 000 Jednost.";"153,685";"-";"-";"-";"-";"0,026585";"371 448,72";"339,76";"25 245,63";"-";"-";"-";"-";"-";"-";"-";"-";"-";"-";"-";"-";"-";"-";"-";"-";"-";"-";"-";"-";"-";"-";"-";"-"
"26 List 2024 16:18:07";"Transakcja Sprzedaży";"O2-DC-9CWHJE";"T2-DC-5P49T2";"-";"USD/JPY";"100 000 Jednost.";"153,503";"-";"-";"-";"-";"4,122568";"412 256,80";"0,00";"-";"-";"-";"-";"-";"-";"-";"-";"-";"-";"-";"-";"-";"-";"-";"-";"-";"-";"-";"-";"-";"-";"-";"-";"-"
"26 List 2024 16:12:24";"Stop Loss";"O2-DC-9CWGFL";"T2-DC-5P499N";"-";"USD/JPY";"100 000 Jednost.";"153,590";"-";"-";"-";"-";"0,026589";"412 533,40";"23,93";"24 905,87";"-";"-";"-";"-";"-";"-";"-";"-";"-";"-";"-";"-";"-";"-";"-";"-";"-";"-";"-";"-";"-";"-";"-";"-"
"26 List 2024 16:12:20";"Zmodyfikowano Transakcję Sprzedaży";"O2-DC-9CWGFL";"T2-DC-5P48YJ";"-";"USD/JPY";"100 000 Jednost.";"153,599";"-";"153,590";"-";"-";"-";"-";"0,00";"-";"-";"-";"-";"-";"-";"-";"-";"-";"-";"-";"-";"-";"-";"-";"-";"-";"-";"-";"-";"-";"-";"-";"-";"-"
"26 List 2024 16:08:19";"Transakcja Sprzedaży";"O2-DC-9CWGFL";"T2-DC-5P48YJ";"-";"USD/JPY";"100 000 Jednost.";"153,599";"-";"-";"-";"-";"4,126666";"412 666,60";"0,00";"-";"-";"-";"-";"-";"-";"-";"-";"-";"-";"-";"-";"-";"-";"-";"-";"-";"-";"-";"-";"-";"-";"-";"-";"-"
"26 List 2024 16:03:05";"Stop Loss";"O2-DC-9CWFJS";"T2-DC-5P48D2";"-";"USD/JPY";"100 000 Jednost.";"153,430";"-";"-";"-";"-";"0,026618";"412 465,20";"55,90";"24 881,94";"-";"-";"-";"-";"-";"-";"-";"-";"-";"-";"-";"-";"-";"-";"-";"-";"-";"-";"-";"-";"-";"-";"-";"-"
"26 List 2024 16:03:00";"Zmodyfikowano Transakcję Sprzedaży";"O2-DC-9CWFJS";"T2-DC-5P4872";"-";"USD/JPY";"100 000 Jednost.";"153,451";"-";"153,430";"-";"-";"-";"-";"0,00";"-";"-";"-";"-";"-";"-";"-";"-";"-";"-";"-";"-";"-";"-";"-";"-";"-";"-";"-";"-";"-";"-";"-";"-";"-"
"26 List 2024 16:02:05";"Transakcja Sprzedaży";"O2-DC-9CWFJS";"T2-DC-5P4872";"-";"USD/JPY";"100 000 Jednost.";"153,451";"-";"-";"-";"-";"4,124161";"412 416,10";"0,00";"-";"-";"-";"-";"-";"-";"-";"-";"-";"-";"-";"-";"-";"-";"-";"-";"-";"-";"-";"-";"-";"-";"-";"-";"-"
"26 List 2024 15:51:03";" Zamknięcie Transakcji";"O2-DC-9CWE76";"T2-DC-5P472V";"O2-DC-9CVR1F";"USD/JPY";"10 000 Jednost.";"153,618";"-";"-";"-";"-";"0,026602";"41 275,08";"55,60";"24 826,04";"-";"-";"-";"-";"-";"-";"-";"-";"-";"-";"-";"-";"-";"-";"-";"-";"-";"-";"-";"-";"-";"-";"-";"-"
"26 List 2024 15:44:20";" Zamknięcie Transakcji";"O2-DC-9CWDBZ";"T2-DC-5P4677";"O2-DC-9CTC38";"USD/JPY";"95 000 Jednost.";"153,662";"-";"-";"-";"-";"0,026592";"392 127,51";"558,30";"24 770,44";"-";"-";"-";"-";"-";"-";"-";"-";"-";"-";"-";"-";"-";"-";"-";"-";"-";"-";"-";"-";"-";"-";"-";"-"
"26 List 2024 15:34:07";"Stop Loss";"O2-DC-9CW90H";"T2-DC-5P44QE";"-";"USD/JPY";"80 000 Jednost.";"153,590";"-";"-";"-";"-";"0,026622";"330 332,88";"29,82";"24 212,14";"-";"-";"-";"-";"-";"-";"-";"-";"-";"-";"-";"-";"-";"-";"-";"-";"-";"-";"-";"-";"-";"-";"-";"-"
"26 List 2024 15:34:07";" Zmodyfikowano Transakcję Kupna";"O2-DC-9CW90H";"T2-DC-5P43BQ";"-";"USD/JPY";"80 000 Jednost.";"153,576";"-";"153,590";"-";"-";"-";"-";"0,00";"-";"-";"-";"-";"-";"-";"-";"-";"-";"-";"-";"-";"-";"-";"-";"-";"-";"-";"-";"-";"-";"-";"-";"-";"-"
"26 List 2024 15:14:58";" Transakcja Kupna";"O2-DC-9CW90H";"T2-DC-5P43BQ";"-";"USD/JPY";"80 000 Jednost.";"153,576";"-";"-";"-";"-";"4,129021";"330 321,68";"0,00";"-";"-";"-";"-";"-";"-";"-";"-";"-";"-";"-";"-";"-";"-";"-";"-";"-";"-";"-";"-";"-";"-";"-";"-";"-"
"26 List 2024 15:14:41";"Odrzucono Zlecenie: brak wystarczających środków";"O2-DC-9CW8ZZ";"-";"-";"USD/JPY";"100 000 Jednost.";"-";"-";"-";"-";"-";"-";"-";"-";"-";"-";"-";"-";"-";"-";"-";"-";"-";"-";"-";"-";"-";"-";"-";"-";"-";"-";"-";"-";"-";"-";"-";"-";"-"
"26 List 2024 15:12:51";"Transakcja Sprzedaży";"O2-DC-9CW8WR";"T2-DC-5P437E";"-";"USD/JPY";"100 000 Jednost.";"153,481";"-";"-";"-";"-";"4,129482";"412 948,20";"0,00";"-";"-";"-";"-";"-";"-";"-";"-";"-";"-";"-";"-";"-";"-";"-";"-";"-";"-";"-";"-";"-";"-";"-";"-";"-"
"26 List 2024 15:09:21";"Stop Loss";"O2-DC-9CW8P4";"T2-DC-5P432M";"-";"USD/JPY";"100 000 Jednost.";"153,490";"-";"-";"-";"-";"0,026645";"413 075,50";"7,99";"24 182,32";"-";"-";"-";"-";"-";"-";"-";"-";"-";"-";"-";"-";"-";"-";"-";"-";"-";"-";"-";"-";"-";"-";"-";"-"
"26 List 2024 15:09:20";"Zmodyfikowano Transakcję Sprzedaży";"O2-DC-9CW8P4";"T2-DC-5P4324";"-";"USD/JPY";"100 000 Jednost.";"153,493";"-";"153,490";"-";"-";"-";"-";"0,00";"-";"-";"-";"-";"-";"-";"-";"-";"-";"-";"-";"-";"-";"-";"-";"-";"-";"-";"-";"-";"-";"-";"-";"-";"-"
"26 List 2024 15:08:35";"Transakcja Sprzedaży";"O2-DC-9CW8P4";"T2-DC-5P4324";"-";"USD/JPY";"100 000 Jednost.";"153,493";"-";"-";"-";"-";"4,130614";"413 061,40";"0,00";"-";"-";"-";"-";"-";"-";"-";"-";"-";"-";"-";"-";"-";"-";"-";"-";"-";"-";"-";"-";"-";"-";"-";"-";"-"
"26 List 2024 14:04:30";"Stop Loss";"O2-DC-9CW57E";"T2-DC-5P406S";"-";"USD/JPY";"100 000 Jednost.";"153,060";"-";"-";"-";"-";"0,026634";"411 636,60";"82,57";"24 174,33";"-";"-";"-";"-";"-";"-";"-";"-";"-";"-";"-";"-";"-";"-";"-";"-";"-";"-";"-";"-";"-";"-";"-";"-"
"26 List 2024 14:03:59";"Zmodyfikowano Transakcję Sprzedaży";"O2-DC-9CW57E";"T2-DC-5P403K";"-";"USD/JPY";"100 000 Jednost.";"153,091";"-";"153,060";"-";"-";"-";"-";"0,00";"-";"-";"-";"-";"-";"-";"-";"-";"-";"-";"-";"-";"-";"-";"-";"-";"-";"-";"-";"-";"-";"-";"-";"-";"-"
"26 List 2024 14:03:34";"Transakcja Sprzedaży";"O2-DC-9CW57E";"T2-DC-5P403K";"-";"USD/JPY";"100 000 Jednost.";"153,091";"-";"-";"-";"-";"4,11841";"411 841,00";"0,00";"-";"-";"-";"-";"-";"-";"-";"-";"-";"-";"-";"-";"-";"-";"-";"-";"-";"-";"-";"-";"-";"-";"-";"-";"-"
"26 List 2024 13:32:46";" Zamknięcie Transakcji";"O2-DC-9CW3WD";"T2-DC-5P3Z2F";"O2-DC-9CW3EN";"USD/JPY";"100 000 Jednost.";"153,123";"-";"-";"-";"-";"0,026559";"410 786,90";"23,90";"24 091,76";"-";"-";"-";"-";"-";"-";"-";"-";"-";"-";"-";"-";"-";"-";"-";"-";"-";"-";"-";"-";"-";"-";"-";"-"
"26 List 2024 13:25:01";"Transakcja Sprzedaży";"O2-DC-9CW3EN";"T2-DC-5P3YR1";"-";"USD/JPY";"100 000 Jednost.";"153,132";"-";"-";"-";"-";"4,108039";"410 803,90";"0,00";"-";"-";"-";"-";"-";"-";"-";"-";"-";"-";"-";"-";"-";"-";"-";"-";"-";"-";"-";"-";"-";"-";"-";"-";"-"
"26 List 2024 13:18:15";"Stop Loss";"O2-DC-9CW2VW";"T2-DC-5P3YDR";"-";"USD/JPY";"100 000 Jednost.";"153,160";"-";"-";"-";"-";"0,026549";"410 663,60";"188,50";"24 067,86";"-";"-";"-";"-";"-";"-";"-";"-";"-";"-";"-";"-";"-";"-";"-";"-";"-";"-";"-";"-";"-";"-";"-";"-"
"26 List 2024 13:18:14";"Zmodyfikowano Stop Loss";"O2-DC-9CW2VW";"-";"O2-DC-9CW2Y5";"USD/JPY";"100 000 Jednost.";"153,231";"-";"153,160";"-";"-";"-";"-";"-";"-";"-";"-";"-";"-";"-";"-";"-";"-";"-";"-";"-";"-";"-";"-";"-";"-";"-";"-";"-";"-";"-";"-";"-";"-"
"26 List 2024 13:17:56";"Zmodyfikowano Transakcję Sprzedaży";"O2-DC-9CW2VW";"T2-DC-5P3Y8V";"-";"USD/JPY";"100 000 Jednost.";"153,231";"-";"153,200";"-";"-";"-";"-";"0,00";"-";"-";"-";"-";"-";"-";"-";"-";"-";"-";"-";"-";"-";"-";"-";"-";"-";"-";"-";"-";"-";"-";"-";"-";"-"
"26 List 2024 13:17:22";"Transakcja Sprzedaży";"O2-DC-9CW2VW";"T2-DC-5P3Y8V";"-";"USD/JPY";"100 000 Jednost.";"153,231";"-";"-";"-";"-";"4,112488";"411 248,80";"0,00";"-";"-";"-";"-";"-";"-";"-";"-";"-";"-";"-";"-";"-";"-";"-";"-";"-";"-";"-";"-";"-";"-";"-";"-";"-"
"26 List 2024 13:16:28";"Stop Loss";"O2-DC-9CW2EV";"T2-DC-5P3Y6V";"-";"USD/JPY";"100 000 Jednost.";"153,204";"-";"-";"-";"-";"0,026588";"411 336,00";"648,75";"23 879,36";"-";"-";"-";"-";"-";"-";"-";"-";"-";"-";"-";"-";"-";"-";"-";"-";"-";"-";"-";"-";"-";"-";"-";"-"
"26 List 2024 13:16:17";"Zmodyfikowano Transakcję Sprzedaży";"O2-DC-9CW2EV";"T2-DC-5P3XVB";"-";"USD/JPY";"100 000 Jednost.";"153,448";"-";"153,200";"-";"-";"-";"-";"0,00";"-";"-";"-";"-";"-";"-";"-";"-";"-";"-";"-";"-";"-";"-";"-";"-";"-";"-";"-";"-";"-";"-";"-";"-";"-"
"26 List 2024 13:11:45";"Transakcja Sprzedaży";"O2-DC-9CW2EV";"T2-DC-5P3XVB";"-";"USD/JPY";"100 000 Jednost.";"153,448";"-";"-";"-";"-";"4,117739";"411 773,90";"0,00";"-";"-";"-";"-";"-";"-";"-";"-";"-";"-";"-";"-";"-";"-";"-";"-";"-";"-";"-";"-";"-";"-";"-";"-";"-"
"26 List 2024 12:32:21";" Zamknięcie Transakcji";"O2-DC-9CW09W";"T2-DC-5P3VZ5";"O2-DC-9CTC38";"USD/JPY";"5 000 Jednost.";"153,838";"-";"-";"-";"-";"0,026533";"20 614,24";"5,97";"23 230,61";"-";"-";"-";"-";"-";"-";"-";"-";"-";"-";"-";"-";"-";"-";"-";"-";"-";"-";"-";"-";"-";"-";"-";"-"
"26 List 2024 11:10:36";" Zamknięcie Transakcji";"O2-DC-9CVX6R";"T2-DC-5P3SK9";"O2-DC-9CV3WD";"USD/JPY";"10 000 Jednost.";"153,915";"-";"-";"-";"-";"0,026561";"41 296,52";"1,06";"23 224,64";"-";"-";"-";"-";"-";"-";"-";"-";"-";"-";"-";"-";"-";"-";"-";"-";"-";"-";"-";"-";"-";"-";"-";"-"
"26 List 2024 09:59:53";" Zamknięcie Transakcji";"O2-DC-9CVSM1";"T2-DC-5P3PLB";"O2-DC-9CV173";"USD/JPY";"20 000 Jednost.";"153,973";"-";"-";"-";"-";"0,026605";"82 745,96";"77,69";"23 223,58";"-";"-";"-";"-";"-";"-";"-";"-";"-";"-";"-";"-";"-";"-";"-";"-";"-";"-";"-";"-";"-";"-";"-";"-"
"26 List 2024 09:59:45";" Zamknięcie Transakcji";"O2-DC-9CVSLS";"T2-DC-5P3PL4";"O2-DC-9CTMNB";"USD/JPY";"60 000 Jednost.";"153,972";"-";"-";"-";"-";"0,026608";"248 240,28";"477,35";"23 145,89";"-";"-";"-";"-";"-";"-";"-";"-";"-";"-";"-";"-";"-";"-";"-";"-";"-";"-";"-";"-";"-";"-";"-";"-"
"26 List 2024 09:30:33";"Transakcja Sprzedaży";"O2-DC-9CVR1F";"T2-DC-5P3N9Z";"-";"USD/JPY";"100 000 Jednost.";"153,827";"-";"-";"-";"-";"4,144151";"414 415,10";"0,00";"-";"-";"-";"-";"-";"-";"-";"-";"-";"-";"-";"-";"-";"-";"-";"-";"-";"-";"-";"-";"-";"-";"-";"-";"-"
"26 List 2024 09:10:36";"Stop Loss";"O2-DC-9CVPE4";"T2-DC-5P3MC7";"-";"USD/JPY";"100 000 Jednost.";"153,870";"-";"-";"-";"-";"0,026688";"414 714,70";"50,71";"22 668,54";"-";"-";"-";"-";"-";"-";"-";"-";"-";"-";"-";"-";"-";"-";"-";"-";"-";"-";"-";"-";"-";"-";"-";"-"
"26 List 2024 09:10:34";"Zmodyfikowano Transakcję Sprzedaży";"O2-DC-9CVPE4";"T2-DC-5P3M21";"-";"USD/JPY";"100 000 Jednost.";"153,889";"-";"153,870";"-";"-";"-";"-";"0,00";"-";"-";"-";"-";"-";"-";"-";"-";"-";"-";"-";"-";"-";"-";"-";"-";"-";"-";"-";"-";"-";"-";"-";"-";"-"
"26 List 2024 09:05:42";"Transakcja Sprzedaży";"O2-DC-9CVPE4";"T2-DC-5P3M21";"-";"USD/JPY";"100 000 Jednost.";"153,889";"-";"-";"-";"-";"4,14856";"414 856,00";"0,00";"-";"-";"-";"-";"-";"-";"-";"-";"-";"-";"-";"-";"-";"-";"-";"-";"-";"-";"-";"-";"-";"-";"-";"-";"-"
"26 List 2024 08:01:28";" Zamknięcie Transakcji";"O2-DC-9CVLB4";"T2-DC-5P3JKK";"O2-DC-9CTMNB";"USD/JPY";"5 000 Jednost.";"154,083";"-";"-";"-";"-";"0,02662";"20 713,24";"25,02";"22 617,83";"-";"-";"-";"-";"-";"-";"-";"-";"-";"-";"-";"-";"-";"-";"-";"-";"-";"-";"-";"-";"-";"-";"-";"-"
"26 List 2024 00:17:06";"Transakcja Sprzedaży";"O2-DC-9CV3WD";"T2-DC-5P34EP";"-";"USD/JPY";"10 000 Jednost.";"153,919";"-";"-";"-";"-";"4,125244";"41 252,44";"0,00";"-";"-";"-";"-";"-";"-";"-";"-";"-";"-";"-";"-";"-";"-";"-";"-";"-";"-";"-";"-";"-";"-";"-";"-";"-"
"25 List 2024 23:02:08";"Koszty Utrzymania Pozycji";"1390821744";"-";"-";"Rachunek";"-";"-";"-";"-";"-";"-";"-";"-";"-37,15";"22 592,81";"-";"-";"-";"-";"-";"-37,15";"-";"-";"-";"-";"-";"-";"-";"-";"-";"-";"-";"-";"-";"-";"-";"-";"-";"-"
"25 List 2024 23:02:08";"Koszty Utrzymania Pozycji";"O2-D9-9BJZX7";"-";"-";"USD/JPY";"-";"-";"-";"-";"-";"-";"-";"-";"-";"-";"-";"-";"30 000,00";"5,53252%";"-18,77";"0,00";"-";"-";"-";"-";"-";"-";"-";"-";"-";"-";"-";"-";"-";"-";"-";"-";"-";"-"
"25 List 2024 23:02:08";"Koszty Utrzymania Pozycji";"O2-D9-9BB04B";"-";"-";"USD/JPY";"-";"-";"-";"-";"-";"-";"-";"-";"-";"-";"-";"-";"34 000,00";"5,53252%";"-21,27";"0,00";"-";"-";"-";"-";"-";"-";"-";"-";"-";"-";"-";"-";"-";"-";"-";"-";"-";"-"
"25 List 2024 23:02:08";"Koszty Utrzymania Pozycji";"O2-DB-9C9X8L";"-";"-";"USD/JPY";"-";"-";"-";"-";"-";"-";"-";"-";"-";"-";"-";"-";"20 000,00";"3,47811%";"7,79";"0,00";"-";"-";"-";"-";"-";"-";"-";"-";"-";"-";"-";"-";"-";"-";"-";"-";"-";"-"
"25 List 2024 23:02:08";"Koszty Utrzymania Pozycji";"O2-DB-9CQYNM";"-";"-";"USD/JPY";"-";"-";"-";"-";"-";"-";"-";"-";"-";"-";"-";"-";"100 000,00";"3,47811%";"38,94";"0,00";"-";"-";"-";"-";"-";"-";"-";"-";"-";"-";"-";"-";"-";"-";"-";"-";"-";"-"
"25 List 2024 23:02:08";"Koszty Utrzymania Pozycji";"O2-DC-9CTMNB";"-";"-";"USD/JPY";"-";"-";"-";"-";"-";"-";"-";"-";"-";"-";"-";"-";"65 000,00";"5,53252%";"-40,67";"0,00";"-";"-";"-";"-";"-";"-";"-";"-";"-";"-";"-";"-";"-";"-";"-";"-";"-";"-"
"25 List 2024 23:02:08";"Koszty Utrzymania Pozycji";"O2-DC-9CTNWE";"-";"-";"USD/JPY";"-";"-";"-";"-";"-";"-";"-";"-";"-";"-";"-";"-";"100 000,00";"3,47811%";"38,94";"0,00";"-";"-";"-";"-";"-";"-";"-";"-";"-";"-";"-";"-";"-";"-";"-";"-";"-";"-"
"25 List 2024 23:02:08";"Koszty Utrzymania Pozycji";"O2-D9-9BS5RZ";"-";"-";"USD/JPY";"-";"-";"-";"-";"-";"-";"-";"-";"-";"-";"-";"-";"22 000,00";"5,53252%";"-13,76";"0,00";"-";"-";"-";"-";"-";"-";"-";"-";"-";"-";"-";"-";"-";"-";"-";"-";"-";"-"
"25 List 2024 23:02:08";"Koszty Utrzymania Pozycji";"O2-DC-9CTC38";"-";"-";"USD/JPY";"-";"-";"-";"-";"-";"-";"-";"-";"-";"-";"-";"-";"100 000,00";"5,53252%";"-62,57";"0,00";"-";"-";"-";"-";"-";"-";"-";"-";"-";"-";"-";"-";"-";"-";"-";"-";"-";"-"
"25 List 2024 23:02:08";"Koszty Utrzymania Pozycji";"O2-DB-9CKXH9";"-";"-";"USD/JPY";"-";"-";"-";"-";"-";"-";"-";"-";"-";"-";"-";"-";"90 000,00";"3,47811%";"35,05";"0,00";"-";"-";"-";"-";"-";"-";"-";"-";"-";"-";"-";"-";"-";"-";"-";"-";"-";"-"
"25 List 2024 23:02:08";"Koszty Utrzymania Pozycji";"O2-DB-9C9XVJ";"-";"-";"USD/JPY";"-";"-";"-";"-";"-";"-";"-";"-";"-";"-";"-";"-";"30 000,00";"3,47811%";"11,68";"0,00";"-";"-";"-";"-";"-";"-";"-";"-";"-";"-";"-";"-";"-";"-";"-";"-";"-";"-"
"25 List 2024 23:02:08";"Koszty Utrzymania Pozycji";"O2-DC-9CV173";"-";"-";"USD/JPY";"-";"-";"-";"-";"-";"-";"-";"-";"-";"-";"-";"-";"20 000,00";"5,53252%";"-12,51";"0,00";"-";"-";"-";"-";"-";"-";"-";"-";"-";"-";"-";"-";"-";"-";"-";"-";"-";"-"
"25 List 2024 22:57:05";" Zamknięcie Transakcji";"O2-DC-9CV2QG";"T2-DC-5P33LH";"O2-DC-9CTMNB";"USD/JPY";"5 000 Jednost.";"154,201";"-";"-";"-";"-";"0,026511";"20 644,55";"9,28";"22 629,96";"-";"-";"-";"-";"-";"-";"-";"-";"-";"-";"-";"-";"-";"-";"-";"-";"-";"-";"-";"-";"-";"-";"-";"-"
"25 List 2024 22:40:11";" Zamknięcie Transakcji";"O2-DC-9CV2DP";"T2-DC-5P33BX";"O2-DC-9CTMNB";"USD/JPY";"20 000 Jednost.";"154,230";"-";"-";"-";"-";"0,026508";"82 584,24";"21,74";"22 620,68";"-";"-";"-";"-";"-";"-";"-";"-";"-";"-";"-";"-";"-";"-";"-";"-";"-";"-";"-";"-";"-";"-";"-";"-"
"25 List 2024 21:57:19";"Transakcja Sprzedaży";"O2-DC-9CV173";"T2-DC-5P32B0";"-";"USD/JPY";"20 000 Jednost.";"154,119";"-";"-";"-";"-";"4,125835";"82 516,70";"0,00";"-";"-";"-";"-";"-";"-";"-";"-";"-";"-";"-";"-";"-";"-";"-";"-";"-";"-";"-";"-";"-";"-";"-";"-";"-"
"25 List 2024 21:18:09";" Zamknięcie Transakcji";"O2-DC-9CTZQ0";"T2-DC-5P30XV";"O2-DC-9CTMNB";"USD/JPY";"10 000 Jednost.";"154,107";"-";"-";"-";"-";"0,026463";"41 189,11";"43,40";"22 598,94";"-";"-";"-";"-";"-";"-";"-";"-";"-";"-";"-";"-";"-";"-";"-";"-";"-";"-";"-";"-";"-";"-";"-";"-"
"25 List 2024 20:39:18";" Zamknięcie Transakcji";"O2-DC-9CTY3Q";"T2-DC-5P2ZEC";"O2-DC-9CTMNB";"USD/JPY";"10 000 Jednost.";"154,069";"-";"-";"-";"-";"0,02649";"41 220,27";"53,51";"22 555,54";"-";"-";"-";"-";"-";"-";"-";"-";"-";"-";"-";"-";"-";"-";"-";"-";"-";"-";"-";"-";"-";"-";"-";"-"
"25 List 2024 18:31:00";" Zmodyfikowano Transakcję Kupna";"O2-DC-9CTNWE";"T2-DC-5P2R5Y";"-";"USD/JPY";"100 000 Jednost.";"154,369";"-";"-";"154,500";"-";"-";"-";"0,00";"-";"-";"-";"-";"-";"-";"-";"-";"-";"-";"-";"-";"-";"-";"-";"-";"-";"-";"-";"-";"-";"-";"-";"-";"-"
"25 List 2024 18:20:28";" Transakcja Kupna";"O2-DC-9CTNWE";"T2-DC-5P2R5Y";"-";"USD/JPY";"100 000 Jednost.";"154,369";"-";"-";"-";"-";"4,139923";"413 992,30";"0,00";"-";"-";"-";"-";"-";"-";"-";"-";"-";"-";"-";"-";"-";"-";"-";"-";"-";"-";"-";"-";"-";"-";"-";"-";"-"
"25 List 2024 18:04:02";"Transakcja Sprzedaży";"O2-DC-9CTMNB";"T2-DC-5P2Q06";"-";"USD/JPY";"110 000 Jednost.";"154,271";"-";"-";"-";"-";"4,141536";"455 568,96";"0,00";"-";"-";"-";"-";"-";"-";"-";"-";"-";"-";"-";"-";"-";"-";"-";"-";"-";"-";"-";"-";"-";"-";"-";"-";"-"
"25 List 2024 18:00:23";"Stop Loss";"O2-DC-9CTM3P";"T2-DC-5P2PSY";"-";"USD/JPY";"110 000 Jednost.";"154,300";"-";"-";"-";"-";"0,026584";"455 728,79";"70,18";"22 502,03";"-";"-";"-";"-";"-";"-";"-";"-";"-";"-";"-";"-";"-";"-";"-";"-";"-";"-";"-";"-";"-";"-";"-";"-"
"25 List 2024 18:00:10";"Zmodyfikowano Stop Loss";"O2-DC-9CTM3P";"-";"O2-DC-9CTMD8";"USD/JPY";"110 000 Jednost.";"154,324";"-";"154,300";"-";"-";"-";"-";"-";"-";"-";"-";"-";"-";"-";"-";"-";"-";"-";"-";"-";"-";"-";"-";"-";"-";"-";"-";"-";"-";"-";"-";"-";"-"
"25 List 2024 17:59:44";"Zmodyfikowano Stop Loss";"O2-DC-9CTM3P";"-";"O2-DC-9CTMD8";"USD/JPY";"110 000 Jednost.";"154,324";"-";"154,310";"-";"-";"-";"-";"-";"-";"-";"-";"-";"-";"-";"-";"-";"-";"-";"-";"-";"-";"-";"-";"-";"-";"-";"-";"-";"-";"-";"-";"-";"-"
"25 List 2024 17:59:31";"Zmodyfikowano Transakcję Sprzedaży";"O2-DC-9CTM3P";"T2-DC-5P2PJ8";"-";"USD/JPY";"110 000 Jednost.";"154,324";"-";"154,320";"-";"-";"-";"-";"0,00";"-";"-";"-";"-";"-";"-";"-";"-";"-";"-";"-";"-";"-";"-";"-";"-";"-";"-";"-";"-";"-";"-";"-";"-";"-"
"25 List 2024 17:55:16";"Transakcja Sprzedaży";"O2-DC-9CTM3P";"T2-DC-5P2PJ8";"-";"USD/JPY";"110 000 Jednost.";"154,324";"-";"-";"-";"-";"4,143741";"455 811,51";"0,00";"-";"-";"-";"-";"-";"-";"-";"-";"-";"-";"-";"-";"-";"-";"-";"-";"-";"-";"-";"-";"-";"-";"-";"-";"-"
"25 List 2024 17:39:22";"Stop Loss";"O2-DC-9CTGBX";"T2-DC-5P2NH1";"-";"USD/JPY";"100 000 Jednost.";"154,360";"-";"-";"-";"-";"0,02658";"414 354,00";"34,55";"22 431,85";"-";"-";"-";"-";"-";"-";"-";"-";"-";"-";"-";"-";"-";"-";"-";"-";"-";"-";"-";"-";"-";"-";"-";"-"
"25 List 2024 17:33:59";"Zmodyfikowano Transakcję Sprzedaży";"O2-DC-9CTGBX";"T2-DC-5P2KDR";"-";"USD/JPY";"100 000 Jednost.";"154,373";"-";"154,360";"-";"-";"-";"-";"0,00";"-";"-";"-";"-";"-";"-";"-";"-";"-";"-";"-";"-";"-";"-";"-";"-";"-";"-";"-";"-";"-";"-";"-";"-";"-"
"25 List 2024 16:59:34";"Transakcja Sprzedaży";"O2-DC-9CTGBX";"T2-DC-5P2KDR";"-";"USD/JPY";"100 000 Jednost.";"154,373";"-";"-";"-";"-";"4,145544";"414 554,40";"0,00";"-";"-";"-";"-";"-";"-";"-";"-";"-";"-";"-";"-";"-";"-";"-";"-";"-";"-";"-";"-";"-";"-";"-";"-";"-"
"25 List 2024 16:26:57";" Zamknięcie Transakcji";"O2-DC-9CTCRN";"T2-DC-5P2G2C";"O2-DC-9CT8YE";"USD/JPY";"100 000 Jednost.";"153,839";"-";"-";"-";"-";"0,026584";"413 041,40";"15,95";"22 397,30";"-";"-";"-";"-";"-";"-";"-";"-";"-";"-";"-";"-";"-";"-";"-";"-";"-";"-";"-";"-";"-";"-";"-";"-"
"25 List 2024 16:20:04";"Transakcja Sprzedaży";"O2-DC-9CTC38";"T2-DC-5P2FJ2";"-";"USD/JPY";"100 000 Jednost.";"153,883";"-";"-";"-";"-";"4,136416";"413 641,60";"0,00";"-";"-";"-";"-";"-";"-";"-";"-";"-";"-";"-";"-";"-";"-";"-";"-";"-";"-";"-";"-";"-";"-";"-";"-";"-"
"25 List 2024 16:16:12";" Zamknięcie Transakcji";"O2-DC-9CTBQ7";"T2-DC-5P2F75";"O2-DC-9CSSVK";"USD/JPY";"95 000 Jednost.";"153,991";"-";"-";"-";"-";"0,026619";"393 303,13";"1 309,92";"22 381,35";"-";"-";"-";"-";"-";"-";"-";"-";"-";"-";"-";"-";"-";"-";"-";"-";"-";"-";"-";"-";"-";"-";"-";"-"
"25 List 2024 16:05:42";"Transakcja Sprzedaży";"O2-DC-9CT8YE";"T2-DC-5P2DLZ";"-";"USD/JPY";"100 000 Jednost.";"153,845";"-";"-";"-";"-";"4,142378";"414 237,80";"0,00";"-";"-";"-";"-";"-";"-";"-";"-";"-";"-";"-";"-";"-";"-";"-";"-";"-";"-";"-";"-";"-";"-";"-";"-";"-"
"25 List 2024 15:31:58";"Stop Loss";"O2-DC-9CT2J2";"T2-DC-5P27GG";"-";"USD/JPY";"100 000 Jednost.";"153,650";"-";"-";"-";"-";"0,02658";"412 560,40";"55,82";"21 071,43";"-";"-";"-";"-";"-";"-";"-";"-";"-";"-";"-";"-";"-";"-";"-";"-";"-";"-";"-";"-";"-";"-";"-";"-"
"25 List 2024 15:31:57";"Zmodyfikowano Transakcję Sprzedaży";"O2-DC-9CT2J2";"T2-DC-5P26T6";"-";"USD/JPY";"100 000 Jednost.";"153,671";"-";"153,650";"-";"-";"-";"-";"0,00";"-";"-";"-";"-";"-";"-";"-";"-";"-";"-";"-";"-";"-";"-";"-";"-";"-";"-";"-";"-";"-";"-";"-";"-";"-"
"25 List 2024 15:28:18";"Transakcja Sprzedaży";"O2-DC-9CT2J2";"T2-DC-5P26T6";"-";"USD/JPY";"100 000 Jednost.";"153,671";"-";"-";"-";"-";"4,124783";"412 478,30";"0,00";"-";"-";"-";"-";"-";"-";"-";"-";"-";"-";"-";"-";"-";"-";"-";"-";"-";"-";"-";"-";"-";"-";"-";"-";"-"
"25 List 2024 14:20:38";"Stop Loss";"O2-DC-9CSW8N";"T2-DC-5P21LK";"-";"USD/JPY";"100 000 Jednost.";"153,884";"-";"-";"-";"-";"0,026567";"412 906,10";"252,39";"21 015,61";"-";"-";"-";"-";"-";"-";"-";"-";"-";"-";"-";"-";"-";"-";"-";"-";"-";"-";"-";"-";"-";"-";"-";"-"
"25 List 2024 14:20:12";"Zmodyfikowano Stop Loss";"O2-DC-9CSW8N";"-";"O2-DC-9CSWEC";"USD/JPY";"100 000 Jednost.";"153,979";"-";"153,880";"-";"-";"-";"-";"-";"-";"-";"-";"-";"-";"-";"-";"-";"-";"-";"-";"-";"-";"-";"-";"-";"-";"-";"-";"-";"-";"-";"-";"-";"-"
"25 List 2024 14:18:21";"Zmodyfikowano Stop Loss";"O2-DC-9CSW8N";"-";"O2-DC-9CSWEC";"USD/JPY";"100 000 Jednost.";"153,979";"-";"153,900";"-";"-";"-";"-";"-";"-";"-";"-";"-";"-";"-";"-";"-";"-";"-";"-";"-";"-";"-";"-";"-";"-";"-";"-";"-";"-";"-";"-";"-";"-"
"25 List 2024 14:14:56";"Zmodyfikowano Transakcję Sprzedaży";"O2-DC-9CSW8N";"T2-DC-5P2118";"-";"USD/JPY";"100 000 Jednost.";"153,979";"-";"153,950";"-";"-";"-";"-";"0,00";"-";"-";"-";"-";"-";"-";"-";"-";"-";"-";"-";"-";"-";"-";"-";"-";"-";"-";"-";"-";"-";"-";"-";"-";"-"
"25 List 2024 14:11:27";"Transakcja Sprzedaży";"O2-DC-9CSW8N";"T2-DC-5P2118";"-";"USD/JPY";"100 000 Jednost.";"153,979";"-";"-";"-";"-";"4,134542";"413 454,20";"0,00";"-";"-";"-";"-";"-";"-";"-";"-";"-";"-";"-";"-";"-";"-";"-";"-";"-";"-";"-";"-";"-";"-";"-";"-";"-"
"25 List 2024 14:00:36";"Stop Loss";"O2-DC-9CSVGN";"T2-DC-5P20JH";"-";"USD/JPY";"100 000 Jednost.";"154,150";"-";"-";"-";"-";"0,026577";"413 742,80";"71,76";"20 763,22";"-";"-";"-";"-";"-";"-";"-";"-";"-";"-";"-";"-";"-";"-";"-";"-";"-";"-";"-";"-";"-";"-";"-";"-"
"25 List 2024 14:00:35";"Zmodyfikowano Transakcję Sprzedaży";"O2-DC-9CSVGN";"T2-DC-5P20C0";"-";"USD/JPY";"100 000 Jednost.";"154,177";"-";"154,150";"-";"-";"-";"-";"0,00";"-";"-";"-";"-";"-";"-";"-";"-";"-";"-";"-";"-";"-";"-";"-";"-";"-";"-";"-";"-";"-";"-";"-";"-";"-"
"25 List 2024 13:52:53";"Transakcja Sprzedaży";"O2-DC-9CSVGN";"T2-DC-5P20C0";"-";"USD/JPY";"100 000 Jednost.";"154,177";"-";"-";"-";"-";"4,139242";"413 924,20";"0,00";"-";"-";"-";"-";"-";"-";"-";"-";"-";"-";"-";"-";"-";"-";"-";"-";"-";"-";"-";"-";"-";"-";"-";"-";"-"
"25 List 2024 13:51:11";"Stop Loss";"O2-DC-9CSVCC";"T2-DC-5P208W";"-";"USD/JPY";"100 000 Jednost.";"154,200";"-";"-";"-";"-";"0,026587";"414 051,40";"61,15";"20 691,46";"-";"-";"-";"-";"-";"-";"-";"-";"-";"-";"-";"-";"-";"-";"-";"-";"-";"-";"-";"-";"-";"-";"-";"-"
"25 List 2024 13:50:48";"Zmodyfikowano Stop Loss";"O2-DC-9CSVCC";"-";"O2-DC-9CSVED";"USD/JPY";"100 000 Jednost.";"154,223";"-";"154,200";"-";"-";"-";"-";"-";"-";"-";"-";"-";"-";"-";"-";"-";"-";"-";"-";"-";"-";"-";"-";"-";"-";"-";"-";"-";"-";"-";"-";"-";"-"
"25 List 2024 13:50:31";"Zmodyfikowano Transakcję Sprzedaży";"O2-DC-9CSVCC";"T2-DC-5P206D";"-";"USD/JPY";"100 000 Jednost.";"154,223";"-";"154,210";"-";"-";"-";"-";"0,00";"-";"-";"-";"-";"-";"-";"-";"-";"-";"-";"-";"-";"-";"-";"-";"-";"-";"-";"-";"-";"-";"-";"-";"-";"-"
"25 List 2024 13:48:58";"Transakcja Sprzedaży";"O2-DC-9CSVCC";"T2-DC-5P206D";"-";"USD/JPY";"100 000 Jednost.";"154,223";"-";"-";"-";"-";"4,140735";"414 073,50";"0,00";"-";"-";"-";"-";"-";"-";"-";"-";"-";"-";"-";"-";"-";"-";"-";"-";"-";"-";"-";"-";"-";"-";"-";"-";"-"
"25 List 2024 13:44:54";" Zamknięcie Transakcji";"O2-DC-9CSV7B";"T2-DC-5P2034";"O2-DC-9CSSVK";"USD/JPY";"5 000 Jednost.";"154,290";"-";"-";"-";"-";"0,026587";"20 716,30";"29,11";"20 630,31";"-";"-";"-";"-";"-";"-";"-";"-";"-";"-";"-";"-";"-";"-";"-";"-";"-";"-";"-";"-";"-";"-";"-";"-"
"25 List 2024 13:31:28";" Zamknięcie Transakcji";"O2-DC-9CSTQG";"T2-DC-5P1ZMV";"O2-DC-9CSTF7";"USD/JPY";"11 000 Jednost.";"154,440";"-";"-";"-";"-";"0,026601";"45 644,74";"33,65";"20 601,20";"-";"-";"-";"-";"-";"-";"-";"-";"-";"-";"-";"-";"-";"-";"-";"-";"-";"-";"-";"-";"-";"-";"-";"-"
"25 List 2024 13:30:24";"Take Profit";"O2-DC-9CSRXG";"T2-DC-5P1ZM0";"-";"USD/JPY";"100 000 Jednost.";"154,450";"-";"-";"-";"-";"0,026592";"414 906,10";"47,87";"20 567,55";"-";"-";"-";"-";"-";"-";"-";"-";"-";"-";"-";"-";"-";"-";"-";"-";"-";"-";"-";"-";"-";"-";"-";"-"
"25 List 2024 13:23:55";"Transakcja Sprzedaży";"O2-DC-9CSTF7";"T2-DC-5P1ZFJ";"-";"USD/JPY";"11 000 Jednost.";"154,555";"-";"-";"-";"-";"4,151416";"45 665,57";"0,00";"-";"-";"-";"-";"-";"-";"-";"-";"-";"-";"-";"-";"-";"-";"-";"-";"-";"-";"-";"-";"-";"-";"-";"-";"-"
"25 List 2024 13:18:16";"Zmodyfikowano Transakcję Sprzedaży";"O2-DC-9CSRXG";"T2-DC-5P1Y89";"-";"USD/JPY";"100 000 Jednost.";"154,468";"-";"-";"154,450";"-";"-";"-";"0,00";"-";"-";"-";"-";"-";"-";"-";"-";"-";"-";"-";"-";"-";"-";"-";"-";"-";"-";"-";"-";"-";"-";"-";"-";"-"
"25 List 2024 13:10:58";"Transakcja Sprzedaży";"O2-DC-9CSSVK";"T2-DC-5P1YZL";"-";"USD/JPY";"100 000 Jednost.";"154,509";"-";"-";"-";"-";"4,148109";"414 810,90";"0,00";"-";"-";"-";"-";"-";"-";"-";"-";"-";"-";"-";"-";"-";"-";"-";"-";"-";"-";"-";"-";"-";"-";"-";"-";"-"
"25 List 2024 13:08:07";" Zamknięcie Transakcji";"O2-DC-9CSSQG";"T2-DC-5P1YVL";"O2-DC-9CSSEG";"USD/JPY";"30 000 Jednost.";"154,451";"-";"-";"-";"-";"0,026574";"124 363,02";"62,18";"20 519,68";"-";"-";"-";"-";"-";"-";"-";"-";"-";"-";"-";"-";"-";"-";"-";"-";"-";"-";"-";"-";"-";"-";"-";"-"
"25 List 2024 13:07:26";"Stop Loss";"O2-DC-9CSN33";"T2-DC-5P1YV8";"-";"USD/JPY";"80 000 Jednost.";"154,440";"-";"-";"-";"-";"0,026579";"331 682,00";"10,63";"20 457,50";"-";"-";"-";"-";"-";"-";"-";"-";"-";"-";"-";"-";"-";"-";"-";"-";"-";"-";"-";"-";"-";"-";"-";"-"
"25 List 2024 13:07:25";"Zmodyfikowano Transakcję Sprzedaży";"O2-DC-9CSN33";"T2-DC-5P1V5X";"-";"USD/JPY";"80 000 Jednost.";"154,445";"-";"154,440";"-";"-";"-";"-";"0,00";"-";"-";"-";"-";"-";"-";"-";"-";"-";"-";"-";"-";"-";"-";"-";"-";"-";"-";"-";"-";"-";"-";"-";"-";"-"
"25 List 2024 13:00:50";"Transakcja Sprzedaży";"O2-DC-9CSSEG";"T2-DC-5P1YMN";"-";"USD/JPY";"30 000 Jednost.";"154,529";"-";"-";"-";"-";"4,147448";"124 423,44";"0,00";"-";"-";"-";"-";"-";"-";"-";"-";"-";"-";"-";"-";"-";"-";"-";"-";"-";"-";"-";"-";"-";"-";"-";"-";"-"
"25 List 2024 12:48:46";"Transakcja Sprzedaży";"O2-DC-9CSRXG";"T2-DC-5P1Y89";"-";"USD/JPY";"100 000 Jednost.";"154,468";"-";"-";"-";"-";"4,147939";"414 793,90";"0,00";"-";"-";"-";"-";"-";"-";"-";"-";"-";"-";"-";"-";"-";"-";"-";"-";"-";"-";"-";"-";"-";"-";"-";"-";"-"
"25 List 2024 12:22:14";"Stop Loss";"O2-DB-9CQ1EQ";"T2-DC-5P1XJD";"-";"USD/JPY";"90 000 Jednost.";"154,340";"-";"-";"-";"-";"0,026576";"372 826,62";"19,13";"20 446,87";"-";"-";"-";"-";"-";"-";"-";"-";"-";"-";"-";"-";"-";"-";"-";"-";"-";"-";"-";"-";"-";"-";"-";"-"
"25 List 2024 12:22:00";"Zmodyfikowano Transakcję Sprzedaży";"O2-DB-9CQ1EQ";"T2-DB-5NZMJ3";"-";"USD/JPY";"90 000 Jednost.";"154,348";"-";"154,340";"154,300";"-";"-";"-";"0,00";"-";"-";"-";"-";"-";"-";"-";"-";"-";"-";"-";"-";"-";"-";"-";"-";"-";"-";"-";"-";"-";"-";"-";"-";"-"
"25 List 2024 11:58:02";"Odrzucono Zlecenie: brak wystarczających środków";"O2-DC-9CSPZ5";"-";"-";"USD/JPY";"40 000 Jednost.";"-";"-";"-";"-";"-";"-";"-";"-";"-";"-";"-";"-";"-";"-";"-";"-";"-";"-";"-";"-";"-";"-";"-";"-";"-";"-";"-";"-";"-";"-";"-";"-";"-"
"25 List 2024 11:57:46";"Odrzucono Zlecenie: brak wystarczających środków";"O2-DC-9CSPYY";"-";"-";"USD/JPY";"45 000 Jednost.";"-";"-";"-";"-";"-";"-";"-";"-";"-";"-";"-";"-";"-";"-";"-";"-";"-";"-";"-";"-";"-";"-";"-";"-";"-";"-";"-";"-";"-";"-";"-";"-";"-"
"25 List 2024 11:57:32";"Odrzucono Zlecenie: brak wystarczających środków";"O2-DC-9CSPYN";"-";"-";"USD/JPY";"50 000 Jednost.";"-";"-";"-";"-";"-";"-";"-";"-";"-";"-";"-";"-";"-";"-";"-";"-";"-";"-";"-";"-";"-";"-";"-";"-";"-";"-";"-";"-";"-";"-";"-";"-";"-"
"25 List 2024 11:20:27";"Zmodyfikowano Transakcję Sprzedaży";"O2-DB-9CQ1EQ";"T2-DB-5NZMJ3";"-";"USD/JPY";"90 000 Jednost.";"154,348";"-";"-";"154,300";"-";"-";"-";"0,00";"-";"-";"-";"-";"-";"-";"-";"-";"-";"-";"-";"-";"-";"-";"-";"-";"-";"-";"-";"-";"-";"-";"-";"-";"-"
"25 List 2024 11:00:55";"Transakcja Sprzedaży";"O2-DC-9CSN33";"T2-DC-5P1V5X";"-";"USD/JPY";"80 000 Jednost.";"154,445";"-";"-";"-";"-";"4,151857";"332 148,56";"0,00";"-";"-";"-";"-";"-";"-";"-";"-";"-";"-";"-";"-";"-";"-";"-";"-";"-";"-";"-";"-";"-";"-";"-";"-";"-"
"25 List 2024 10:51:01";"Stop Loss";"O2-DC-9CSH9G";"T2-DC-5P1TQE";"-";"USD/JPY";"64 000 Jednost.";"154,470";"-";"-";"-";"-";"0,026605";"265 627,13";"95,35";"20 427,74";"-";"-";"-";"-";"-";"-";"-";"-";"-";"-";"-";"-";"-";"-";"-";"-";"-";"-";"-";"-";"-";"-";"-";"-"
"25 List 2024 10:50:17";"Zmodyfikowano Stop Loss";"O2-DC-9CSH9G";"-";"O2-DC-9CSMBJ";"USD/JPY";"64 000 Jednost.";"154,526";"-";"154,470";"-";"-";"-";"-";"-";"-";"-";"-";"-";"-";"-";"-";"-";"-";"-";"-";"-";"-";"-";"-";"-";"-";"-";"-";"-";"-";"-";"-";"-";"-"
"25 List 2024 10:49:42";"Zmodyfikowano Transakcję Sprzedaży";"O2-DC-9CSH9G";"T2-DC-5P1QMJ";"-";"USD/JPY";"64 000 Jednost.";"154,526";"-";"154,480";"-";"-";"-";"-";"0,00";"-";"-";"-";"-";"-";"-";"-";"-";"-";"-";"-";"-";"-";"-";"-";"-";"-";"-";"-";"-";"-";"-";"-";"-";"-"
"25 List 2024 09:27:45";"Transakcja Sprzedaży";"O2-DC-9CSH9G";"T2-DC-5P1QMJ";"-";"USD/JPY";"64 000 Jednost.";"154,526";"-";"-";"-";"-";"4,16856";"266 787,84";"0,00";"-";"-";"-";"-";"-";"-";"-";"-";"-";"-";"-";"-";"-";"-";"-";"-";"-";"-";"-";"-";"-";"-";"-";"-";"-"
"25 List 2024 06:59:18";"Take Profit";"O2-DC-9CRXL0";"T2-DC-5P1KZP";"-";"USD/JPY";"54 000 Jednost.";"154,250";"-";"-";"-";"-";"0,026666";"224 351,20";"7,20";"20 332,39";"-";"-";"-";"-";"-";"-";"-";"-";"-";"-";"-";"-";"-";"-";"-";"-";"-";"-";"-";"-";"-";"-";"-";"-"
"25 List 2024 06:37:20";"Zmodyfikowano Transakcję Sprzedaży";"O2-DC-9CRXL0";"T2-DC-5P182Y";"-";"USD/JPY";"54 000 Jednost.";"154,255";"-";"-";"154,250";"-";"-";"-";"0,00";"-";"-";"-";"-";"-";"-";"-";"-";"-";"-";"-";"-";"-";"-";"-";"-";"-";"-";"-";"-";"-";"-";"-";"-";"-"
"25 List 2024 00:07:18";"Transakcja Sprzedaży";"O2-DC-9CRXL0";"T2-DC-5P182Y";"-";"USD/JPY";"54 000 Jednost.";"154,255";"-";"-";"-";"-";"4,162588";"224 779,75";"0,00";"-";"-";"-";"-";"-";"-";"-";"-";"-";"-";"-";"-";"-";"-";"-";"-";"-";"-";"-";"-";"-";"-";"-";"-";"-"
"24 List 2024 22:10:20";" Zamknięcie Transakcji";"O2-DC-9CRVL0";"T2-DC-5P15YV";"O2-DB-9CQ1EQ";"USD/JPY";"10 000 Jednost.";"154,204";"-";"-";"-";"-";"0,02673";"41 623,48";"38,49";"20 325,19";"-";"-";"-";"-";"-";"-";"-";"-";"-";"-";"-";"-";"-";"-";"-";"-";"-";"-";"-";"-";"-";"-";"-";"-"
"22 List 2024 23:02:06";"Koszty Utrzymania Pozycji";"1390430705";"-";"-";"Rachunek";"-";"-";"-";"-";"-";"-";"-";"-";"-22,67";"20 286,70";"-";"-";"-";"-";"-";"-22,67";"-";"-";"-";"-";"-";"-";"-";"-";"-";"-";"-";"-";"-";"-";"-";"-";"-";"-"
"22 List 2024 23:02:06";"Koszty Utrzymania Pozycji";"O2-D9-9BJZX7";"-";"-";"USD/JPY";"-";"-";"-";"-";"-";"-";"-";"-";"-";"-";"-";"-";"30 000,00";"5,52678%";"-19,00";"0,00";"-";"-";"-";"-";"-";"-";"-";"-";"-";"-";"-";"-";"-";"-";"-";"-";"-";"-"
"22 List 2024 23:02:06";"Koszty Utrzymania Pozycji";"O2-D9-9BB04B";"-";"-";"USD/JPY";"-";"-";"-";"-";"-";"-";"-";"-";"-";"-";"-";"-";"34 000,00";"5,52678%";"-21,53";"0,00";"-";"-";"-";"-";"-";"-";"-";"-";"-";"-";"-";"-";"-";"-";"-";"-";"-";"-"
"22 List 2024 23:02:06";"Koszty Utrzymania Pozycji";"O2-DB-9C9X8L";"-";"-";"USD/JPY";"-";"-";"-";"-";"-";"-";"-";"-";"-";"-";"-";"-";"20 000,00";"3,49372%";"7,93";"0,00";"-";"-";"-";"-";"-";"-";"-";"-";"-";"-";"-";"-";"-";"-";"-";"-";"-";"-"
"22 List 2024 23:02:06";"Koszty Utrzymania Pozycji";"O2-DB-9CQYNM";"-";"-";"USD/JPY";"-";"-";"-";"-";"-";"-";"-";"-";"-";"-";"-";"-";"100 000,00";"3,49372%";"39,63";"0,00";"-";"-";"-";"-";"-";"-";"-";"-";"-";"-";"-";"-";"-";"-";"-";"-";"-";"-"
"22 List 2024 23:02:06";"Koszty Utrzymania Pozycji";"O2-D9-9BS5RZ";"-";"-";"USD/JPY";"-";"-";"-";"-";"-";"-";"-";"-";"-";"-";"-";"-";"22 000,00";"5,52678%";"-13,93";"0,00";"-";"-";"-";"-";"-";"-";"-";"-";"-";"-";"-";"-";"-";"-";"-";"-";"-";"-"
"22 List 2024 23:02:06";"Koszty Utrzymania Pozycji";"O2-DB-9CKXH9";"-";"-";"USD/JPY";"-";"-";"-";"-";"-";"-";"-";"-";"-";"-";"-";"-";"90 000,00";"3,49372%";"35,67";"0,00";"-";"-";"-";"-";"-";"-";"-";"-";"-";"-";"-";"-";"-";"-";"-";"-";"-";"-"
"22 List 2024 23:02:06";"Koszty Utrzymania Pozycji";"O2-DB-9CQ1EQ";"-";"-";"USD/JPY";"-";"-";"-";"-";"-";"-";"-";"-";"-";"-";"-";"-";"100 000,00";"5,52678%";"-63,33";"0,00";"-";"-";"-";"-";"-";"-";"-";"-";"-";"-";"-";"-";"-";"-";"-";"-";"-";"-"
"22 List 2024 23:02:06";"Koszty Utrzymania Pozycji";"O2-DB-9C9XVJ";"-";"-";"USD/JPY";"-";"-";"-";"-";"-";"-";"-";"-";"-";"-";"-";"-";"30 000,00";"3,49372%";"11,89";"0,00";"-";"-";"-";"-";"-";"-";"-";"-";"-";"-";"-";"-";"-";"-";"-";"-";"-";"-"
"22 List 2024 20:43:16";" Zmodyfikowano Transakcję Kupna";"O2-DB-9CQYNM";"T2-DB-5P0E5V";"-";"USD/JPY";"100 000 Jednost.";"154,952";"-";"-";"-";"-";"-";"-";"0,00";"-";"-";"-";"-";"-";"-";"-";"-";"-";"-";"-";"-";"-";"-";"-";"-";"-";"-";"-";"-";"-";"-";"-";"-";"-"
"22 List 2024 18:01:40";"Stop Loss";"O2-DB-9CRCQN";"T2-DB-5P0RTX";"-";"USD/JPY";"90 000 Jednost.";"154,710";"-";"-";"-";"-";"0,026796";"376 848,63";"26,53";"20 309,37";"-";"-";"-";"-";"-";"-";"-";"-";"-";"-";"-";"-";"-";"-";"-";"-";"-";"-";"-";"-";"-";"-";"-";"-"
"22 List 2024 18:01:24";"Zmodyfikowano Transakcję Sprzedaży";"O2-DB-9CRCQN";"T2-DB-5P0RLY";"-";"USD/JPY";"90 000 Jednost.";"154,721";"-";"154,710";"-";"-";"-";"-";"0,00";"-";"-";"-";"-";"-";"-";"-";"-";"-";"-";"-";"-";"-";"-";"-";"-";"-";"-";"-";"-";"-";"-";"-";"-";"-"
"22 List 2024 17:58:45";"Transakcja Sprzedaży";"O2-DB-9CRCQN";"T2-DB-5P0RLY";"-";"USD/JPY";"90 000 Jednost.";"154,721";"-";"-";"-";"-";"4,189151";"377 023,59";"0,00";"-";"-";"-";"-";"-";"-";"-";"-";"-";"-";"-";"-";"-";"-";"-";"-";"-";"-";"-";"-";"-";"-";"-";"-";"-"
"22 List 2024 17:49:42";" Zmodyfikowano Transakcję Kupna";"O2-DB-9CQYNM";"T2-DB-5P0E5V";"-";"USD/JPY";"100 000 Jednost.";"154,952";"-";"-";"154,960";"-";"-";"-";"0,00";"-";"-";"-";"-";"-";"-";"-";"-";"-";"-";"-";"-";"-";"-";"-";"-";"-";"-";"-";"-";"-";"-";"-";"-";"-"
"22 List 2024 17:48:42";"Stop Loss";"O2-DB-9CR93P";"T2-DB-5P0R1J";"-";"USD/JPY";"90 000 Jednost.";"154,800";"-";"-";"-";"-";"0,026787";"376 921,71";"28,93";"20 282,84";"-";"-";"-";"-";"-";"-";"-";"-";"-";"-";"-";"-";"-";"-";"-";"-";"-";"-";"-";"-";"-";"-";"-";"-"
"22 List 2024 17:48:33";"Zmodyfikowano Transakcję Sprzedaży";"O2-DB-9CR93P";"T2-DB-5P0PFF";"-";"USD/JPY";"90 000 Jednost.";"154,812";"-";"154,800";"-";"-";"-";"-";"0,00";"-";"-";"-";"-";"-";"-";"-";"-";"-";"-";"-";"-";"-";"-";"-";"-";"-";"-";"-";"-";"-";"-";"-";"-";"-"
"22 List 2024 17:38:22";"Zmodyfikowano Transakcję Sprzedaży";"O2-DB-9CR93P";"T2-DB-5P0PFF";"-";"USD/JPY";"90 000 Jednost.";"154,812";"-";"-";"-";"-";"-";"-";"0,00";"-";"-";"-";"-";"-";"-";"-";"-";"-";"-";"-";"-";"-";"-";"-";"-";"-";"-";"-";"-";"-";"-";"-";"-";"-"
"22 List 2024 17:38:05";" Zmodyfikowano Transakcję Kupna";"O2-DB-9CQYNM";"T2-DB-5P0E5V";"-";"USD/JPY";"100 000 Jednost.";"154,952";"-";"-";"-";"-";"-";"-";"0,00";"-";"-";"-";"-";"-";"-";"-";"-";"-";"-";"-";"-";"-";"-";"-";"-";"-";"-";"-";"-";"-";"-";"-";"-";"-"
"22 List 2024 17:23:01";"Zmodyfikowano Transakcję Sprzedaży";"O2-DB-9CR93P";"T2-DB-5P0PFF";"-";"USD/JPY";"90 000 Jednost.";"154,812";"-";"154,948";"-";"-";"-";"-";"0,00";"-";"-";"-";"-";"-";"-";"-";"-";"-";"-";"-";"-";"-";"-";"-";"-";"-";"-";"-";"-";"-";"-";"-";"-";"-"
"22 List 2024 17:20:57";"Transakcja Sprzedaży";"O2-DB-9CR93P";"T2-DB-5P0PFF";"-";"USD/JPY";"90 000 Jednost.";"154,812";"-";"-";"-";"-";"4,192277";"377 304,93";"0,00";"-";"-";"-";"-";"-";"-";"-";"-";"-";"-";"-";"-";"-";"-";"-";"-";"-";"-";"-";"-";"-";"-";"-";"-";"-"
"22 List 2024 17:20:05";"Stop Loss";"O2-DB-9CR8XH";"T2-DB-5P0PBW";"-";"USD/JPY";"90 000 Jednost.";"154,850";"-";"-";"-";"-";"0,026797";"377 172,36";"9,65";"20 253,91";"-";"-";"-";"-";"-";"-";"-";"-";"-";"-";"-";"-";"-";"-";"-";"-";"-";"-";"-";"-";"-";"-";"-";"-"
"22 List 2024 17:19:57";"Zmodyfikowano Transakcję Sprzedaży";"O2-DB-9CR8XH";"T2-DB-5P0P7E";"-";"USD/JPY";"90 000 Jednost.";"154,854";"-";"154,850";"-";"-";"-";"-";"0,00";"-";"-";"-";"-";"-";"-";"-";"-";"-";"-";"-";"-";"-";"-";"-";"-";"-";"-";"-";"-";"-";"-";"-";"-";"-"
"22 List 2024 17:19:16";"Transakcja Sprzedaży";"O2-DB-9CR8XH";"T2-DB-5P0P7E";"-";"USD/JPY";"90 000 Jednost.";"154,854";"-";"-";"-";"-";"4,190474";"377 142,66";"0,00";"-";"-";"-";"-";"-";"-";"-";"-";"-";"-";"-";"-";"-";"-";"-";"-";"-";"-";"-";"-";"-";"-";"-";"-";"-"
"22 List 2024 17:14:19";"Stop Loss";"O2-DB-9CR8FQ";"T2-DB-5P0NXP";"-";"USD/JPY";"90 000 Jednost.";"154,810";"-";"-";"-";"-";"0,026786";"376 912,71";"33,75";"20 244,26";"-";"-";"-";"-";"-";"-";"-";"-";"-";"-";"-";"-";"-";"-";"-";"-";"-";"-";"-";"-";"-";"-";"-";"-"
"22 List 2024 17:14:00";"Zmodyfikowano Transakcję Sprzedaży";"O2-DB-9CR8FQ";"T2-DB-5P0NTL";"-";"USD/JPY";"90 000 Jednost.";"154,824";"-";"154,810";"-";"-";"-";"-";"0,00";"-";"-";"-";"-";"-";"-";"-";"-";"-";"-";"-";"-";"-";"-";"-";"-";"-";"-";"-";"-";"-";"-";"-";"-";"-"
"22 List 2024 17:13:07";"Transakcja Sprzedaży";"O2-DB-9CR8FQ";"T2-DB-5P0NTL";"-";"USD/JPY";"90 000 Jednost.";"154,824";"-";"-";"-";"-";"4,187358";"376 862,22";"0,00";"-";"-";"-";"-";"-";"-";"-";"-";"-";"-";"-";"-";"-";"-";"-";"-";"-";"-";"-";"-";"-";"-";"-";"-";"-"
"22 List 2024 16:33:10";"Stop Loss";"O2-DB-9CR4RF";"T2-DB-5P0KHD";"-";"USD/JPY";"90 000 Jednost.";"154,800";"-";"-";"-";"-";"0,026781";"376 821,63";"43,39";"20 210,51";"-";"-";"-";"-";"-";"-";"-";"-";"-";"-";"-";"-";"-";"-";"-";"-";"-";"-";"-";"-";"-";"-";"-";"-"
"22 List 2024 16:33:10";"Zmodyfikowano Transakcję Sprzedaży";"O2-DB-9CR4RF";"T2-DB-5P0KFR";"-";"USD/JPY";"90 000 Jednost.";"154,818";"-";"154,800";"-";"-";"-";"-";"0,00";"-";"-";"-";"-";"-";"-";"-";"-";"-";"-";"-";"-";"-";"-";"-";"-";"-";"-";"-";"-";"-";"-";"-";"-";"-"
"22 List 2024 16:32:32";"Transakcja Sprzedaży";"O2-DB-9CR4RF";"T2-DB-5P0KFR";"-";"USD/JPY";"90 000 Jednost.";"154,818";"-";"-";"-";"-";"4,187408";"376 866,72";"0,00";"-";"-";"-";"-";"-";"-";"-";"-";"-";"-";"-";"-";"-";"-";"-";"-";"-";"-";"-";"-";"-";"-";"-";"-";"-"
"22 List 2024 16:27:30";"Stop Loss";"O2-DB-9CR3J5";"T2-DB-5P0JMS";"-";"USD/JPY";"90 000 Jednost.";"154,700";"-";"-";"-";"-";"0,026779";"376 560,09";"257,88";"20 167,12";"-";"-";"-";"-";"-";"-";"-";"-";"-";"-";"-";"-";"-";"-";"-";"-";"-";"-";"-";"-";"-";"-";"-";"-"
"22 List 2024 16:27:14";"Zmodyfikowano Stop Loss";"O2-DB-9CR3J5";"-";"O2-DB-9CR3TR";"USD/JPY";"90 000 Jednost.";"154,807";"-";"154,700";"-";"-";"-";"-";"-";"-";"-";"-";"-";"-";"-";"-";"-";"-";"-";"-";"-";"-";"-";"-";"-";"-";"-";"-";"-";"-";"-";"-";"-";"-"
"22 List 2024 16:26:58";"Zmodyfikowano Stop Loss";"O2-DB-9CR3J5";"-";"O2-DB-9CR3TR";"USD/JPY";"90 000 Jednost.";"154,807";"-";"154,720";"-";"-";"-";"-";"-";"-";"-";"-";"-";"-";"-";"-";"-";"-";"-";"-";"-";"-";"-";"-";"-";"-";"-";"-";"-";"-";"-";"-";"-";"-"
"22 List 2024 16:26:35";"Zmodyfikowano Stop Loss";"O2-DB-9CR3J5";"-";"O2-DB-9CR3TR";"USD/JPY";"90 000 Jednost.";"154,807";"-";"154,730";"-";"-";"-";"-";"-";"-";"-";"-";"-";"-";"-";"-";"-";"-";"-";"-";"-";"-";"-";"-";"-";"-";"-";"-";"-";"-";"-";"-";"-";"-"
"22 List 2024 16:26:23";"Zmodyfikowano Stop Loss";"O2-DB-9CR3J5";"-";"O2-DB-9CR3TR";"USD/JPY";"90 000 Jednost.";"154,807";"-";"154,760";"-";"-";"-";"-";"-";"-";"-";"-";"-";"-";"-";"-";"-";"-";"-";"-";"-";"-";"-";"-";"-";"-";"-";"-";"-";"-";"-";"-";"-";"-"
"22 List 2024 16:26:09";"Zmodyfikowano Transakcję Sprzedaży";"O2-DB-9CR3J5";"T2-DB-5P0J9M";"-";"USD/JPY";"90 000 Jednost.";"154,807";"-";"154,790";"-";"-";"-";"-";"0,00";"-";"-";"-";"-";"-";"-";"-";"-";"-";"-";"-";"-";"-";"-";"-";"-";"-";"-";"-";"-";"-";"-";"-";"-";"-"
"22 List 2024 16:23:41";"Transakcja Sprzedaży";"O2-DB-9CR3J5";"T2-DB-5P0J9M";"-";"USD/JPY";"90 000 Jednost.";"154,807";"-";"-";"-";"-";"4,184231";"376 580,79";"0,00";"-";"-";"-";"-";"-";"-";"-";"-";"-";"-";"-";"-";"-";"-";"-";"-";"-";"-";"-";"-";"-";"-";"-";"-";"-"
"22 List 2024 16:11:04";"Stop Loss";"O2-DB-9CR1RL";"T2-DB-5P0H1R";"-";"USD/JPY";"90 000 Jednost.";"154,700";"-";"-";"-";"-";"0,026804";"376 891,02";"113,38";"19 909,24";"-";"-";"-";"-";"-";"-";"-";"-";"-";"-";"-";"-";"-";"-";"-";"-";"-";"-";"-";"-";"-";"-";"-";"-"
"22 List 2024 16:10:34";"Zmodyfikowano Transakcję Sprzedaży";"O2-DB-9CR1RL";"T2-DB-5P0GR7";"-";"USD/JPY";"90 000 Jednost.";"154,747";"-";"154,700";"-";"-";"-";"-";"0,00";"-";"-";"-";"-";"-";"-";"-";"-";"-";"-";"-";"-";"-";"-";"-";"-";"-";"-";"-";"-";"-";"-";"-";"-";"-"
"22 List 2024 16:09:48";"Transakcja Sprzedaży";"O2-DB-9CR1RL";"T2-DB-5P0GR7";"-";"USD/JPY";"90 000 Jednost.";"154,747";"-";"-";"-";"-";"4,186155";"376 753,95";"0,00";"-";"-";"-";"-";"-";"-";"-";"-";"-";"-";"-";"-";"-";"-";"-";"-";"-";"-";"-";"-";"-";"-";"-";"-";"-"
"22 List 2024 15:52:54";" Zmodyfikowano Transakcję Kupna";"O2-DB-9CQYNM";"T2-DB-5P0E5V";"-";"USD/JPY";"100 000 Jednost.";"154,952";"-";"-";"154,960";"-";"-";"-";"0,00";"-";"-";"-";"-";"-";"-";"-";"-";"-";"-";"-";"-";"-";"-";"-";"-";"-";"-";"-";"-";"-";"-";"-";"-";"-"
"22 List 2024 15:49:58";" Transakcja Kupna";"O2-DB-9CQYNM";"T2-DB-5P0E5V";"-";"USD/JPY";"100 000 Jednost.";"154,952";"-";"-";"-";"-";"4,190684";"419 068,40";"0,00";"-";"-";"-";"-";"-";"-";"-";"-";"-";"-";"-";"-";"-";"-";"-";"-";"-";"-";"-";"-";"-";"-";"-";"-";"-"
"22 List 2024 15:48:35";"Stop Loss";"O2-DB-9CQY4Z";"T2-DB-5P0E02";"-";"USD/JPY";"100 000 Jednost.";"154,940";"-";"-";"-";"-";"0,026766";"418 981,20";"168,63";"19 795,86";"-";"-";"-";"-";"-";"-";"-";"-";"-";"-";"-";"-";"-";"-";"-";"-";"-";"-";"-";"-";"-";"-";"-";"-"
"22 List 2024 15:47:57";"Zmodyfikowano Stop Loss";"O2-DB-9CQY4Z";"-";"O2-DB-9CQY8N";"USD/JPY";"100 000 Jednost.";"154,877";"-";"154,940";"-";"-";"-";"-";"-";"-";"-";"-";"-";"-";"-";"-";"-";"-";"-";"-";"-";"-";"-";"-";"-";"-";"-";"-";"-";"-";"-";"-";"-";"-"
"22 List 2024 15:47:36";" Zmodyfikowano Transakcję Kupna";"O2-DB-9CQY4Z";"T2-DB-5P0DR3";"-";"USD/JPY";"100 000 Jednost.";"154,877";"-";"154,920";"-";"-";"-";"-";"0,00";"-";"-";"-";"-";"-";"-";"-";"-";"-";"-";"-";"-";"-";"-";"-";"-";"-";"-";"-";"-";"-";"-";"-";"-";"-"
"22 List 2024 15:46:59";" Transakcja Kupna";"O2-DB-9CQY4Z";"T2-DB-5P0DR3";"-";"USD/JPY";"100 000 Jednost.";"154,877";"-";"-";"-";"-";"4,187658";"418 765,80";"0,00";"-";"-";"-";"-";"-";"-";"-";"-";"-";"-";"-";"-";"-";"-";"-";"-";"-";"-";"-";"-";"-";"-";"-";"-";"-"
"22 List 2024 15:33:54";"Stop Loss";"O2-DB-9CQVBH";"T2-DB-5P0BE7";"-";"USD/JPY";"100 000 Jednost.";"154,710";"-";"-";"-";"-";"0,026767";"418 308,90";"8,03";"19 627,23";"-";"-";"-";"-";"-";"-";"-";"-";"-";"-";"-";"-";"-";"-";"-";"-";"-";"-";"-";"-";"-";"-";"-";"-"
"22 List 2024 15:32:37";" Zmodyfikowano Transakcję Kupna";"O2-DB-9CQVBH";"T2-DB-5P0B3N";"-";"USD/JPY";"100 000 Jednost.";"154,707";"-";"154,710";"-";"-";"-";"-";"0,00";"-";"-";"-";"-";"-";"-";"-";"-";"-";"-";"-";"-";"-";"-";"-";"-";"-";"-";"-";"-";"-";"-";"-";"-";"-"
"22 List 2024 15:32:05";" Transakcja Kupna";"O2-DB-9CQVBH";"T2-DB-5P0B3N";"-";"USD/JPY";"100 000 Jednost.";"154,707";"-";"-";"-";"-";"4,184402";"418 440,20";"0,00";"-";"-";"-";"-";"-";"-";"-";"-";"-";"-";"-";"-";"-";"-";"-";"-";"-";"-";"-";"-";"-";"-";"-";"-";"-"
"22 List 2024 15:25:24";"Stop Loss";"O2-DB-9CQTD6";"T2-DB-5P09C9";"-";"USD/JPY";"100 000 Jednost.";"154,650";"-";"-";"-";"-";"0,02679";"418 544,40";"26,79";"19 619,20";"-";"-";"-";"-";"-";"-";"-";"-";"-";"-";"-";"-";"-";"-";"-";"-";"-";"-";"-";"-";"-";"-";"-";"-"
"22 List 2024 15:25:18";" Zmodyfikowano Transakcję Kupna";"O2-DB-9CQTD6";"T2-DB-5P0972";"-";"USD/JPY";"100 000 Jednost.";"154,640";"-";"154,650";"-";"-";"-";"-";"0,00";"-";"-";"-";"-";"-";"-";"-";"-";"-";"-";"-";"-";"-";"-";"-";"-";"-";"-";"-";"-";"-";"-";"-";"-";"-"
"22 List 2024 15:22:29";" Transakcja Kupna";"O2-DB-9CQTD6";"T2-DB-5P0972";"-";"USD/JPY";"100 000 Jednost.";"154,640";"-";"-";"-";"-";"4,186005";"418 600,50";"0,00";"-";"-";"-";"-";"-";"-";"-";"-";"-";"-";"-";"-";"-";"-";"-";"-";"-";"-";"-";"-";"-";"-";"-";"-";"-"
"22 List 2024 15:09:05";" Zmodyfikowano Transakcję Kupna";"O2-DB-9CKXH9";"T2-DB-5NWCP4";"-";"USD/JPY";"90 000 Jednost.";"155,516";"-";"-";"-";"-";"-";"-";"0,00";"-";"-";"-";"-";"-";"-";"-";"-";"-";"-";"-";"-";"-";"-";"-";"-";"-";"-";"-";"-";"-";"-";"-";"-";"-"
"22 List 2024 15:08:32";"Stop Loss";"O2-DB-9CQLPN";"T2-DB-5P08N9";"-";"USD/JPY";"100 000 Jednost.";"154,460";"-";"-";"-";"-";"0,026785";"417 901,10";"144,64";"19 592,41";"-";"-";"-";"-";"-";"-";"-";"-";"-";"-";"-";"-";"-";"-";"-";"-";"-";"-";"-";"-";"-";"-";"-";"-"
"22 List 2024 15:08:26";"Zmodyfikowano Stop Loss";"O2-DB-9CQLPN";"-";"O2-DB-9CQSS2";"USD/JPY";"100 000 Jednost.";"154,406";"-";"154,460";"-";"-";"-";"-";"-";"-";"-";"-";"-";"-";"-";"-";"-";"-";"-";"-";"-";"-";"-";"-";"-";"-";"-";"-";"-";"-";"-";"-";"-";"-"
"22 List 2024 15:08:08";" Zmodyfikowano Transakcję Kupna";"O2-DB-9CQLPN";"T2-DB-5P04VW";"-";"USD/JPY";"100 000 Jednost.";"154,406";"-";"154,440";"-";"-";"-";"-";"0,00";"-";"-";"-";"-";"-";"-";"-";"-";"-";"-";"-";"-";"-";"-";"-";"-";"-";"-";"-";"-";"-";"-";"-";"-";"-"
"22 List 2024 14:22:34";" Transakcja Kupna";"O2-DB-9CQLPN";"T2-DB-5P04VW";"-";"USD/JPY";"100 000 Jednost.";"154,406";"-";"-";"-";"-";"4,178259";"417 825,90";"0,00";"-";"-";"-";"-";"-";"-";"-";"-";"-";"-";"-";"-";"-";"-";"-";"-";"-";"-";"-";"-";"-";"-";"-";"-";"-"
"22 List 2024 13:27:42";"Stop Loss";"O2-DB-9CQEL3";"T2-DB-5P0277";"-";"USD/JPY";"100 000 Jednost.";"154,480";"-";"-";"-";"-";"0,026867";"419 252,80";"37,61";"19 447,77";"-";"-";"-";"-";"-";"-";"-";"-";"-";"-";"-";"-";"-";"-";"-";"-";"-";"-";"-";"-";"-";"-";"-";"-"
"22 List 2024 13:27:35";" Zmodyfikowano Transakcję Kupna";"O2-DB-9CQEL3";"T2-DB-5NZZHG";"-";"USD/JPY";"100 000 Jednost.";"154,466";"-";"154,480";"-";"-";"-";"-";"0,00";"-";"-";"-";"-";"-";"-";"-";"-";"-";"-";"-";"-";"-";"-";"-";"-";"-";"-";"-";"-";"-";"-";"-";"-";"-"
"22 List 2024 12:28:42";" Transakcja Kupna";"O2-DB-9CQEL3";"T2-DB-5NZZHG";"-";"USD/JPY";"100 000 Jednost.";"154,466";"-";"-";"-";"-";"4,1836";"418 360,00";"0,00";"-";"-";"-";"-";"-";"-";"-";"-";"-";"-";"-";"-";"-";"-";"-";"-";"-";"-";"-";"-";"-";"-";"-";"-";"-"
"22 List 2024 12:20:23";"Stop Loss";"O2-DB-9CQDSN";"T2-DB-5NZZ5H";"-";"USD/JPY";"100 000 Jednost.";"154,410";"-";"-";"-";"-";"0,026846";"418 739,80";"99,33";"19 410,16";"-";"-";"-";"-";"-";"-";"-";"-";"-";"-";"-";"-";"-";"-";"-";"-";"-";"-";"-";"-";"-";"-";"-";"-"
"22 List 2024 12:18:24";" Zmodyfikowano Transakcję Kupna";"O2-DB-9CQDSN";"T2-DB-5NZYVM";"-";"USD/JPY";"100 000 Jednost.";"154,373";"-";"154,410";"-";"-";"-";"-";"0,00";"-";"-";"-";"-";"-";"-";"-";"-";"-";"-";"-";"-";"-";"-";"-";"-";"-";"-";"-";"-";"-";"-";"-";"-";"-"
"22 List 2024 12:13:00";" Transakcja Kupna";"O2-DB-9CQDSN";"T2-DB-5NZYVM";"-";"USD/JPY";"100 000 Jednost.";"154,373";"-";"-";"-";"-";"4,185534";"418 553,40";"0,00";"-";"-";"-";"-";"-";"-";"-";"-";"-";"-";"-";"-";"-";"-";"-";"-";"-";"-";"-";"-";"-";"-";"-";"-";"-"
"22 List 2024 11:32:09";"Take Profit";"O2-DB-9CQ7XH";"T2-DB-5NZWRF";"-";"USD/JPY";"100 000 Jednost.";"154,400";"-";"-";"-";"-";"0,0271221";"418 778,80";"-81,37";"19 310,83";"-";"-";"-";"-";"-";"-";"-";"-";"-";"-";"-";"-";"-";"-";"-";"-";"-";"-";"-";"-";"-";"-";"-";"-"
"22 List 2024 11:23:42";" Zmodyfikowano Transakcję Kupna";"O2-DB-9CQ7XH";"T2-DB-5NZTJL";"-";"USD/JPY";"100 000 Jednost.";"154,430";"-";"-";"154,400";"-";"-";"-";"0,00";"-";"-";"-";"-";"-";"-";"-";"-";"-";"-";"-";"-";"-";"-";"-";"-";"-";"-";"-";"-";"-";"-";"-";"-";"-"
"22 List 2024 11:14:47";" Transakcja Kupna";"O2-DB-9CQ7XH";"T2-DB-5NZTJL";"-";"USD/JPY";"100 000 Jednost.";"154,430";"-";"-";"-";"-";"4,201045";"420 104,50";"0,00";"-";"-";"-";"-";"-";"-";"-";"-";"-";"-";"-";"-";"-";"-";"-";"-";"-";"-";"-";"-";"-";"-";"-";"-";"-"
"22 List 2024 11:07:37";"Stop Loss";"O2-DB-9CQ63P";"T2-DB-5NZS36";"-";"USD/JPY";"95 000 Jednost.";"154,540";"-";"-";"-";"-";"0,026941";"399 538,08";"232,90";"19 392,20";"-";"-";"-";"-";"-";"-";"-";"-";"-";"-";"-";"-";"-";"-";"-";"-";"-";"-";"-";"-";"-";"-";"-";"-"
"22 List 2024 11:07:34";" Zmodyfikowano Transakcję Kupna";"O2-DB-9CQ63P";"T2-DB-5NZRRT";"-";"USD/JPY";"95 000 Jednost.";"154,449";"-";"154,540";"-";"-";"-";"-";"0,00";"-";"-";"-";"-";"-";"-";"-";"-";"-";"-";"-";"-";"-";"-";"-";"-";"-";"-";"-";"-";"-";"-";"-";"-";"-"
"22 List 2024 11:05:19";" Transakcja Kupna";"O2-DB-9CQ63P";"T2-DB-5NZRRT";"-";"USD/JPY";"95 000 Jednost.";"154,449";"-";"-";"-";"-";"4,204893";"399 464,83";"0,00";"-";"-";"-";"-";"-";"-";"-";"-";"-";"-";"-";"-";"-";"-";"-";"-";"-";"-";"-";"-";"-";"-";"-";"-";"-"
"22 List 2024 11:02:33";"Odrzucono Zlecenie: brak wystarczających środków";"O2-DB-9CQ5MR";"-";"-";"USD/JPY";"100 000 Jednost.";"-";"-";"-";"-";"-";"-";"-";"-";"-";"-";"-";"-";"-";"-";"-";"-";"-";"-";"-";"-";"-";"-";"-";"-";"-";"-";"-";"-";"-";"-";"-";"-";"-"
"22 List 2024 10:54:03";"Stop Loss";"O2-DB-9CQ1Z4";"T2-DB-5NZQLC";"-";"USD/JPY";"100 000 Jednost.";"154,395";"-";"-";"-";"-";"0,026872";"419 070,40";"16,12";"19 159,30";"-";"-";"-";"-";"-";"-";"-";"-";"-";"-";"-";"-";"-";"-";"-";"-";"-";"-";"-";"-";"-";"-";"-";"-"
"22 List 2024 10:53:36";" Zmodyfikowano Transakcję Kupna";"O2-DB-9CQ1Z4";"T2-DB-5NZN1E";"-";"USD/JPY";"100 000 Jednost.";"154,389";"-";"154,395";"-";"-";"-";"-";"0,00";"-";"-";"-";"-";"-";"-";"-";"-";"-";"-";"-";"-";"-";"-";"-";"-";"-";"-";"-";"-";"-";"-";"-";"-";"-"
"22 List 2024 10:39:28";" Transakcja Kupna";"O2-DB-9CQ1Z4";"T2-DB-5NZN1E";"-";"USD/JPY";"100 000 Jednost.";"154,389";"-";"-";"-";"-";"4,19341";"419 341,00";"0,00";"-";"-";"-";"-";"-";"-";"-";"-";"-";"-";"-";"-";"-";"-";"-";"-";"-";"-";"-";"-";"-";"-";"-";"-";"-"
"22 List 2024 10:36:37";"Transakcja Sprzedaży";"O2-DB-9CQ1EQ";"T2-DB-5NZMJ3";"-";"USD/JPY";"100 000 Jednost.";"154,348";"-";"-";"-";"-";"4,190263";"419 026,30";"0,00";"-";"-";"-";"-";"-";"-";"-";"-";"-";"-";"-";"-";"-";"-";"-";"-";"-";"-";"-";"-";"-";"-";"-";"-";"-"
"22 List 2024 10:31:28";"Stop Loss";"O2-DB-9CPVPW";"T2-DB-5NZL50";"-";"USD/JPY";"106 000 Jednost.";"154,460";"-";"-";"-";"-";"0,026872";"444 431,28";"37,03";"19 143,18";"-";"-";"-";"-";"-";"-";"-";"-";"-";"-";"-";"-";"-";"-";"-";"-";"-";"-";"-";"-";"-";"-";"-";"-"
"22 List 2024 10:31:26";"Zmodyfikowano Transakcję Sprzedaży";"O2-DB-9CPVPW";"T2-DB-5NZFN6";"-";"USD/JPY";"106 000 Jednost.";"154,473";"-";"154,460";"-";"-";"-";"-";"0,00";"-";"-";"-";"-";"-";"-";"-";"-";"-";"-";"-";"-";"-";"-";"-";"-";"-";"-";"-";"-";"-";"-";"-";"-";"-"
"22 List 2024 10:18:52";"Stop Loss";"O2-DB-9CPXJJ";"T2-DB-5NZHVB";"-";"USD/JPY";"100 000 Jednost.";"154,780";"-";"-";"-";"-";"0,026874";"420 206,70";"61,81";"19 106,15";"-";"-";"-";"-";"-";"-";"-";"-";"-";"-";"-";"-";"-";"-";"-";"-";"-";"-";"-";"-";"-";"-";"-";"-"
"22 List 2024 10:18:49";" Zmodyfikowano Transakcję Kupna";"O2-DB-9CPXJJ";"T2-DB-5NZHT2";"-";"USD/JPY";"100 000 Jednost.";"154,757";"-";"154,780";"-";"-";"-";"-";"0,00";"-";"-";"-";"-";"-";"-";"-";"-";"-";"-";"-";"-";"-";"-";"-";"-";"-";"-";"-";"-";"-";"-";"-";"-";"-"
"22 List 2024 10:18:17";" Transakcja Kupna";"O2-DB-9CPXJJ";"T2-DB-5NZHT2";"-";"USD/JPY";"100 000 Jednost.";"154,757";"-";"-";"-";"-";"4,203921";"420 392,10";"0,00";"-";"-";"-";"-";"-";"-";"-";"-";"-";"-";"-";"-";"-";"-";"-";"-";"-";"-";"-";"-";"-";"-";"-";"-";"-"
"22 List 2024 10:15:54";"Stop Loss";"O2-DB-9CPX68";"T2-DB-5NZHM0";"-";"USD/JPY";"100 000 Jednost.";"154,786";"-";"-";"-";"-";"0,026964";"421 534,30";"18,87";"19 044,34";"-";"-";"-";"-";"-";"-";"-";"-";"-";"-";"-";"-";"-";"-";"-";"-";"-";"-";"-";"-";"-";"-";"-";"-"
"22 List 2024 10:15:53";" Zmodyfikowano Transakcję Kupna";"O2-DB-9CPX68";"T2-DB-5NZHHS";"-";"USD/JPY";"100 000 Jednost.";"154,779";"-";"154,790";"-";"-";"-";"-";"0,00";"-";"-";"-";"-";"-";"-";"-";"-";"-";"-";"-";"-";"-";"-";"-";"-";"-";"-";"-";"-";"-";"-";"-";"-";"-"
"22 List 2024 10:15:04";" Transakcja Kupna";"O2-DB-9CPX68";"T2-DB-5NZHHS";"-";"USD/JPY";"100 000 Jednost.";"154,779";"-";"-";"-";"-";"4,222428";"422 242,80";"0,00";"-";"-";"-";"-";"-";"-";"-";"-";"-";"-";"-";"-";"-";"-";"-";"-";"-";"-";"-";"-";"-";"-";"-";"-";"-"
"22 List 2024 10:02:44";"Transakcja Sprzedaży";"O2-DB-9CPVPW";"T2-DB-5NZFN6";"-";"USD/JPY";"106 000 Jednost.";"154,473";"-";"-";"-";"-";"4,178921";"442 965,62";"0,00";"-";"-";"-";"-";"-";"-";"-";"-";"-";"-";"-";"-";"-";"-";"-";"-";"-";"-";"-";"-";"-";"-";"-";"-";"-"
"22 List 2024 09:53:06";"Stop Loss";"O2-DB-9CPTT4";"T2-DB-5NZF04";"-";"USD/JPY";"106 000 Jednost.";"154,440";"-";"-";"-";"-";"0,026732";"442 057,52";"28,34";"19 025,47";"-";"-";"-";"-";"-";"-";"-";"-";"-";"-";"-";"-";"-";"-";"-";"-";"-";"-";"-";"-";"-";"-";"-";"-"
"22 List 2024 09:53:06";"Zmodyfikowano Transakcję Sprzedaży";"O2-DB-9CPTT4";"T2-DB-5NZEV9";"-";"USD/JPY";"106 000 Jednost.";"154,450";"-";"154,440";"-";"-";"-";"-";"0,00";"-";"-";"-";"-";"-";"-";"-";"-";"-";"-";"-";"-";"-";"-";"-";"-";"-";"-";"-";"-";"-";"-";"-";"-";"-"
"22 List 2024 09:49:08";"Transakcja Sprzedaży";"O2-DB-9CPTT4";"T2-DB-5NZEV9";"-";"USD/JPY";"106 000 Jednost.";"154,450";"-";"-";"-";"-";"4,165714";"441 565,68";"0,00";"-";"-";"-";"-";"-";"-";"-";"-";"-";"-";"-";"-";"-";"-";"-";"-";"-";"-";"-";"-";"-";"-";"-";"-";"-"
"22 List 2024 09:48:00";" Zamknięcie Transakcji";"O2-DB-9CPTR6";"T2-DB-5NZET2";"O2-DB-9CPTJG";"USD/JPY";"106 000 Jednost.";"154,437";"-";"-";"-";"-";"0,026704";"441 556,14";"8,49";"18 997,13";"-";"-";"-";"-";"-";"-";"-";"-";"-";"-";"-";"-";"-";"-";"-";"-";"-";"-";"-";"-";"-";"-";"-";"-"
"22 List 2024 09:43:11";"Transakcja Sprzedaży";"O2-DB-9CPTJG";"T2-DB-5NZENE";"-";"USD/JPY";"106 000 Jednost.";"154,440";"-";"-";"-";"-";"4,165604";"441 554,02";"0,00";"-";"-";"-";"-";"-";"-";"-";"-";"-";"-";"-";"-";"-";"-";"-";"-";"-";"-";"-";"-";"-";"-";"-";"-";"-"
"22 List 2024 09:38:15";"Stop Loss";"O2-DB-9CPT6V";"T2-DB-5NZEGB";"-";"USD/JPY";"106 000 Jednost.";"154,450";"-";"-";"-";"-";"0,026684";"441 195,00";"62,23";"18 988,64";"-";"-";"-";"-";"-";"-";"-";"-";"-";"-";"-";"-";"-";"-";"-";"-";"-";"-";"-";"-";"-";"-";"-";"-"
"22 List 2024 09:37:44";"Zmodyfikowano Transakcję Sprzedaży";"O2-DB-9CPT6V";"T2-DB-5NZEEC";"-";"USD/JPY";"106 000 Jednost.";"154,472";"-";"154,450";"-";"-";"-";"-";"0,00";"-";"-";"-";"-";"-";"-";"-";"-";"-";"-";"-";"-";"-";"-";"-";"-";"-";"-";"-";"-";"-";"-";"-";"-";"-"
"22 List 2024 09:36:54";"Transakcja Sprzedaży";"O2-DB-9CPT6V";"T2-DB-5NZEEC";"-";"USD/JPY";"106 000 Jednost.";"154,472";"-";"-";"-";"-";"4,163049";"441 283,19";"0,00";"-";"-";"-";"-";"-";"-";"-";"-";"-";"-";"-";"-";"-";"-";"-";"-";"-";"-";"-";"-";"-";"-";"-";"-";"-"
"22 List 2024 09:31:00";"Stop Loss";"O2-DB-9CPSW2";"T2-DB-5NZE6K";"-";"USD/JPY";"106 000 Jednost.";"154,500";"-";"-";"-";"-";"0,026676";"441 201,46";"248,83";"18 926,41";"-";"-";"-";"-";"-";"-";"-";"-";"-";"-";"-";"-";"-";"-";"-";"-";"-";"-";"-";"-";"-";"-";"-";"-"
"22 List 2024 09:30:59";"Zmodyfikowano Transakcję Sprzedaży";"O2-DB-9CPSW2";"T2-DB-5NZE3G";"-";"USD/JPY";"106 000 Jednost.";"154,588";"-";"154,500";"-";"-";"-";"-";"0,00";"-";"-";"-";"-";"-";"-";"-";"-";"-";"-";"-";"-";"-";"-";"-";"-";"-";"-";"-";"-";"-";"-";"-";"-";"-"
"22 List 2024 09:29:38";"Transakcja Sprzedaży";"O2-DB-9CPSW2";"T2-DB-5NZE3G";"-";"USD/JPY";"106 000 Jednost.";"154,588";"-";"-";"-";"-";"4,162227";"441 196,06";"0,00";"-";"-";"-";"-";"-";"-";"-";"-";"-";"-";"-";"-";"-";"-";"-";"-";"-";"-";"-";"-";"-";"-";"-";"-";"-"
"22 List 2024 09:27:56";" Zamknięcie Transakcji";"O2-DB-9CPSTE";"T2-DB-5NZE1R";"O2-DB-9CPSGJ";"USD/JPY";"100 000 Jednost.";"154,560";"-";"-";"-";"-";"0,026664";"416 238,80";"21,33";"18 677,58";"-";"-";"-";"-";"-";"-";"-";"-";"-";"-";"-";"-";"-";"-";"-";"-";"-";"-";"-";"-";"-";"-";"-";"-"
"22 List 2024 09:22:22";"Transakcja Sprzedaży";"O2-DB-9CPSGJ";"T2-DB-5NZDSP";"-";"USD/JPY";"100 000 Jednost.";"154,568";"-";"-";"-";"-";"4,160223";"416 022,30";"0,00";"-";"-";"-";"-";"-";"-";"-";"-";"-";"-";"-";"-";"-";"-";"-";"-";"-";"-";"-";"-";"-";"-";"-";"-";"-"
"22 List 2024 01:12:23";"Take Profit";"O2-DB-9CP8ZK";"T2-DB-5NZ07J";"-";"USD/JPY";"30 000 Jednost.";"154,000";"-";"-";"-";"-";"0,026809";"125 105,19";"285,52";"18 656,25";"-";"-";"-";"-";"-";"-";"-";"-";"-";"-";"-";"-";"-";"-";"-";"-";"-";"-";"-";"-";"-";"-";"-";"-"
"22 List 2024 00:24:22";"Zmodyfikowano Transakcję Sprzedaży";"O2-DB-9CP8ZK";"T2-DB-5NYZ97";"-";"USD/JPY";"30 000 Jednost.";"154,355";"-";"-";"154,000";"-";"-";"-";"0,00";"-";"-";"-";"-";"-";"-";"-";"-";"-";"-";"-";"-";"-";"-";"-";"-";"-";"-";"-";"-";"-";"-";"-";"-";"-"
"22 List 2024 00:23:41";"Transakcja Sprzedaży";"O2-DB-9CP8ZK";"T2-DB-5NYZ97";"-";"USD/JPY";"30 000 Jednost.";"154,355";"-";"-";"-";"-";"4,168801";"125 064,03";"0,00";"-";"-";"-";"-";"-";"-";"-";"-";"-";"-";"-";"-";"-";"-";"-";"-";"-";"-";"-";"-";"-";"-";"-";"-";"-"
"22 List 2024 00:11:00";"Stop Loss";"O2-DB-9CP38Q";"T2-DB-5NYZ3R";"-";"USD/JPY";"100 000 Jednost.";"154,358";"-";"-";"-";"-";"0,026741";"416 817,90";"280,78";"18 370,73";"-";"-";"-";"-";"-";"-";"-";"-";"-";"-";"-";"-";"-";"-";"-";"-";"-";"-";"-";"-";"-";"-";"-";"-"
"22 List 2024 00:08:50";"Zmodyfikowano Stop Loss";"O2-DB-9CP38Q";"-";"O2-DB-9CP8E1";"USD/JPY";"100 000 Jednost.";"154,463";"-";"154,350";"-";"-";"-";"-";"-";"-";"-";"-";"-";"-";"-";"-";"-";"-";"-";"-";"-";"-";"-";"-";"-";"-";"-";"-";"-";"-";"-";"-";"-";"-"
"22 List 2024 00:06:21";"Zmodyfikowano Take Profit";"O2-DB-9CP38Q";"-";"O2-DB-9CP7Y0";"USD/JPY";"100 000 Jednost.";"154,463";"-";"-";"154,000";"-";"-";"-";"-";"-";"-";"-";"-";"-";"-";"-";"-";"-";"-";"-";"-";"-";"-";"-";"-";"-";"-";"-";"-";"-";"-";"-";"-";"-"
"22 List 2024 00:06:21";"Zmodyfikowano Stop Loss";"O2-DB-9CP38Q";"-";"O2-DB-9CP8E1";"USD/JPY";"100 000 Jednost.";"154,463";"-";"154,390";"-";"-";"-";"-";"-";"-";"-";"-";"-";"-";"-";"-";"-";"-";"-";"-";"-";"-";"-";"-";"-";"-";"-";"-";"-";"-";"-";"-";"-";"-"
"22 List 2024 00:04:57";"Zmodyfikowano Transakcję Sprzedaży";"O2-DB-9CP38Q";"T2-DB-5NYVS1";"-";"USD/JPY";"100 000 Jednost.";"154,463";"-";"154,420";"154,200";"-";"-";"-";"0,00";"-";"-";"-";"-";"-";"-";"-";"-";"-";"-";"-";"-";"-";"-";"-";"-";"-";"-";"-";"-";"-";"-";"-";"-";"-"
"21 List 2024 23:15:50";"Zmodyfikowano Transakcję Sprzedaży";"O2-DB-9CP38Q";"T2-DB-5NYVS1";"-";"USD/JPY";"100 000 Jednost.";"154,463";"-";"-";"154,200";"-";"-";"-";"0,00";"-";"-";"-";"-";"-";"-";"-";"-";"-";"-";"-";"-";"-";"-";"-";"-";"-";"-";"-";"-";"-";"-";"-";"-";"-"
"21 List 2024 23:02:09";"Koszty Utrzymania Pozycji";"1390064286";"-";"-";"Rachunek";"-";"-";"-";"-";"-";"-";"-";"-";"-62,27";"18 089,95";"-";"-";"-";"-";"-";"-62,27";"-";"-";"-";"-";"-";"-";"-";"-";"-";"-";"-";"-";"-";"-";"-";"-";"-";"-"
"21 List 2024 23:02:09";"Koszty Utrzymania Pozycji";"O2-D9-9BJZX7";"-";"-";"USD/JPY";"-";"-";"-";"-";"-";"-";"-";"-";"-";"-";"-";"-";"30 000,00";"5,55460%";"-19,03";"0,00";"-";"-";"-";"-";"-";"-";"-";"-";"-";"-";"-";"-";"-";"-";"-";"-";"-";"-"
"21 List 2024 23:02:09";"Koszty Utrzymania Pozycji";"O2-D9-9BB04B";"-";"-";"USD/JPY";"-";"-";"-";"-";"-";"-";"-";"-";"-";"-";"-";"-";"34 000,00";"5,55460%";"-21,56";"0,00";"-";"-";"-";"-";"-";"-";"-";"-";"-";"-";"-";"-";"-";"-";"-";"-";"-";"-"
"21 List 2024 23:02:09";"Koszty Utrzymania Pozycji";"O2-DB-9C9X8L";"-";"-";"USD/JPY";"-";"-";"-";"-";"-";"-";"-";"-";"-";"-";"-";"-";"20 000,00";"3,51924%";"7,96";"0,00";"-";"-";"-";"-";"-";"-";"-";"-";"-";"-";"-";"-";"-";"-";"-";"-";"-";"-"
"21 List 2024 23:02:09";"Koszty Utrzymania Pozycji";"O2-DB-9CP38Q";"-";"-";"USD/JPY";"-";"-";"-";"-";"-";"-";"-";"-";"-";"-";"-";"-";"100 000,00";"5,55460%";"-63,42";"0,00";"-";"-";"-";"-";"-";"-";"-";"-";"-";"-";"-";"-";"-";"-";"-";"-";"-";"-"
"21 List 2024 23:02:09";"Koszty Utrzymania Pozycji";"O2-D9-9BS5RZ";"-";"-";"USD/JPY";"-";"-";"-";"-";"-";"-";"-";"-";"-";"-";"-";"-";"22 000,00";"5,55460%";"-13,95";"0,00";"-";"-";"-";"-";"-";"-";"-";"-";"-";"-";"-";"-";"-";"-";"-";"-";"-";"-"
"21 List 2024 23:02:09";"Koszty Utrzymania Pozycji";"O2-DB-9CKXH9";"-";"-";"USD/JPY";"-";"-";"-";"-";"-";"-";"-";"-";"-";"-";"-";"-";"90 000,00";"3,51924%";"35,80";"0,00";"-";"-";"-";"-";"-";"-";"-";"-";"-";"-";"-";"-";"-";"-";"-";"-";"-";"-"
"21 List 2024 23:02:09";"Koszty Utrzymania Pozycji";"O2-DB-9C9XVJ";"-";"-";"USD/JPY";"-";"-";"-";"-";"-";"-";"-";"-";"-";"-";"-";"-";"30 000,00";"3,51924%";"11,93";"0,00";"-";"-";"-";"-";"-";"-";"-";"-";"-";"-";"-";"-";"-";"-";"-";"-";"-";"-"
"21 List 2024 22:57:17";"Zmodyfikowano Transakcję Sprzedaży";"O2-DB-9CP38Q";"T2-DB-5NYVS1";"-";"USD/JPY";"100 000 Jednost.";"154,463";"-";"-";"-";"-";"-";"-";"0,00";"-";"-";"-";"-";"-";"-";"-";"-";"-";"-";"-";"-";"-";"-";"-";"-";"-";"-";"-";"-";"-";"-";"-";"-";"-"
"21 List 2024 22:30:27";"Zmodyfikowano Transakcję Sprzedaży";"O2-DB-9CP38Q";"T2-DB-5NYVS1";"-";"USD/JPY";"100 000 Jednost.";"154,463";"-";"-";"154,455";"-";"-";"-";"0,00";"-";"-";"-";"-";"-";"-";"-";"-";"-";"-";"-";"-";"-";"-";"-";"-";"-";"-";"-";"-";"-";"-";"-";"-";"-"
"21 List 2024 21:06:21";"Transakcja Sprzedaży";"O2-DB-9CP38Q";"T2-DB-5NYVS1";"-";"USD/JPY";"100 000 Jednost.";"154,463";"-";"-";"-";"-";"4,161827";"416 182,70";"0,00";"-";"-";"-";"-";"-";"-";"-";"-";"-";"-";"-";"-";"-";"-";"-";"-";"-";"-";"-";"-";"-";"-";"-";"-";"-"
"21 List 2024 19:44:50";"Stop Loss";"O2-DB-9CNYCW";"T2-DB-5NYRLK";"-";"USD/JPY";"100 000 Jednost.";"154,620";"-";"-";"-";"-";"0,026663";"416 360,00";"29,33";"18 152,22";"-";"-";"-";"-";"-";"-";"-";"-";"-";"-";"-";"-";"-";"-";"-";"-";"-";"-";"-";"-";"-";"-";"-";"-"
"21 List 2024 19:44:30";"Zmodyfikowano Transakcję Sprzedaży";"O2-DB-9CNYCW";"T2-DB-5NYR0Q";"-";"USD/JPY";"100 000 Jednost.";"154,631";"-";"154,620";"-";"-";"-";"-";"0,00";"-";"-";"-";"-";"-";"-";"-";"-";"-";"-";"-";"-";"-";"-";"-";"-";"-";"-";"-";"-";"-";"-";"-";"-";"-"
"21 List 2024 19:33:40";"Transakcja Sprzedaży";"O2-DB-9CNYCW";"T2-DB-5NYR0Q";"-";"USD/JPY";"100 000 Jednost.";"154,631";"-";"-";"-";"-";"4,164141";"416 414,10";"0,00";"-";"-";"-";"-";"-";"-";"-";"-";"-";"-";"-";"-";"-";"-";"-";"-";"-";"-";"-";"-";"-";"-";"-";"-";"-"
"21 List 2024 18:57:22";"Stop Loss";"O2-DB-9CNVKH";"T2-DB-5NYP1J";"-";"USD/JPY";"100 000 Jednost.";"154,435";"-";"-";"-";"-";"0,02668";"416 132,60";"56,03";"18 122,89";"-";"-";"-";"-";"-";"-";"-";"-";"-";"-";"-";"-";"-";"-";"-";"-";"-";"-";"-";"-";"-";"-";"-";"-"
"21 List 2024 18:57:18";"Zmodyfikowano Stop Loss";"O2-DB-9CNVKH";"-";"O2-DB-9CNVT3";"USD/JPY";"100 000 Jednost.";"154,456";"-";"154,435";"-";"-";"-";"-";"-";"-";"-";"-";"-";"-";"-";"-";"-";"-";"-";"-";"-";"-";"-";"-";"-";"-";"-";"-";"-";"-";"-";"-";"-";"-"
"21 List 2024 18:56:54";"Zmodyfikowano Transakcję Sprzedaży";"O2-DB-9CNVKH";"T2-DB-5NYNSJ";"-";"USD/JPY";"100 000 Jednost.";"154,456";"-";"154,430";"-";"-";"-";"-";"0,00";"-";"-";"-";"-";"-";"-";"-";"-";"-";"-";"-";"-";"-";"-";"-";"-";"-";"-";"-";"-";"-";"-";"-";"-";"-"
"21 List 2024 18:53:43";"Transakcja Sprzedaży";"O2-DB-9CNVKH";"T2-DB-5NYNSJ";"-";"USD/JPY";"100 000 Jednost.";"154,456";"-";"-";"-";"-";"4,161376";"416 137,60";"0,00";"-";"-";"-";"-";"-";"-";"-";"-";"-";"-";"-";"-";"-";"-";"-";"-";"-";"-";"-";"-";"-";"-";"-";"-";"-"
"21 List 2024 18:49:38";"Stop Loss";"O2-DB-9CNV2L";"T2-DB-5NYNKE";"-";"USD/JPY";"100 000 Jednost.";"154,490";"-";"-";"-";"-";"0,026675";"416 207,70";"16,01";"18 066,86";"-";"-";"-";"-";"-";"-";"-";"-";"-";"-";"-";"-";"-";"-";"-";"-";"-";"-";"-";"-";"-";"-";"-";"-"
"21 List 2024 18:49:21";"Zmodyfikowano Transakcję Sprzedaży";"O2-DB-9CNV2L";"T2-DB-5NYNEG";"-";"USD/JPY";"100 000 Jednost.";"154,496";"-";"154,490";"-";"-";"-";"-";"0,00";"-";"-";"-";"-";"-";"-";"-";"-";"-";"-";"-";"-";"-";"-";"-";"-";"-";"-";"-";"-";"-";"-";"-";"-";"-"
"21 List 2024 18:47:04";"Transakcja Sprzedaży";"O2-DB-9CNV2L";"T2-DB-5NYNEG";"-";"USD/JPY";"100 000 Jednost.";"154,496";"-";"-";"-";"-";"4,16364";"416 364,00";"0,00";"-";"-";"-";"-";"-";"-";"-";"-";"-";"-";"-";"-";"-";"-";"-";"-";"-";"-";"-";"-";"-";"-";"-";"-";"-"
"21 List 2024 18:46:27";"Stop Loss";"O2-DB-9CNSCS";"T2-DB-5NYND6";"-";"USD/JPY";"100 000 Jednost.";"154,490";"-";"-";"-";"-";"0,026685";"416 318,90";"10,67";"18 050,85";"-";"-";"-";"-";"-";"-";"-";"-";"-";"-";"-";"-";"-";"-";"-";"-";"-";"-";"-";"-";"-";"-";"-";"-"
"21 List 2024 18:46:02";"Zmodyfikowano Transakcję Sprzedaży";"O2-DB-9CNSCS";"T2-DB-5NYLVL";"-";"USD/JPY";"100 000 Jednost.";"154,494";"-";"154,490";"-";"-";"-";"-";"0,00";"-";"-";"-";"-";"-";"-";"-";"-";"-";"-";"-";"-";"-";"-";"-";"-";"-";"-";"-";"-";"-";"-";"-";"-";"-"
"21 List 2024 18:27:23";"Transakcja Sprzedaży";"O2-DB-9CNSCS";"T2-DB-5NYLVL";"-";"USD/JPY";"100 000 Jednost.";"154,494";"-";"-";"-";"-";"4,167839";"416 783,90";"0,00";"-";"-";"-";"-";"-";"-";"-";"-";"-";"-";"-";"-";"-";"-";"-";"-";"-";"-";"-";"-";"-";"-";"-";"-";"-"
"21 List 2024 18:24:50";"Stop Loss";"O2-DB-9CNR8C";"T2-DB-5NYLL5";"-";"USD/JPY";"93 000 Jednost.";"154,580";"-";"-";"-";"-";"0,026692";"387 527,93";"29,79";"18 040,18";"-";"-";"-";"-";"-";"-";"-";"-";"-";"-";"-";"-";"-";"-";"-";"-";"-";"-";"-";"-";"-";"-";"-";"-"
"21 List 2024 18:24:48";"Zmodyfikowano Stop Loss";"O2-DB-9CNR8C";"-";"O2-DB-9CNS2K";"USD/JPY";"93 000 Jednost.";"154,592";"-";"154,580";"-";"-";"-";"-";"-";"-";"-";"-";"-";"-";"-";"-";"-";"-";"-";"-";"-";"-";"-";"-";"-";"-";"-";"-";"-";"-";"-";"-";"-";"-"
"21 List 2024 18:24:22";"Zmodyfikowano Transakcję Sprzedaży";"O2-DB-9CNR8C";"T2-DB-5NYKWX";"-";"USD/JPY";"93 000 Jednost.";"154,592";"-";"154,585";"-";"-";"-";"-";"0,00";"-";"-";"-";"-";"-";"-";"-";"-";"-";"-";"-";"-";"-";"-";"-";"-";"-";"-";"-";"-";"-";"-";"-";"-";"-"
"21 List 2024 18:13:19";"Transakcja Sprzedaży";"O2-DB-9CNR8C";"T2-DB-5NYKWX";"-";"USD/JPY";"93 000 Jednost.";"154,592";"-";"-";"-";"-";"4,16853";"387 673,29";"0,00";"-";"-";"-";"-";"-";"-";"-";"-";"-";"-";"-";"-";"-";"-";"-";"-";"-";"-";"-";"-";"-";"-";"-";"-";"-"
"21 List 2024 18:04:45";"Stop Loss";"O2-DB-9CNQB3";"T2-DB-5NYKDD";"-";"USD/JPY";"93 000 Jednost.";"154,600";"-";"-";"-";"-";"0,026726";"388 115,97";"62,14";"18 010,39";"-";"-";"-";"-";"-";"-";"-";"-";"-";"-";"-";"-";"-";"-";"-";"-";"-";"-";"-";"-";"-";"-";"-";"-"
"21 List 2024 18:04:37";"Zmodyfikowano Transakcję Sprzedaży";"O2-DB-9CNQB3";"T2-DB-5NYK6R";"-";"USD/JPY";"93 000 Jednost.";"154,625";"-";"154,600";"-";"-";"-";"-";"0,00";"-";"-";"-";"-";"-";"-";"-";"-";"-";"-";"-";"-";"-";"-";"-";"-";"-";"-";"-";"-";"-";"-";"-";"-";"-"
"21 List 2024 18:02:28";"Transakcja Sprzedaży";"O2-DB-9CNQB3";"T2-DB-5NYK6R";"-";"USD/JPY";"93 000 Jednost.";"154,625";"-";"-";"-";"-";"4,172027";"387 998,51";"0,00";"-";"-";"-";"-";"-";"-";"-";"-";"-";"-";"-";"-";"-";"-";"-";"-";"-";"-";"-";"-";"-";"-";"-";"-";"-"
"21 List 2024 17:58:42";"Stop Loss";"O2-DB-9CNPWZ";"T2-DB-5NYJZ0";"-";"USD/JPY";"93 000 Jednost.";"154,570";"-";"-";"-";"-";"0,026702";"387 655,62";"39,73";"17 948,25";"-";"-";"-";"-";"-";"-";"-";"-";"-";"-";"-";"-";"-";"-";"-";"-";"-";"-";"-";"-";"-";"-";"-";"-"
"21 List 2024 17:58:38";"Zmodyfikowano Transakcję Sprzedaży";"O2-DB-9CNPWZ";"T2-DB-5NYJWD";"-";"USD/JPY";"93 000 Jednost.";"154,586";"-";"154,570";"-";"-";"-";"-";"0,00";"-";"-";"-";"-";"-";"-";"-";"-";"-";"-";"-";"-";"-";"-";"-";"-";"-";"-";"-";"-";"-";"-";"-";"-";"-"
"21 List 2024 17:56:59";"Transakcja Sprzedaży";"O2-DB-9CNPWZ";"T2-DB-5NYJWD";"-";"USD/JPY";"93 000 Jednost.";"154,586";"-";"-";"-";"-";"4,16827";"387 649,11";"0,00";"-";"-";"-";"-";"-";"-";"-";"-";"-";"-";"-";"-";"-";"-";"-";"-";"-";"-";"-";"-";"-";"-";"-";"-";"-"
"21 List 2024 16:51:18";"Stop Loss";"O2-DB-9CNFMJ";"T2-DB-5NYCCS";"-";"USD/JPY";"93 000 Jednost.";"154,210";"-";"-";"-";"-";"0,026645";"385 877,55";"104,08";"17 908,52";"-";"-";"-";"-";"-";"-";"-";"-";"-";"-";"-";"-";"-";"-";"-";"-";"-";"-";"-";"-";"-";"-";"-";"-"
"21 List 2024 16:50:53";"Zmodyfikowano Stop Loss";"O2-DB-9CNFMJ";"-";"O2-DB-9CNGD9";"USD/JPY";"93 000 Jednost.";"154,252";"-";"154,210";"-";"-";"-";"-";"-";"-";"-";"-";"-";"-";"-";"-";"-";"-";"-";"-";"-";"-";"-";"-";"-";"-";"-";"-";"-";"-";"-";"-";"-";"-"
"21 List 2024 16:50:40";"Zmodyfikowano Transakcję Sprzedaży";"O2-DB-9CNFMJ";"T2-DB-5NYBKS";"-";"USD/JPY";"93 000 Jednost.";"154,252";"-";"154,230";"-";"-";"-";"-";"0,00";"-";"-";"-";"-";"-";"-";"-";"-";"-";"-";"-";"-";"-";"-";"-";"-";"-";"-";"-";"-";"-";"-";"-";"-";"-"
"21 List 2024 16:46:04";"Transakcja Sprzedaży";"O2-DB-9CNFMJ";"T2-DB-5NYBKS";"-";"USD/JPY";"93 000 Jednost.";"154,252";"-";"-";"-";"-";"4,146055";"385 583,11";"0,00";"-";"-";"-";"-";"-";"-";"-";"-";"-";"-";"-";"-";"-";"-";"-";"-";"-";"-";"-";"-";"-";"-";"-";"-";"-"
"21 List 2024 16:19:48";"Stop Loss";"O2-DB-9CNB6F";"T2-DB-5NY7B6";"-";"USD/JPY";"93 000 Jednost.";"154,070";"-";"-";"-";"-";"0,026619";"385 190,84";"113,88";"17 804,44";"-";"-";"-";"-";"-";"-";"-";"-";"-";"-";"-";"-";"-";"-";"-";"-";"-";"-";"-";"-";"-";"-";"-";"-"
"21 List 2024 16:19:43";"Zmodyfikowano Stop Loss";"O2-DB-9CNB6F";"-";"O2-DB-9CNBDD";"USD/JPY";"93 000 Jednost.";"154,116";"-";"154,070";"-";"-";"-";"-";"-";"-";"-";"-";"-";"-";"-";"-";"-";"-";"-";"-";"-";"-";"-";"-";"-";"-";"-";"-";"-";"-";"-";"-";"-";"-"
"21 List 2024 16:19:31";"Zmodyfikowano Stop Loss";"O2-DB-9CNB6F";"-";"O2-DB-9CNBDD";"USD/JPY";"93 000 Jednost.";"154,116";"-";"154,090";"-";"-";"-";"-";"-";"-";"-";"-";"-";"-";"-";"-";"-";"-";"-";"-";"-";"-";"-";"-";"-";"-";"-";"-";"-";"-";"-";"-";"-";"-"
"21 List 2024 16:17:51";"Zmodyfikowano Transakcję Sprzedaży";"O2-DB-9CNB6F";"T2-DB-5NY6YQ";"-";"USD/JPY";"93 000 Jednost.";"154,116";"-";"159,080";"-";"-";"-";"-";"0,00";"-";"-";"-";"-";"-";"-";"-";"-";"-";"-";"-";"-";"-";"-";"-";"-";"-";"-";"-";"-";"-";"-";"-";"-";"-"
"21 List 2024 16:16:44";"Transakcja Sprzedaży";"O2-DB-9CNB6F";"T2-DB-5NY6YQ";"-";"USD/JPY";"93 000 Jednost.";"154,116";"-";"-";"-";"-";"4,140564";"385 072,45";"0,00";"-";"-";"-";"-";"-";"-";"-";"-";"-";"-";"-";"-";"-";"-";"-";"-";"-";"-";"-";"-";"-";"-";"-";"-";"-"
"21 List 2024 16:04:44";"Stop Loss";"O2-DB-9CN3KQ";"T2-DB-5NY55L";"-";"USD/JPY";"93 000 Jednost.";"153,950";"-";"-";"-";"-";"0,02661";"384 783,59";"29,70";"17 690,56";"-";"-";"-";"-";"-";"-";"-";"-";"-";"-";"-";"-";"-";"-";"-";"-";"-";"-";"-";"-";"-";"-";"-";"-"
"21 List 2024 16:04:42";"Zmodyfikowano Transakcję Sprzedaży";"O2-DB-9CN3KQ";"T2-DB-5NY1B5";"-";"USD/JPY";"93 000 Jednost.";"153,962";"-";"153,950";"-";"-";"-";"-";"0,00";"-";"-";"-";"-";"-";"-";"-";"-";"-";"-";"-";"-";"-";"-";"-";"-";"-";"-";"-";"-";"-";"-";"-";"-";"-"
"21 List 2024 15:42:34";"Transakcja Sprzedaży";"O2-DB-9CN3KQ";"T2-DB-5NY1B5";"-";"USD/JPY";"93 000 Jednost.";"153,962";"-";"-";"-";"-";"4,145494";"385 530,94";"0,00";"-";"-";"-";"-";"-";"-";"-";"-";"-";"-";"-";"-";"-";"-";"-";"-";"-";"-";"-";"-";"-";"-";"-";"-";"-"
"21 List 2024 15:40:22";"Stop Loss";"O2-DB-9CMXZX";"T2-DB-5NY0TY";"-";"USD/JPY";"93 000 Jednost.";"154,070";"-";"-";"-";"-";"0,026639";"385 499,22";"351,79";"17 660,86";"-";"-";"-";"-";"-";"-";"-";"-";"-";"-";"-";"-";"-";"-";"-";"-";"-";"-";"-";"-";"-";"-";"-";"-"
"21 List 2024 15:39:26";"Zmodyfikowano Stop Loss";"O2-DB-9CMXZX";"-";"O2-DB-9CN1G9";"USD/JPY";"93 000 Jednost.";"154,212";"-";"154,070";"-";"-";"-";"-";"-";"-";"-";"-";"-";"-";"-";"-";"-";"-";"-";"-";"-";"-";"-";"-";"-";"-";"-";"-";"-";"-";"-";"-";"-";"-"
"21 List 2024 15:37:57";"Zmodyfikowano Stop Loss";"O2-DB-9CMXZX";"-";"O2-DB-9CN1G9";"USD/JPY";"93 000 Jednost.";"154,212";"-";"154,100";"-";"-";"-";"-";"-";"-";"-";"-";"-";"-";"-";"-";"-";"-";"-";"-";"-";"-";"-";"-";"-";"-";"-";"-";"-";"-";"-";"-";"-";"-"
"21 List 2024 15:36:57";"Zmodyfikowano Stop Loss";"O2-DB-9CMXZX";"-";"O2-DB-9CN1G9";"USD/JPY";"93 000 Jednost.";"154,212";"-";"154,120";"-";"-";"-";"-";"-";"-";"-";"-";"-";"-";"-";"-";"-";"-";"-";"-";"-";"-";"-";"-";"-";"-";"-";"-";"-";"-";"-";"-";"-";"-"
"21 List 2024 15:36:04";"Zmodyfikowano Stop Loss";"O2-DB-9CMXZX";"-";"O2-DB-9CN1G9";"USD/JPY";"93 000 Jednost.";"154,212";"-";"154,150";"-";"-";"-";"-";"-";"-";"-";"-";"-";"-";"-";"-";"-";"-";"-";"-";"-";"-";"-";"-";"-";"-";"-";"-";"-";"-";"-";"-";"-";"-"
"21 List 2024 15:35:47";"Zmodyfikowano Stop Loss";"O2-DB-9CMXZX";"-";"O2-DB-9CN1G9";"USD/JPY";"93 000 Jednost.";"154,212";"-";"154,170";"-";"-";"-";"-";"-";"-";"-";"-";"-";"-";"-";"-";"-";"-";"-";"-";"-";"-";"-";"-";"-";"-";"-";"-";"-";"-";"-";"-";"-";"-"
"21 List 2024 15:35:25";"Zmodyfikowano Transakcję Sprzedaży";"O2-DB-9CMXZX";"T2-DB-5NXWJ0";"-";"USD/JPY";"93 000 Jednost.";"154,212";"-";"154,200";"-";"-";"-";"-";"0,00";"-";"-";"-";"-";"-";"-";"-";"-";"-";"-";"-";"-";"-";"-";"-";"-";"-";"-";"-";"-";"-";"-";"-";"-";"-"
"21 List 2024 15:17:56";"Stop Loss";"O2-DB-9CMYVY";"T2-DB-5NXXKR";"-";"USD/JPY";"70 000 Jednost.";"154,520";"-";"-";"-";"-";"0,026559";"290 161,41";"74,37";"17 309,07";"-";"-";"-";"-";"-";"-";"-";"-";"-";"-";"-";"-";"-";"-";"-";"-";"-";"-";"-";"-";"-";"-";"-";"-"
"21 List 2024 15:17:24";"Zmodyfikowano Stop Loss";"O2-DB-9CMYVY";"-";"O2-DB-9CMZ9E";"USD/JPY";"70 000 Jednost.";"154,480";"-";"154,520";"-";"-";"-";"-";"-";"-";"-";"-";"-";"-";"-";"-";"-";"-";"-";"-";"-";"-";"-";"-";"-";"-";"-";"-";"-";"-";"-";"-";"-";"-"
"21 List 2024 15:16:52";" Zmodyfikowano Transakcję Kupna";"O2-DB-9CMYVY";"T2-DB-5NXX65";"-";"USD/JPY";"70 000 Jednost.";"154,480";"-";"154,500";"-";"-";"-";"-";"0,00";"-";"-";"-";"-";"-";"-";"-";"-";"-";"-";"-";"-";"-";"-";"-";"-";"-";"-";"-";"-";"-";"-";"-";"-";"-"
"21 List 2024 15:11:30";" Transakcja Kupna";"O2-DB-9CMYVY";"T2-DB-5NXX65";"-";"USD/JPY";"70 000 Jednost.";"154,480";"-";"-";"-";"-";"4,145975";"290 218,25";"0,00";"-";"-";"-";"-";"-";"-";"-";"-";"-";"-";"-";"-";"-";"-";"-";"-";"-";"-";"-";"-";"-";"-";"-";"-";"-"
"21 List 2024 14:58:42";"Transakcja Sprzedaży";"O2-DB-9CMXZX";"T2-DB-5NXWJ0";"-";"USD/JPY";"93 000 Jednost.";"154,212";"-";"-";"-";"-";"4,140574";"385 073,38";"0,00";"-";"-";"-";"-";"-";"-";"-";"-";"-";"-";"-";"-";"-";"-";"-";"-";"-";"-";"-";"-";"-";"-";"-";"-";"-"
"21 List 2024 14:45:19";"Stop Loss";"O2-DB-9CMRXE";"T2-DB-5NXVP4";"-";"USD/JPY";"13 000 Jednost.";"154,180";"-";"-";"-";"-";"0,026582";"53 812,87";"41,81";"17 234,70";"-";"-";"-";"-";"-";"-";"-";"-";"-";"-";"-";"-";"-";"-";"-";"-";"-";"-";"-";"-";"-";"-";"-";"-"
"21 List 2024 14:45:16";"Zmodyfikowano Stop Loss";"O2-DB-9CMRXE";"-";"O2-DB-9CMWTC";"USD/JPY";"13 000 Jednost.";"154,301";"-";"154,180";"-";"-";"-";"-";"-";"-";"-";"-";"-";"-";"-";"-";"-";"-";"-";"-";"-";"-";"-";"-";"-";"-";"-";"-";"-";"-";"-";"-";"-";"-"
"21 List 2024 14:43:44";"Zmodyfikowano Transakcję Sprzedaży";"O2-DB-9CMRXE";"T2-DB-5NXRGE";"-";"USD/JPY";"13 000 Jednost.";"154,301";"-";"154,800";"153,210";"-";"-";"-";"0,00";"-";"-";"-";"-";"-";"-";"-";"-";"-";"-";"-";"-";"-";"-";"-";"-";"-";"-";"-";"-";"-";"-";"-";"-";"-"
"21 List 2024 14:43:23";"Stop Loss";"O2-DB-9CMGLW";"T2-DB-5NXVKN";"-";"USD/JPY";"80 000 Jednost.";"154,180";"-";"-";"-";"-";"0,026573";"330 997,44";"93,54";"17 192,89";"-";"-";"-";"-";"-";"-";"-";"-";"-";"-";"-";"-";"-";"-";"-";"-";"-";"-";"-";"-";"-";"-";"-";"-"
"21 List 2024 14:43:13";"Zmodyfikowano Transakcję Sprzedaży";"O2-DB-9CMGLW";"T2-DB-5NXJ5G";"-";"USD/JPY";"80 000 Jednost.";"154,224";"-";"154,180";"153,210";"-";"-";"-";"0,00";"-";"-";"-";"-";"-";"-";"-";"-";"-";"-";"-";"-";"-";"-";"-";"-";"-";"-";"-";"-";"-";"-";"-";"-";"-"
"21 List 2024 13:52:39";"Zmodyfikowano Transakcję Sprzedaży";"O2-DB-9CMRXE";"T2-DB-5NXRGE";"-";"USD/JPY";"13 000 Jednost.";"154,301";"-";"-";"153,210";"-";"-";"-";"0,00";"-";"-";"-";"-";"-";"-";"-";"-";"-";"-";"-";"-";"-";"-";"-";"-";"-";"-";"-";"-";"-";"-";"-";"-";"-"
"21 List 2024 13:52:06";"Transakcja Sprzedaży";"O2-DB-9CMRXE";"T2-DB-5NXRGE";"-";"USD/JPY";"13 000 Jednost.";"154,301";"-";"-";"-";"-";"4,142127";"53 847,65";"0,00";"-";"-";"-";"-";"-";"-";"-";"-";"-";"-";"-";"-";"-";"-";"-";"-";"-";"-";"-";"-";"-";"-";"-";"-";"-"
"21 List 2024 13:37:00";"Zmodyfikowano Take Profit";"O2-DB-9CMGLW";"-";"O2-DB-9CMHTH";"USD/JPY";"80 000 Jednost.";"154,224";"-";"-";"153,210";"-";"-";"-";"-";"-";"-";"-";"-";"-";"-";"-";"-";"-";"-";"-";"-";"-";"-";"-";"-";"-";"-";"-";"-";"-";"-";"-";"-";"-"
"21 List 2024 13:10:41";"Stop Loss";"O2-DB-9CMNQT";"T2-DB-5NXP94";"-";"USD/JPY";"60 000 Jednost.";"154,636";"-";"-";"-";"-";"0,026543";"248 765,70";"89,18";"17 099,35";"-";"-";"-";"-";"-";"-";"-";"-";"-";"-";"-";"-";"-";"-";"-";"-";"-";"-";"-";"-";"-";"-";"-";"-"
"21 List 2024 13:09:46";"Zmodyfikowano Stop Loss";"O2-DB-9CMNQT";"-";"O2-DB-9CMP0D";"USD/JPY";"60 000 Jednost.";"154,580";"-";"154,640";"-";"-";"-";"-";"-";"-";"-";"-";"-";"-";"-";"-";"-";"-";"-";"-";"-";"-";"-";"-";"-";"-";"-";"-";"-";"-";"-";"-";"-";"-"
"21 List 2024 13:09:21";"Zmodyfikowano Stop Loss";"O2-DB-9CMNQT";"-";"O2-DB-9CMP0D";"USD/JPY";"60 000 Jednost.";"154,580";"-";"154,630";"-";"-";"-";"-";"-";"-";"-";"-";"-";"-";"-";"-";"-";"-";"-";"-";"-";"-";"-";"-";"-";"-";"-";"-";"-";"-";"-";"-";"-";"-"
"21 List 2024 13:08:56";" Zmodyfikowano Transakcję Kupna";"O2-DB-9CMNQT";"T2-DB-5NXNY6";"-";"USD/JPY";"60 000 Jednost.";"154,580";"-";"154,610";"-";"-";"-";"-";"0,00";"-";"-";"-";"-";"-";"-";"-";"-";"-";"-";"-";"-";"-";"-";"-";"-";"-";"-";"-";"-";"-";"-";"-";"-";"-"
"21 List 2024 13:05:38";" Transakcja Kupna";"O2-DB-9CMNQT";"T2-DB-5NXNY6";"-";"USD/JPY";"60 000 Jednost.";"154,580";"-";"-";"-";"-";"4,147919";"248 875,14";"0,00";"-";"-";"-";"-";"-";"-";"-";"-";"-";"-";"-";"-";"-";"-";"-";"-";"-";"-";"-";"-";"-";"-";"-";"-";"-"
"21 List 2024 12:44:36";"Stop Loss";"O2-DB-9CMME5";"T2-DB-5NXN5C";"-";"USD/JPY";"60 000 Jednost.";"154,550";"-";"-";"-";"-";"0,026579";"248 945,46";"28,71";"17 010,17";"-";"-";"-";"-";"-";"-";"-";"-";"-";"-";"-";"-";"-";"-";"-";"-";"-";"-";"-";"-";"-";"-";"-";"-"
"21 List 2024 12:43:43";" Zmodyfikowano Transakcję Kupna";"O2-DB-9CMME5";"T2-DB-5NXMY3";"-";"USD/JPY";"60 000 Jednost.";"154,532";"-";"154,550";"-";"-";"-";"-";"0,00";"-";"-";"-";"-";"-";"-";"-";"-";"-";"-";"-";"-";"-";"-";"-";"-";"-";"-";"-";"-";"-";"-";"-";"-";"-"
"21 List 2024 12:36:41";" Transakcja Kupna";"O2-DB-9CMME5";"T2-DB-5NXMY3";"-";"USD/JPY";"60 000 Jednost.";"154,532";"-";"-";"-";"-";"4,148019";"248 881,14";"0,00";"-";"-";"-";"-";"-";"-";"-";"-";"-";"-";"-";"-";"-";"-";"-";"-";"-";"-";"-";"-";"-";"-";"-";"-";"-"
"21 List 2024 11:51:47";"Odrzucono Zlecenie: brak wystarczających środków";"O2-DB-9CMJ8T";"-";"-";"USD/JPY";"70 000 Jednost.";"-";"-";"-";"-";"-";"-";"-";"-";"-";"-";"-";"-";"-";"-";"-";"-";"-";"-";"-";"-";"-";"-";"-";"-";"-";"-";"-";"-";"-";"-";"-";"-";"-"
"21 List 2024 11:42:59";"Zmodyfikowano Transakcję Sprzedaży";"O2-DB-9CMGLW";"T2-DB-5NXJ5G";"-";"USD/JPY";"80 000 Jednost.";"154,224";"-";"-";"154,210";"-";"-";"-";"0,00";"-";"-";"-";"-";"-";"-";"-";"-";"-";"-";"-";"-";"-";"-";"-";"-";"-";"-";"-";"-";"-";"-";"-";"-";"-"
"21 List 2024 11:17:50";"Transakcja Sprzedaży";"O2-DB-9CMGLW";"T2-DB-5NXJ5G";"-";"USD/JPY";"80 000 Jednost.";"154,224";"-";"-";"-";"-";"4,15325";"332 260,00";"0,00";"-";"-";"-";"-";"-";"-";"-";"-";"-";"-";"-";"-";"-";"-";"-";"-";"-";"-";"-";"-";"-";"-";"-";"-";"-"
"21 List 2024 11:16:27";"Stop Loss";"O2-DB-9CMGGX";"T2-DB-5NXJ42";"-";"USD/JPY";"80 000 Jednost.";"154,280";"-";"-";"-";"-";"0,02665";"332 183,04";"29,85";"16 981,46";"-";"-";"-";"-";"-";"-";"-";"-";"-";"-";"-";"-";"-";"-";"-";"-";"-";"-";"-";"-";"-";"-";"-";"-"
"21 List 2024 11:16:09";"Zmodyfikowano Transakcję Sprzedaży";"O2-DB-9CMGGX";"T2-DB-5NXJ3G";"-";"USD/JPY";"80 000 Jednost.";"154,294";"-";"154,280";"-";"-";"-";"-";"0,00";"-";"-";"-";"-";"-";"-";"-";"-";"-";"-";"-";"-";"-";"-";"-";"-";"-";"-";"-";"-";"-";"-";"-";"-";"-"
"21 List 2024 11:15:33";"Transakcja Sprzedaży";"O2-DB-9CMGGX";"T2-DB-5NXJ3G";"-";"USD/JPY";"80 000 Jednost.";"154,294";"-";"-";"-";"-";"4,153049";"332 243,92";"0,00";"-";"-";"-";"-";"-";"-";"-";"-";"-";"-";"-";"-";"-";"-";"-";"-";"-";"-";"-";"-";"-";"-";"-";"-";"-"
"21 List 2024 11:11:03";"Stop Loss";"O2-DB-9CMG3V";"T2-DB-5NXHVJ";"-";"USD/JPY";"80 000 Jednost.";"154,320";"-";"-";"-";"-";"0,026639";"332 207,84";"49,02";"16 951,61";"-";"-";"-";"-";"-";"-";"-";"-";"-";"-";"-";"-";"-";"-";"-";"-";"-";"-";"-";"-";"-";"-";"-";"-"
"21 List 2024 11:10:58";"Zmodyfikowano Transakcję Sprzedaży";"O2-DB-9CMG3V";"T2-DB-5NXHSJ";"-";"USD/JPY";"80 000 Jednost.";"154,343";"-";"154,320";"-";"-";"-";"-";"0,00";"-";"-";"-";"-";"-";"-";"-";"-";"-";"-";"-";"-";"-";"-";"-";"-";"-";"-";"-";"-";"-";"-";"-";"-";"-"
"21 List 2024 11:10:18";"Transakcja Sprzedaży";"O2-DB-9CMG3V";"T2-DB-5NXHSJ";"-";"USD/JPY";"80 000 Jednost.";"154,343";"-";"-";"-";"-";"4,151085";"332 086,80";"0,00";"-";"-";"-";"-";"-";"-";"-";"-";"-";"-";"-";"-";"-";"-";"-";"-";"-";"-";"-";"-";"-";"-";"-";"-";"-"
"21 List 2024 11:09:01";"Stop Loss";"O2-DB-9CMFT8";"T2-DB-5NXHPG";"-";"USD/JPY";"80 000 Jednost.";"154,360";"-";"-";"-";"-";"0,02663";"332 141,36";"29,83";"16 902,59";"-";"-";"-";"-";"-";"-";"-";"-";"-";"-";"-";"-";"-";"-";"-";"-";"-";"-";"-";"-";"-";"-";"-";"-"
"21 List 2024 11:08:56";"Zmodyfikowano Transakcję Sprzedaży";"O2-DB-9CMFT8";"T2-DB-5NXHKB";"-";"USD/JPY";"80 000 Jednost.";"154,374";"-";"154,360";"-";"-";"-";"-";"0,00";"-";"-";"-";"-";"-";"-";"-";"-";"-";"-";"-";"-";"-";"-";"-";"-";"-";"-";"-";"-";"-";"-";"-";"-";"-"
"21 List 2024 11:06:19";"Transakcja Sprzedaży";"O2-DB-9CMFT8";"T2-DB-5NXHKB";"-";"USD/JPY";"80 000 Jednost.";"154,374";"-";"-";"-";"-";"4,152819";"332 225,52";"0,00";"-";"-";"-";"-";"-";"-";"-";"-";"-";"-";"-";"-";"-";"-";"-";"-";"-";"-";"-";"-";"-";"-";"-";"-";"-"
"21 List 2024 11:03:12";"Stop Loss";"O2-DB-9CMFKJ";"T2-DB-5NXHF7";"-";"USD/JPY";"80 000 Jednost.";"154,310";"-";"-";"-";"-";"0,026629";"332 001,04";"51,13";"16 872,76";"-";"-";"-";"-";"-";"-";"-";"-";"-";"-";"-";"-";"-";"-";"-";"-";"-";"-";"-";"-";"-";"-";"-";"-"
"21 List 2024 11:02:56";"Zmodyfikowano Transakcję Sprzedaży";"O2-DB-9CMFKJ";"T2-DB-5NXHDX";"-";"USD/JPY";"80 000 Jednost.";"154,334";"-";"154,310";"-";"-";"-";"-";"0,00";"-";"-";"-";"-";"-";"-";"-";"-";"-";"-";"-";"-";"-";"-";"-";"-";"-";"-";"-";"-";"-";"-";"-";"-";"-"
"21 List 2024 11:02:00";"Transakcja Sprzedaży";"O2-DB-9CMFKJ";"T2-DB-5NXHDX";"-";"USD/JPY";"80 000 Jednost.";"154,334";"-";"-";"-";"-";"4,150704";"332 056,32";"0,00";"-";"-";"-";"-";"-";"-";"-";"-";"-";"-";"-";"-";"-";"-";"-";"-";"-";"-";"-";"-";"-";"-";"-";"-";"-"
"21 List 2024 10:23:47";"Stop Loss";"O2-DB-9CM9P4";"T2-DB-5NXF5F";"-";"USD/JPY";"80 000 Jednost.";"154,160";"-";"-";"-";"-";"0,026707";"332 652,72";"267,07";"16 821,63";"-";"-";"-";"-";"-";"-";"-";"-";"-";"-";"-";"-";"-";"-";"-";"-";"-";"-";"-";"-";"-";"-";"-";"-"
"21 List 2024 10:22:30";"Zmodyfikowano Transakcję Sprzedaży";"O2-DB-9CM9P4";"T2-DB-5NXDK5";"-";"USD/JPY";"80 000 Jednost.";"154,285";"-";"154,160";"-";"-";"-";"-";"0,00";"-";"-";"-";"-";"-";"-";"-";"-";"-";"-";"-";"-";"-";"-";"-";"-";"-";"-";"-";"-";"-";"-";"-";"-";"-"
"21 List 2024 10:05:29";"Transakcja Sprzedaży";"O2-DB-9CM9P4";"T2-DB-5NXDK5";"-";"USD/JPY";"80 000 Jednost.";"154,285";"-";"-";"-";"-";"4,150444";"332 035,52";"0,00";"-";"-";"-";"-";"-";"-";"-";"-";"-";"-";"-";"-";"-";"-";"-";"-";"-";"-";"-";"-";"-";"-";"-";"-";"-"
"21 List 2024 09:53:58";" Zamknięcie Transakcji";"O2-DB-9CM8P2";"T2-DB-5NXCS3";"O2-DB-9CKR35";"USD/JPY";"13 000 Jednost.";"154,498";"-";"-";"-";"-";"0,026582";"53 919,55";"244,32";"16 554,56";"-";"-";"-";"-";"-";"-";"-";"-";"-";"-";"-";"-";"-";"-";"-";"-";"-";"-";"-";"-";"-";"-";"-";"-"
"20 List 2024 23:08:56";"Zmodyfikowano Take Profit";"O2-DB-9CKXH9";"-";"O2-DB-9CLJ8N";"USD/JPY";"90 000 Jednost.";"155,516";"-";"-";"155,800";"-";"-";"-";"-";"-";"-";"-";"-";"-";"-";"-";"-";"-";"-";"-";"-";"-";"-";"-";"-";"-";"-";"-";"-";"-";"-";"-";"-";"-"
"20 List 2024 23:02:14";"Koszty Utrzymania Pozycji";"1389674679";"-";"-";"Rachunek";"-";"-";"-";"-";"-";"-";"-";"-";"-21,56";"16 310,24";"-";"-";"-";"-";"-";"-21,56";"-";"-";"-";"-";"-";"-";"-";"-";"-";"-";"-";"-";"-";"-";"-";"-";"-";"-"
"20 List 2024 23:02:14";"Koszty Utrzymania Pozycji";"O2-D9-9BJZX7";"-";"-";"USD/JPY";"-";"-";"-";"-";"-";"-";"-";"-";"-";"-";"-";"-";"30 000,00";"5,56280%";"-56,68";"0,00";"-";"-";"-";"-";"-";"-";"-";"-";"-";"-";"-";"-";"-";"-";"-";"-";"-";"-"
"20 List 2024 23:02:14";"Koszty Utrzymania Pozycji";"O2-D9-9BB04B";"-";"-";"USD/JPY";"-";"-";"-";"-";"-";"-";"-";"-";"-";"-";"-";"-";"34 000,00";"5,56280%";"-64,24";"0,00";"-";"-";"-";"-";"-";"-";"-";"-";"-";"-";"-";"-";"-";"-";"-";"-";"-";"-"
"20 List 2024 23:02:14";"Koszty Utrzymania Pozycji";"O2-DB-9C9X8L";"-";"-";"USD/JPY";"-";"-";"-";"-";"-";"-";"-";"-";"-";"-";"-";"-";"20 000,00";"3,51539%";"23,64";"0,00";"-";"-";"-";"-";"-";"-";"-";"-";"-";"-";"-";"-";"-";"-";"-";"-";"-";"-"
"20 List 2024 23:02:14";"Koszty Utrzymania Pozycji";"O2-D9-9BS5RZ";"-";"-";"USD/JPY";"-";"-";"-";"-";"-";"-";"-";"-";"-";"-";"-";"-";"22 000,00";"5,56280%";"-41,57";"0,00";"-";"-";"-";"-";"-";"-";"-";"-";"-";"-";"-";"-";"-";"-";"-";"-";"-";"-"
"20 List 2024 23:02:14";"Koszty Utrzymania Pozycji";"O2-DB-9CKXH9";"-";"-";"USD/JPY";"-";"-";"-";"-";"-";"-";"-";"-";"-";"-";"-";"-";"90 000,00";"3,51539%";"106,39";"0,00";"-";"-";"-";"-";"-";"-";"-";"-";"-";"-";"-";"-";"-";"-";"-";"-";"-";"-"
"20 List 2024 23:02:14";"Koszty Utrzymania Pozycji";"O2-DB-9C9XVJ";"-";"-";"USD/JPY";"-";"-";"-";"-";"-";"-";"-";"-";"-";"-";"-";"-";"30 000,00";"3,51539%";"35,46";"0,00";"-";"-";"-";"-";"-";"-";"-";"-";"-";"-";"-";"-";"-";"-";"-";"-";"-";"-"
"20 List 2024 23:02:14";"Koszty Utrzymania Pozycji";"O2-DB-9CKR35";"-";"-";"USD/JPY";"-";"-";"-";"-";"-";"-";"-";"-";"-";"-";"-";"-";"13 000,00";"5,56280%";"-24,56";"0,00";"-";"-";"-";"-";"-";"-";"-";"-";"-";"-";"-";"-";"-";"-";"-";"-";"-";"-"
"20 List 2024 22:48:16";"Zmodyfikowano Take Profit";"O2-DB-9CKXH9";"-";"O2-DB-9CLJ8N";"USD/JPY";"90 000 Jednost.";"155,516";"-";"-";"155,550";"-";"-";"-";"-";"-";"-";"-";"-";"-";"-";"-";"-";"-";"-";"-";"-";"-";"-";"-";"-";"-";"-";"-";"-";"-";"-";"-";"-";"-"
"20 List 2024 22:27:36";" Zmodyfikowano Transakcję Kupna";"O2-DB-9CKXH9";"T2-DB-5NWCP4";"-";"USD/JPY";"90 000 Jednost.";"155,516";"-";"-";"155,525";"-";"-";"-";"0,00";"-";"-";"-";"-";"-";"-";"-";"-";"-";"-";"-";"-";"-";"-";"-";"-";"-";"-";"-";"-";"-";"-";"-";"-";"-"
"20 List 2024 17:20:02";" Transakcja Kupna";"O2-DB-9CKXH9";"T2-DB-5NWCP4";"-";"USD/JPY";"90 000 Jednost.";"155,516";"-";"-";"-";"-";"4,144883";"373 039,47";"0,00";"-";"-";"-";"-";"-";"-";"-";"-";"-";"-";"-";"-";"-";"-";"-";"-";"-";"-";"-";"-";"-";"-";"-";"-";"-"
"20 List 2024 16:55:07";"Stop Loss";"O2-DB-9CKSY2";"T2-DB-5NW98Z";"-";"USD/JPY";"90 000 Jednost.";"155,480";"-";"-";"-";"-";"0,026372";"372 834,72";"142,41";"16 331,80";"-";"-";"-";"-";"-";"-";"-";"-";"-";"-";"-";"-";"-";"-";"-";"-";"-";"-";"-";"-";"-";"-";"-";"-"
"20 List 2024 16:54:58";"Zmodyfikowano Stop Loss";"O2-DB-9CKSY2";"-";"O2-DB-9CKTJB";"USD/JPY";"90 000 Jednost.";"155,420";"-";"155,480";"-";"-";"-";"-";"-";"-";"-";"-";"-";"-";"-";"-";"-";"-";"-";"-";"-";"-";"-";"-";"-";"-";"-";"-";"-";"-";"-";"-";"-";"-"
"20 List 2024 16:54:40";" Zmodyfikowano Transakcję Kupna";"O2-DB-9CKSY2";"T2-DB-5NW8S9";"-";"USD/JPY";"90 000 Jednost.";"155,420";"-";"155,470";"-";"-";"-";"-";"0,00";"-";"-";"-";"-";"-";"-";"-";"-";"-";"-";"-";"-";"-";"-";"-";"-";"-";"-";"-";"-";"-";"-";"-";"-";"-"
"20 List 2024 16:49:09";" Transakcja Kupna";"O2-DB-9CKSY2";"T2-DB-5NW8S9";"-";"USD/JPY";"90 000 Jednost.";"155,420";"-";"-";"-";"-";"4,142969";"372 867,21";"0,00";"-";"-";"-";"-";"-";"-";"-";"-";"-";"-";"-";"-";"-";"-";"-";"-";"-";"-";"-";"-";"-";"-";"-";"-";"-"
"20 List 2024 16:34:23";"Transakcja Sprzedaży";"O2-DB-9CKR35";"T2-DB-5NW7CX";"-";"USD/JPY";"13 000 Jednost.";"155,205";"-";"-";"-";"-";"4,138109";"53 795,41";"0,00";"-";"-";"-";"-";"-";"-";"-";"-";"-";"-";"-";"-";"-";"-";"-";"-";"-";"-";"-";"-";"-";"-";"-";"-";"-"
"20 List 2024 11:09:37";" Zamknięcie Transakcji";"O2-DB-9CK1EY";"T2-DB-5NVNBE";"O2-DB-9CCHQ3";"USD/JPY";"37 000 Jednost.";"155,701";"-";"-";"-";"-";"0,026266";"152 848,29";"370,27";"16 189,39";"-";"-";"-";"-";"-";"-";"-";"-";"-";"-";"-";"-";"-";"-";"-";"-";"-";"-";"-";"-";"-";"-";"-";"-"
"20 List 2024 11:01:00";"Stop Loss";"O2-DB-9CK0J8";"T2-DB-5NVN4Q";"-";"USD/JPY";"44 500 Jednost.";"155,720";"-";"-";"-";"-";"0,02627";"183 881,87";"26,89";"15 819,12";"-";"-";"-";"-";"-";"-";"-";"-";"-";"-";"-";"-";"-";"-";"-";"-";"-";"-";"-";"-";"-";"-";"-";"-"
"20 List 2024 11:00:15";" Zmodyfikowano Transakcję Kupna";"O2-DB-9CK0J8";"T2-DB-5NVMP0";"-";"USD/JPY";"44 500 Jednost.";"155,697";"-";"155,720";"-";"-";"-";"-";"0,00";"-";"-";"-";"-";"-";"-";"-";"-";"-";"-";"-";"-";"-";"-";"-";"-";"-";"-";"-";"-";"-";"-";"-";"-";"-"
"20 List 2024 10:49:01";" Transakcja Kupna";"O2-DB-9CK0J8";"T2-DB-5NVMP0";"-";"USD/JPY";"44 500 Jednost.";"155,697";"-";"-";"-";"-";"4,12865";"183 724,92";"0,00";"-";"-";"-";"-";"-";"-";"-";"-";"-";"-";"-";"-";"-";"-";"-";"-";"-";"-";"-";"-";"-";"-";"-";"-";"-"
"20 List 2024 10:42:05";" Zamknięcie Transakcji";"O2-DB-9CK064";"T2-DB-5NVME7";"O2-DB-9CCHJJ";"USD/JPY";"6 000 Jednost.";"155,783";"-";"-";"-";"-";"0,026245";"24 775,93";"75,27";"15 792,23";"-";"-";"-";"-";"-";"-";"-";"-";"-";"-";"-";"-";"-";"-";"-";"-";"-";"-";"-";"-";"-";"-";"-";"-"
"20 List 2024 10:41:55";" Zamknięcie Transakcji";"O2-DB-9CK05R";"T2-DB-5NVME0";"O2-DB-9CJVT3";"USD/JPY";"6 500 Jednost.";"155,753";"-";"-";"-";"-";"0,026243";"26 837,66";"17,91";"15 716,96";"-";"-";"-";"-";"-";"-";"-";"-";"-";"-";"-";"-";"-";"-";"-";"-";"-";"-";"-";"-";"-";"-";"-";"-"
"20 List 2024 10:41:46";" Zamknięcie Transakcji";"O2-DB-9CK05L";"T2-DB-5NVMDX";"O2-DB-9CJSHP";"USD/JPY";"32 000 Jednost.";"155,748";"-";"-";"-";"-";"0,026241";"132 118,75";"41,99";"15 699,05";"-";"-";"-";"-";"-";"-";"-";"-";"-";"-";"-";"-";"-";"-";"-";"-";"-";"-";"-";"-";"-";"-";"-";"-"
"20 List 2024 09:27:34";" Transakcja Kupna";"O2-DB-9CJVT3";"T2-DB-5NVJ24";"-";"USD/JPY";"6 500 Jednost.";"155,648";"-";"-";"-";"-";"4,122338";"26 795,19";"0,00";"-";"-";"-";"-";"-";"-";"-";"-";"-";"-";"-";"-";"-";"-";"-";"-";"-";"-";"-";"-";"-";"-";"-";"-";"-"
"20 List 2024 09:01:05";" Transakcja Kupna";"O2-DB-9CJSHP";"T2-DB-5NVG8E";"-";"USD/JPY";"32 000 Jednost.";"155,698";"-";"-";"-";"-";"4,117578";"131 762,49";"0,00";"-";"-";"-";"-";"-";"-";"-";"-";"-";"-";"-";"-";"-";"-";"-";"-";"-";"-";"-";"-";"-";"-";"-";"-";"-"
"20 List 2024 00:09:44";"Stop Loss";"O2-DB-9CJ9JE";"T2-DB-5NV5RS";"-";"USD/JPY";"40 000 Jednost.";"154,600";"-";"-";"-";"-";"0,026319";"164 390,12";"71,59";"15 657,06";"-";"-";"-";"-";"-";"-";"-";"-";"-";"-";"-";"-";"-";"-";"-";"-";"-";"-";"-";"-";"-";"-";"-";"-"
"20 List 2024 00:07:17";"Zmodyfikowano Transakcję Sprzedaży";"O2-DB-9CJ9JE";"T2-DB-5NV59S";"-";"USD/JPY";"40 000 Jednost.";"154,668";"-";"154,600";"154,000";"-";"-";"-";"0,00";"-";"-";"-";"-";"-";"-";"-";"-";"-";"-";"-";"-";"-";"-";"-";"-";"-";"-";"-";"-";"-";"-";"-";"-";"-"
"19 List 2024 23:02:01";"Koszty Utrzymania Pozycji";"1389351494";"-";"-";"Rachunek";"-";"-";"-";"-";"-";"-";"-";"-";"-42,48";"15 585,47";"-";"-";"-";"-";"-";"-42,48";"-";"-";"-";"-";"-";"-";"-";"-";"-";"-";"-";"-";"-";"-";"-";"-";"-";"-"
"19 List 2024 23:02:01";"Koszty Utrzymania Pozycji";"O2-D9-9BJZX7";"-";"-";"USD/JPY";"-";"-";"-";"-";"-";"-";"-";"-";"-";"-";"-";"-";"30 000,00";"5,56280%";"-18,79";"0,00";"-";"-";"-";"-";"-";"-";"-";"-";"-";"-";"-";"-";"-";"-";"-";"-";"-";"-"
"19 List 2024 23:02:01";"Koszty Utrzymania Pozycji";"O2-D9-9BB04B";"-";"-";"USD/JPY";"-";"-";"-";"-";"-";"-";"-";"-";"-";"-";"-";"-";"34 000,00";"5,56280%";"-21,30";"0,00";"-";"-";"-";"-";"-";"-";"-";"-";"-";"-";"-";"-";"-";"-";"-";"-";"-";"-"
"19 List 2024 23:02:01";"Koszty Utrzymania Pozycji";"O2-DB-9CJ9JE";"-";"-";"USD/JPY";"-";"-";"-";"-";"-";"-";"-";"-";"-";"-";"-";"-";"40 000,00";"5,56280%";"-25,06";"0,00";"-";"-";"-";"-";"-";"-";"-";"-";"-";"-";"-";"-";"-";"-";"-";"-";"-";"-"
"19 List 2024 23:02:01";"Koszty Utrzymania Pozycji";"O2-DB-9C9X8L";"-";"-";"USD/JPY";"-";"-";"-";"-";"-";"-";"-";"-";"-";"-";"-";"-";"20 000,00";"3,51539%";"7,84";"0,00";"-";"-";"-";"-";"-";"-";"-";"-";"-";"-";"-";"-";"-";"-";"-";"-";"-";"-"
"19 List 2024 23:02:01";"Koszty Utrzymania Pozycji";"O2-DB-9CCHJJ";"-";"-";"USD/JPY";"-";"-";"-";"-";"-";"-";"-";"-";"-";"-";"-";"-";"6 000,00";"3,51539%";"2,35";"0,00";"-";"-";"-";"-";"-";"-";"-";"-";"-";"-";"-";"-";"-";"-";"-";"-";"-";"-"
"19 List 2024 23:02:01";"Koszty Utrzymania Pozycji";"O2-D9-9BS5RZ";"-";"-";"USD/JPY";"-";"-";"-";"-";"-";"-";"-";"-";"-";"-";"-";"-";"22 000,00";"5,56280%";"-13,78";"0,00";"-";"-";"-";"-";"-";"-";"-";"-";"-";"-";"-";"-";"-";"-";"-";"-";"-";"-"
"19 List 2024 23:02:01";"Koszty Utrzymania Pozycji";"O2-DB-9C9XVJ";"-";"-";"USD/JPY";"-";"-";"-";"-";"-";"-";"-";"-";"-";"-";"-";"-";"30 000,00";"3,51539%";"11,76";"0,00";"-";"-";"-";"-";"-";"-";"-";"-";"-";"-";"-";"-";"-";"-";"-";"-";"-";"-"
"19 List 2024 23:02:01";"Koszty Utrzymania Pozycji";"O2-DB-9CCHQ3";"-";"-";"USD/JPY";"-";"-";"-";"-";"-";"-";"-";"-";"-";"-";"-";"-";"37 000,00";"3,51539%";"14,50";"0,00";"-";"-";"-";"-";"-";"-";"-";"-";"-";"-";"-";"-";"-";"-";"-";"-";"-";"-"
"19 List 2024 22:48:57";"Zmodyfikowano Transakcję Sprzedaży";"O2-DB-9CJ9JE";"T2-DB-5NV59S";"-";"USD/JPY";"40 000 Jednost.";"154,668";"-";"-";"154,000";"-";"-";"-";"0,00";"-";"-";"-";"-";"-";"-";"-";"-";"-";"-";"-";"-";"-";"-";"-";"-";"-";"-";"-";"-";"-";"-";"-";"-";"-"
"19 List 2024 22:47:49";"Transakcja Sprzedaży";"O2-DB-9CJ9JE";"T2-DB-5NV59S";"-";"USD/JPY";"40 000 Jednost.";"154,668";"-";"-";"-";"-";"4,110324";"164 412,96";"0,00";"-";"-";"-";"-";"-";"-";"-";"-";"-";"-";"-";"-";"-";"-";"-";"-";"-";"-";"-";"-";"-";"-";"-";"-";"-"
"19 List 2024 19:32:34";"Stop Loss";"O2-DB-9CHYE2";"T2-DB-5NTY8Z";"-";"USD/JPY";"32 000 Jednost.";"154,730";"-";"-";"-";"-";"0,026357";"131 821,50";"95,31";"15 627,95";"-";"-";"-";"-";"-";"-";"-";"-";"-";"-";"-";"-";"-";"-";"-";"-";"-";"-";"-";"-";"-";"-";"-";"-"
"19 List 2024 19:32:30";"Zmodyfikowano Stop Loss";"O2-DB-9CHYE2";"-";"O2-DB-9CHYKF";"USD/JPY";"32 000 Jednost.";"154,617";"-";"154,730";"-";"-";"-";"-";"-";"-";"-";"-";"-";"-";"-";"-";"-";"-";"-";"-";"-";"-";"-";"-";"-";"-";"-";"-";"-";"-";"-";"-";"-";"-"
"19 List 2024 19:01:09";"Zmodyfikowano Stop Loss";"O2-DB-9CHYE2";"-";"O2-DB-9CHYKF";"USD/JPY";"32 000 Jednost.";"154,617";"-";"154,700";"-";"-";"-";"-";"-";"-";"-";"-";"-";"-";"-";"-";"-";"-";"-";"-";"-";"-";"-";"-";"-";"-";"-";"-";"-";"-";"-";"-";"-";"-"
"19 List 2024 18:56:53";" Zmodyfikowano Transakcję Kupna";"O2-DB-9CHYE2";"T2-DB-5NTWTC";"-";"USD/JPY";"32 000 Jednost.";"154,617";"-";"154,650";"-";"-";"-";"-";"0,00";"-";"-";"-";"-";"-";"-";"-";"-";"-";"-";"-";"-";"-";"-";"-";"-";"-";"-";"-";"-";"-";"-";"-";"-";"-"
"19 List 2024 18:52:47";" Transakcja Kupna";"O2-DB-9CHYE2";"T2-DB-5NTWTC";"-";"USD/JPY";"32 000 Jednost.";"154,617";"-";"-";"-";"-";"4,114332";"131 658,62";"0,00";"-";"-";"-";"-";"-";"-";"-";"-";"-";"-";"-";"-";"-";"-";"-";"-";"-";"-";"-";"-";"-";"-";"-";"-";"-"
"19 List 2024 18:40:11";"Stop Loss";"O2-DB-9CHWC9";"T2-DB-5NTWBW";"-";"USD/JPY";"32 000 Jednost.";"154,560";"-";"-";"-";"-";"0,026356";"131 682,65";"99,52";"15 532,64";"-";"-";"-";"-";"-";"-";"-";"-";"-";"-";"-";"-";"-";"-";"-";"-";"-";"-";"-";"-";"-";"-";"-";"-"
"19 List 2024 18:40:01";"Zmodyfikowano Stop Loss";"O2-DB-9CHWC9";"-";"O2-DB-9CHX41";"USD/JPY";"32 000 Jednost.";"154,442";"-";"154,560";"-";"-";"-";"-";"-";"-";"-";"-";"-";"-";"-";"-";"-";"-";"-";"-";"-";"-";"-";"-";"-";"-";"-";"-";"-";"-";"-";"-";"-";"-"
"19 List 2024 18:38:17";" Zmodyfikowano Transakcję Kupna";"O2-DB-9CHWC9";"T2-DB-5NTVSK";"-";"USD/JPY";"32 000 Jednost.";"154,442";"-";"154,480";"-";"-";"-";"-";"0,00";"-";"-";"-";"-";"-";"-";"-";"-";"-";"-";"-";"-";"-";"-";"-";"-";"-";"-";"-";"-";"-";"-";"-";"-";"-"
"19 List 2024 18:30:43";" Transakcja Kupna";"O2-DB-9CHWC9";"T2-DB-5NTVSK";"-";"USD/JPY";"32 000 Jednost.";"154,442";"-";"-";"-";"-";"4,112989";"131 615,64";"0,00";"-";"-";"-";"-";"-";"-";"-";"-";"-";"-";"-";"-";"-";"-";"-";"-";"-";"-";"-";"-";"-";"-";"-";"-";"-"
"19 List 2024 18:10:35";"Stop Loss";"O2-DB-9CHRWJ";"T2-DB-5NTTSS";"-";"USD/JPY";"30 000 Jednost.";"154,305";"-";"-";"-";"-";"0,026387";"123 368,94";"21,37";"15 433,12";"-";"-";"-";"-";"-";"-";"-";"-";"-";"-";"-";"-";"-";"-";"-";"-";"-";"-";"-";"-";"-";"-";"-";"-"
"19 List 2024 18:09:46";"Zmodyfikowano Stop Loss";"O2-DB-9CHRWJ";"-";"O2-DB-9CHSR4";"USD/JPY";"30 000 Jednost.";"154,332";"-";"154,300";"-";"-";"-";"-";"-";"-";"-";"-";"-";"-";"-";"-";"-";"-";"-";"-";"-";"-";"-";"-";"-";"-";"-";"-";"-";"-";"-";"-";"-";"-"
"19 List 2024 18:08:35";"Zmodyfikowano Transakcję Sprzedaży";"O2-DB-9CHRWJ";"T2-DB-5NTTKF";"-";"USD/JPY";"30 000 Jednost.";"154,332";"-";"154,310";"-";"-";"-";"-";"0,00";"-";"-";"-";"-";"-";"-";"-";"-";"-";"-";"-";"-";"-";"-";"-";"-";"-";"-";"-";"-";"-";"-";"-";"-";"-"
"19 List 2024 18:04:58";"Transakcja Sprzedaży";"O2-DB-9CHRWJ";"T2-DB-5NTTKF";"-";"USD/JPY";"30 000 Jednost.";"154,332";"-";"-";"-";"-";"4,113741";"123 412,23";"0,00";"-";"-";"-";"-";"-";"-";"-";"-";"-";"-";"-";"-";"-";"-";"-";"-";"-";"-";"-";"-";"-";"-";"-";"-";"-"
"19 List 2024 16:29:57";"Stop Loss";"O2-DB-9CHGSN";"T2-DB-5NTLVR";"-";"USD/JPY";"30 000 Jednost.";"153,930";"-";"-";"-";"-";"0,026465";"123 418,53";"46,05";"15 411,75";"-";"-";"-";"-";"-";"-";"-";"-";"-";"-";"-";"-";"-";"-";"-";"-";"-";"-";"-";"-";"-";"-";"-";"-"
"19 List 2024 16:29:26";"Zmodyfikowano Transakcję Sprzedaży";"O2-DB-9CHGSN";"T2-DB-5NTLFY";"-";"USD/JPY";"30 000 Jednost.";"153,988";"-";"153,930";"153,580";"-";"-";"-";"0,00";"-";"-";"-";"-";"-";"-";"-";"-";"-";"-";"-";"-";"-";"-";"-";"-";"-";"-";"-";"-";"-";"-";"-";"-";"-"
"19 List 2024 16:26:00";"Zmodyfikowano Transakcję Sprzedaży";"O2-DB-9CHGSN";"T2-DB-5NTLFY";"-";"USD/JPY";"30 000 Jednost.";"153,988";"-";"-";"153,580";"-";"-";"-";"0,00";"-";"-";"-";"-";"-";"-";"-";"-";"-";"-";"-";"-";"-";"-";"-";"-";"-";"-";"-";"-";"-";"-";"-";"-";"-"
"19 List 2024 16:25:01";"Transakcja Sprzedaży";"O2-DB-9CHGSN";"T2-DB-5NTLFY";"-";"USD/JPY";"30 000 Jednost.";"153,988";"-";"-";"-";"-";"4,116456";"123 493,68";"0,00";"-";"-";"-";"-";"-";"-";"-";"-";"-";"-";"-";"-";"-";"-";"-";"-";"-";"-";"-";"-";"-";"-";"-";"-";"-"
"19 List 2024 15:09:56";"Stop Loss";"O2-DB-9CH14Z";"T2-DB-5NTDEH";"-";"USD/JPY";"32 000 Jednost.";"153,950";"-";"-";"-";"-";"0,026429";"131 540,28";"105,72";"15 365,70";"-";"-";"-";"-";"-";"-";"-";"-";"-";"-";"-";"-";"-";"-";"-";"-";"-";"-";"-";"-";"-";"-";"-";"-"
"19 List 2024 15:09:19";"Zmodyfikowano Take Profit";"O2-DB-9CH14Z";"-";"O2-DB-9CH4ZS";"USD/JPY";"32 000 Jednost.";"153,825";"-";"-";"154,150";"-";"-";"-";"-";"-";"-";"-";"-";"-";"-";"-";"-";"-";"-";"-";"-";"-";"-";"-";"-";"-";"-";"-";"-";"-";"-";"-";"-";"-"
"19 List 2024 15:09:19";" Zmodyfikowano Transakcję Kupna";"O2-DB-9CH14Z";"T2-DB-5NT7BR";"-";"USD/JPY";"32 000 Jednost.";"153,825";"-";"153,950";"154,150";"-";"-";"-";"0,00";"-";"-";"-";"-";"-";"-";"-";"-";"-";"-";"-";"-";"-";"-";"-";"-";"-";"-";"-";"-";"-";"-";"-";"-";"-"
"19 List 2024 14:56:07";" Zmodyfikowano Transakcję Kupna";"O2-DB-9CH14Z";"T2-DB-5NT7BR";"-";"USD/JPY";"32 000 Jednost.";"153,825";"-";"-";"154,100";"-";"-";"-";"0,00";"-";"-";"-";"-";"-";"-";"-";"-";"-";"-";"-";"-";"-";"-";"-";"-";"-";"-";"-";"-";"-";"-";"-";"-";"-"
"19 List 2024 14:10:25";" Transakcja Kupna";"O2-DB-9CH14Z";"T2-DB-5NT7BR";"-";"USD/JPY";"32 000 Jednost.";"153,825";"-";"-";"-";"-";"4,113851";"131 643,23";"0,00";"-";"-";"-";"-";"-";"-";"-";"-";"-";"-";"-";"-";"-";"-";"-";"-";"-";"-";"-";"-";"-";"-";"-";"-";"-"
"19 List 2024 13:59:05";"Stop Loss";"O2-DB-9CH0C3";"T2-DB-5NT6WM";"-";"USD/JPY";"40 000 Jednost.";"154,030";"-";"-";"-";"-";"0,026439";"164 523,16";"23,27";"15 259,98";"-";"-";"-";"-";"-";"-";"-";"-";"-";"-";"-";"-";"-";"-";"-";"-";"-";"-";"-";"-";"-";"-";"-";"-"
"19 List 2024 13:58:48";"Zmodyfikowano Transakcję Sprzedaży";"O2-DB-9CH0C3";"T2-DB-5NT6QD";"-";"USD/JPY";"40 000 Jednost.";"154,052";"-";"154,030";"-";"-";"-";"-";"0,00";"-";"-";"-";"-";"-";"-";"-";"-";"-";"-";"-";"-";"-";"-";"-";"-";"-";"-";"-";"-";"-";"-";"-";"-";"-"
"19 List 2024 13:55:28";"Transakcja Sprzedaży";"O2-DB-9CH0C3";"T2-DB-5NT6QD";"-";"USD/JPY";"40 000 Jednost.";"154,052";"-";"-";"-";"-";"4,115103";"164 604,12";"0,00";"-";"-";"-";"-";"-";"-";"-";"-";"-";"-";"-";"-";"-";"-";"-";"-";"-";"-";"-";"-";"-";"-";"-";"-";"-"
"19 List 2024 13:50:56";"Stop Loss";"O2-DB-9CGX8J";"T2-DB-5NT6LL";"-";"USD/JPY";"30 000 Jednost.";"154,150";"-";"-";"-";"-";"0,026429";"123 455,82";"20,61";"15 236,71";"-";"-";"-";"-";"-";"-";"-";"-";"-";"-";"-";"-";"-";"-";"-";"-";"-";"-";"-";"-";"-";"-";"-";"-"
"19 List 2024 13:45:39";" Zmodyfikowano Transakcję Kupna";"O2-DB-9CGX8J";"T2-DB-5NT4JT";"-";"USD/JPY";"30 000 Jednost.";"154,124";"-";"154,150";"-";"-";"-";"-";"0,00";"-";"-";"-";"-";"-";"-";"-";"-";"-";"-";"-";"-";"-";"-";"-";"-";"-";"-";"-";"-";"-";"-";"-";"-";"-"
"19 List 2024 12:58:31";" Transakcja Kupna";"O2-DB-9CGX8J";"T2-DB-5NT4JT";"-";"USD/JPY";"30 000 Jednost.";"154,124";"-";"-";"-";"-";"4,12348";"123 704,40";"0,00";"-";"-";"-";"-";"-";"-";"-";"-";"-";"-";"-";"-";"-";"-";"-";"-";"-";"-";"-";"-";"-";"-";"-";"-";"-"
"19 List 2024 11:01:43";"Stop Loss";"O2-DB-9CGP48";"T2-DB-5NT05B";"-";"USD/JPY";"40 000 Jednost.";"153,760";"-";"-";"-";"-";"0,026575";"165 068,28";"34,02";"15 216,10";"-";"-";"-";"-";"-";"-";"-";"-";"-";"-";"-";"-";"-";"-";"-";"-";"-";"-";"-";"-";"-";"-";"-";"-"
"19 List 2024 11:01:41";"Zmodyfikowano Transakcję Sprzedaży";"O2-DB-9CGP48";"T2-DB-5NSZWB";"-";"USD/JPY";"40 000 Jednost.";"153,792";"-";"153,760";"-";"-";"-";"-";"0,00";"-";"-";"-";"-";"-";"-";"-";"-";"-";"-";"-";"-";"-";"-";"-";"-";"-";"-";"-";"-";"-";"-";"-";"-";"-"
"19 List 2024 10:58:18";"Transakcja Sprzedaży";"O2-DB-9CGP48";"T2-DB-5NSZWB";"-";"USD/JPY";"40 000 Jednost.";"153,792";"-";"-";"-";"-";"4,126656";"165 066,24";"0,00";"-";"-";"-";"-";"-";"-";"-";"-";"-";"-";"-";"-";"-";"-";"-";"-";"-";"-";"-";"-";"-";"-";"-";"-";"-"
"19 List 2024 10:53:45";"Stop Loss";"O2-DB-9CGHKW";"T2-DB-5NSZK8";"-";"USD/JPY";"30 000 Jednost.";"153,780";"-";"-";"-";"-";"0,026557";"123 763,62";"17,53";"15 182,08";"-";"-";"-";"-";"-";"-";"-";"-";"-";"-";"-";"-";"-";"-";"-";"-";"-";"-";"-";"-";"-";"-";"-";"-"
"19 List 2024 10:53:07";" Zmodyfikowano Transakcję Kupna";"O2-DB-9CGHKW";"T2-DB-5NSTNP";"-";"USD/JPY";"30 000 Jednost.";"153,758";"-";"153,780";"-";"-";"-";"-";"0,00";"-";"-";"-";"-";"-";"-";"-";"-";"-";"-";"-";"-";"-";"-";"-";"-";"-";"-";"-";"-";"-";"-";"-";"-";"-"
"19 List 2024 10:17:20";" Transakcja Kupna";"O2-DB-9CGHKW";"T2-DB-5NSTNP";"-";"USD/JPY";"30 000 Jednost.";"153,758";"-";"-";"-";"-";"4,120073";"123 602,19";"0,00";"-";"-";"-";"-";"-";"-";"-";"-";"-";"-";"-";"-";"-";"-";"-";"-";"-";"-";"-";"-";"-";"-";"-";"-";"-"
"19 List 2024 10:16:12";" Zamknięcie Transakcji";"O2-DB-9CGHDH";"T2-DB-5NSTG7";"O2-DB-9CGH0X";"USD/JPY";"40 000 Jednost.";"153,886";"-";"-";"-";"-";"0,026455";"164 523,56";"64,55";"15 164,55";"-";"-";"-";"-";"-";"-";"-";"-";"-";"-";"-";"-";"-";"-";"-";"-";"-";"-";"-";"-";"-";"-";"-";"-"
"19 List 2024 10:10:51";"Transakcja Sprzedaży";"O2-DB-9CGH0X";"T2-DB-5NST4S";"-";"USD/JPY";"40 000 Jednost.";"153,947";"-";"-";"-";"-";"4,111576";"164 463,04";"0,00";"-";"-";"-";"-";"-";"-";"-";"-";"-";"-";"-";"-";"-";"-";"-";"-";"-";"-";"-";"-";"-";"-";"-";"-";"-"
"19 List 2024 02:13:25";"Take Profit";"O2-DB-9CFS8S";"T2-DB-5NSEDW";"-";"USD/JPY";"30 000 Jednost.";"154,100";"-";"-";"-";"-";"0,02635";"123 041,58";"378,65";"15 100,00";"-";"-";"-";"-";"-";"-";"-";"-";"-";"-";"-";"-";"-";"-";"-";"-";"-";"-";"-";"-";"-";"-";"-";"-"
"18 List 2024 23:02:06";"Koszty Utrzymania Pozycji";"1389001605";"-";"-";"Rachunek";"-";"-";"-";"-";"-";"-";"-";"-";"-36,75";"14 721,35";"-";"-";"-";"-";"-";"-36,75";"-";"-";"-";"-";"-";"-";"-";"-";"-";"-";"-";"-";"-";"-";"-";"-";"-";"-"
"18 List 2024 23:02:06";"Koszty Utrzymania Pozycji";"O2-D9-9BJZX7";"-";"-";"USD/JPY";"-";"-";"-";"-";"-";"-";"-";"-";"-";"-";"-";"-";"30 000,00";"5,59284%";"-18,80";"0,00";"-";"-";"-";"-";"-";"-";"-";"-";"-";"-";"-";"-";"-";"-";"-";"-";"-";"-"
"18 List 2024 23:02:06";"Koszty Utrzymania Pozycji";"O2-D9-9BB04B";"-";"-";"USD/JPY";"-";"-";"-";"-";"-";"-";"-";"-";"-";"-";"-";"-";"34 000,00";"5,59284%";"-21,31";"0,00";"-";"-";"-";"-";"-";"-";"-";"-";"-";"-";"-";"-";"-";"-";"-";"-";"-";"-"
"18 List 2024 23:02:06";"Koszty Utrzymania Pozycji";"O2-DB-9C9X8L";"-";"-";"USD/JPY";"-";"-";"-";"-";"-";"-";"-";"-";"-";"-";"-";"-";"20 000,00";"3,48444%";"7,73";"0,00";"-";"-";"-";"-";"-";"-";"-";"-";"-";"-";"-";"-";"-";"-";"-";"-";"-";"-"
"18 List 2024 23:02:06";"Koszty Utrzymania Pozycji";"O2-DB-9CCHJJ";"-";"-";"USD/JPY";"-";"-";"-";"-";"-";"-";"-";"-";"-";"-";"-";"-";"6 000,00";"3,48444%";"2,32";"0,00";"-";"-";"-";"-";"-";"-";"-";"-";"-";"-";"-";"-";"-";"-";"-";"-";"-";"-"
"18 List 2024 23:02:06";"Koszty Utrzymania Pozycji";"O2-D9-9BS5RZ";"-";"-";"USD/JPY";"-";"-";"-";"-";"-";"-";"-";"-";"-";"-";"-";"-";"22 000,00";"5,59284%";"-13,79";"0,00";"-";"-";"-";"-";"-";"-";"-";"-";"-";"-";"-";"-";"-";"-";"-";"-";"-";"-"
"18 List 2024 23:02:06";"Koszty Utrzymania Pozycji";"O2-DB-9C9XVJ";"-";"-";"USD/JPY";"-";"-";"-";"-";"-";"-";"-";"-";"-";"-";"-";"-";"30 000,00";"3,48444%";"11,60";"0,00";"-";"-";"-";"-";"-";"-";"-";"-";"-";"-";"-";"-";"-";"-";"-";"-";"-";"-"
"18 List 2024 23:02:06";"Koszty Utrzymania Pozycji";"O2-DB-9CCHQ3";"-";"-";"USD/JPY";"-";"-";"-";"-";"-";"-";"-";"-";"-";"-";"-";"-";"37 000,00";"3,48444%";"14,30";"0,00";"-";"-";"-";"-";"-";"-";"-";"-";"-";"-";"-";"-";"-";"-";"-";"-";"-";"-"
"18 List 2024 23:02:06";"Koszty Utrzymania Pozycji";"O2-DB-9CFS8S";"-";"-";"USD/JPY";"-";"-";"-";"-";"-";"-";"-";"-";"-";"-";"-";"-";"30 000,00";"5,59284%";"-18,80";"0,00";"-";"-";"-";"-";"-";"-";"-";"-";"-";"-";"-";"-";"-";"-";"-";"-";"-";"-"
"18 List 2024 22:50:09";"Zmodyfikowano Transakcję Sprzedaży";"O2-DB-9CFS8S";"T2-DB-5NSBKG";"-";"USD/JPY";"30 000 Jednost.";"154,579";"-";"-";"154,100";"-";"-";"-";"0,00";"-";"-";"-";"-";"-";"-";"-";"-";"-";"-";"-";"-";"-";"-";"-";"-";"-";"-";"-";"-";"-";"-";"-";"-";"-"
"18 List 2024 22:24:43";"Transakcja Sprzedaży";"O2-DB-9CFS8S";"T2-DB-5NSBKG";"-";"USD/JPY";"30 000 Jednost.";"154,579";"-";"-";"-";"-";"4,090224";"122 706,72";"0,00";"-";"-";"-";"-";"-";"-";"-";"-";"-";"-";"-";"-";"-";"-";"-";"-";"-";"-";"-";"-";"-";"-";"-";"-";"-"
"18 List 2024 16:49:24";" Zamknięcie Transakcji";"O2-DB-9CF649";"T2-DB-5NRVMN";"O2-DB-9CF21T";"USD/JPY";"31 000 Jednost.";"155,011";"-";"-";"-";"-";"0,026208";"127 192,96";"21,12";"14 758,10";"-";"-";"-";"-";"-";"-";"-";"-";"-";"-";"-";"-";"-";"-";"-";"-";"-";"-";"-";"-";"-";"-";"-";"-"
"18 List 2024 16:14:46";" Transakcja Kupna";"O2-DB-9CF21T";"T2-DB-5NRR6J";"-";"USD/JPY";"31 000 Jednost.";"154,985";"-";"-";"-";"-";"4,106787";"127 310,39";"0,00";"-";"-";"-";"-";"-";"-";"-";"-";"-";"-";"-";"-";"-";"-";"-";"-";"-";"-";"-";"-";"-";"-";"-";"-";"-"
"18 List 2024 15:21:41";" Zamknięcie Transakcji";"O2-DB-9CEVQR";"T2-DB-5NRL5V";"O2-DB-9CEG4M";"USD/JPY";"30 000 Jednost.";"154,834";"-";"-";"-";"-";"0,026281";"123 305,22";"3,15";"14 736,98";"-";"-";"-";"-";"-";"-";"-";"-";"-";"-";"-";"-";"-";"-";"-";"-";"-";"-";"-";"-";"-";"-";"-";"-"
"18 List 2024 14:25:32";" Zamknięcie Transakcji";"O2-DB-9CER73";"T2-DB-5NRHK9";"O2-DB-9CEJ41";"USD/JPY";"40 000 Jednost.";"155,151";"-";"-";"-";"-";"0,026276";"164 726,36";"49,40";"14 733,83";"-";"-";"-";"-";"-";"-";"-";"-";"-";"-";"-";"-";"-";"-";"-";"-";"-";"-";"-";"-";"-";"-";"-";"-"
"18 List 2024 12:05:37";" Transakcja Kupna";"O2-DB-9CEJ41";"T2-DB-5NRCP9";"-";"USD/JPY";"40 000 Jednost.";"155,104";"-";"-";"-";"-";"4,131075";"165 243,00";"0,00";"-";"-";"-";"-";"-";"-";"-";"-";"-";"-";"-";"-";"-";"-";"-";"-";"-";"-";"-";"-";"-";"-";"-";"-";"-"
"18 List 2024 11:19:41";"Transakcja Sprzedaży";"O2-DB-9CEG4M";"T2-DB-5NRBC9";"-";"USD/JPY";"30 000 Jednost.";"154,838";"-";"-";"-";"-";"4,127749";"123 832,47";"0,00";"-";"-";"-";"-";"-";"-";"-";"-";"-";"-";"-";"-";"-";"-";"-";"-";"-";"-";"-";"-";"-";"-";"-";"-";"-"
"18 List 2024 10:24:27";"Stop Loss";"O2-DB-9CE9EB";"T2-DB-5NR7ZN";"-";"USD/JPY";"30 000 Jednost.";"154,600";"-";"-";"-";"-";"0,026395";"123 660,81";"208,26";"14 684,43";"-";"-";"-";"-";"-";"-";"-";"-";"-";"-";"-";"-";"-";"-";"-";"-";"-";"-";"-";"-";"-";"-";"-";"-"
"18 List 2024 10:24:12";"Zmodyfikowano Stop Loss";"O2-DB-9CE9EB";"-";"O2-DB-9CECQ5";"USD/JPY";"30 000 Jednost.";"154,863";"-";"154,600";"-";"-";"-";"-";"-";"-";"-";"-";"-";"-";"-";"-";"-";"-";"-";"-";"-";"-";"-";"-";"-";"-";"-";"-";"-";"-";"-";"-";"-";"-"
"18 List 2024 10:23:27";"Zmodyfikowano Transakcję Sprzedaży";"O2-DB-9CE9EB";"T2-DB-5NR67T";"-";"USD/JPY";"30 000 Jednost.";"154,863";"-";"154,640";"-";"-";"-";"-";"0,00";"-";"-";"-";"-";"-";"-";"-";"-";"-";"-";"-";"-";"-";"-";"-";"-";"-";"-";"-";"-";"-";"-";"-";"-";"-"
"18 List 2024 09:50:42";"Transakcja Sprzedaży";"O2-DB-9CE9EB";"T2-DB-5NR67T";"-";"USD/JPY";"30 000 Jednost.";"154,863";"-";"-";"-";"-";"4,130234";"123 907,02";"0,00";"-";"-";"-";"-";"-";"-";"-";"-";"-";"-";"-";"-";"-";"-";"-";"-";"-";"-";"-";"-";"-";"-";"-";"-";"-"
"18 List 2024 08:50:07";" Zamknięcie Transakcji";"O2-DB-9CE542";"T2-DB-5NR32Q";"O2-DB-9CD0JQ";"USD/JPY";"26 500 Jednost.";"154,560";"-";"-";"-";"-";"0,026408";"109 266,92";"187,55";"14 476,17";"-";"-";"-";"-";"-";"-";"-";"-";"-";"-";"-";"-";"-";"-";"-";"-";"-";"-";"-";"-";"-";"-";"-";"-"
"15 List 2024 23:02:11";"Koszty Utrzymania Pozycji";"1388647435";"-";"-";"Rachunek";"-";"-";"-";"-";"-";"-";"-";"-";"-6,92";"14 288,62";"-";"-";"-";"-";"-";"-6,92";"-";"-";"-";"-";"-";"-";"-";"-";"-";"-";"-";"-";"-";"-";"-";"-";"-";"-"
"15 List 2024 23:02:11";"Koszty Utrzymania Pozycji";"O2-D9-9BJZX7";"-";"-";"USD/JPY";"-";"-";"-";"-";"-";"-";"-";"-";"-";"-";"-";"-";"30 000,00";"5,55226%";"-18,79";"0,00";"-";"-";"-";"-";"-";"-";"-";"-";"-";"-";"-";"-";"-";"-";"-";"-";"-";"-"
"15 List 2024 23:02:11";"Koszty Utrzymania Pozycji";"O2-D9-9BB04B";"-";"-";"USD/JPY";"-";"-";"-";"-";"-";"-";"-";"-";"-";"-";"-";"-";"34 000,00";"5,55226%";"-21,30";"0,00";"-";"-";"-";"-";"-";"-";"-";"-";"-";"-";"-";"-";"-";"-";"-";"-";"-";"-"
"15 List 2024 23:02:11";"Koszty Utrzymania Pozycji";"O2-DB-9C9X8L";"-";"-";"USD/JPY";"-";"-";"-";"-";"-";"-";"-";"-";"-";"-";"-";"-";"20 000,00";"3,51713%";"7,86";"0,00";"-";"-";"-";"-";"-";"-";"-";"-";"-";"-";"-";"-";"-";"-";"-";"-";"-";"-"
"15 List 2024 23:02:11";"Koszty Utrzymania Pozycji";"O2-DB-9CD0JQ";"-";"-";"USD/JPY";"-";"-";"-";"-";"-";"-";"-";"-";"-";"-";"-";"-";"26 500,00";"3,51713%";"10,41";"0,00";"-";"-";"-";"-";"-";"-";"-";"-";"-";"-";"-";"-";"-";"-";"-";"-";"-";"-"
"15 List 2024 23:02:11";"Koszty Utrzymania Pozycji";"O2-DB-9CCHJJ";"-";"-";"USD/JPY";"-";"-";"-";"-";"-";"-";"-";"-";"-";"-";"-";"-";"6 000,00";"3,51713%";"2,36";"0,00";"-";"-";"-";"-";"-";"-";"-";"-";"-";"-";"-";"-";"-";"-";"-";"-";"-";"-"
"15 List 2024 23:02:11";"Koszty Utrzymania Pozycji";"O2-D9-9BS5RZ";"-";"-";"USD/JPY";"-";"-";"-";"-";"-";"-";"-";"-";"-";"-";"-";"-";"22 000,00";"5,55226%";"-13,78";"0,00";"-";"-";"-";"-";"-";"-";"-";"-";"-";"-";"-";"-";"-";"-";"-";"-";"-";"-"
"15 List 2024 23:02:11";"Koszty Utrzymania Pozycji";"O2-DB-9C9XVJ";"-";"-";"USD/JPY";"-";"-";"-";"-";"-";"-";"-";"-";"-";"-";"-";"-";"30 000,00";"3,51713%";"11,79";"0,00";"-";"-";"-";"-";"-";"-";"-";"-";"-";"-";"-";"-";"-";"-";"-";"-";"-";"-"
"15 List 2024 23:02:11";"Koszty Utrzymania Pozycji";"O2-DB-9CCHQ3";"-";"-";"USD/JPY";"-";"-";"-";"-";"-";"-";"-";"-";"-";"-";"-";"-";"37 000,00";"3,51713%";"14,53";"0,00";"-";"-";"-";"-";"-";"-";"-";"-";"-";"-";"-";"-";"-";"-";"-";"-";"-";"-"
"15 List 2024 19:56:25";"Stop Loss";"O2-DB-9CD4WX";"T2-DB-5NQEML";"-";"USD/JPY";"30 000 Jednost.";"153,955";"-";"-";"-";"-";"0,026442";"123 338,28";"27,76";"14 295,54";"-";"-";"-";"-";"-";"-";"-";"-";"-";"-";"-";"-";"-";"-";"-";"-";"-";"-";"-";"-";"-";"-";"-";"-"
"15 List 2024 19:51:16";"Zmodyfikowano Transakcję Sprzedaży";"O2-DB-9CD4WX";"T2-DB-5NQE4S";"-";"USD/JPY";"30 000 Jednost.";"153,990";"-";"153,950";"-";"-";"-";"-";"0,00";"-";"-";"-";"-";"-";"-";"-";"-";"-";"-";"-";"-";"-";"-";"-";"-";"-";"-";"-";"-";"-";"-";"-";"-";"-"
"15 List 2024 19:49:08";"Transakcja Sprzedaży";"O2-DB-9CD4WX";"T2-DB-5NQE4S";"-";"USD/JPY";"30 000 Jednost.";"153,990";"-";"-";"-";"-";"4,112638";"123 379,14";"0,00";"-";"-";"-";"-";"-";"-";"-";"-";"-";"-";"-";"-";"-";"-";"-";"-";"-";"-";"-";"-";"-";"-";"-";"-";"-"
"15 List 2024 18:47:13";" Transakcja Kupna";"O2-DB-9CD0JQ";"T2-DB-5NQ9ER";"-";"USD/JPY";"26 500 Jednost.";"154,292";"-";"-";"-";"-";"4,110174";"108 919,61";"0,00";"-";"-";"-";"-";"-";"-";"-";"-";"-";"-";"-";"-";"-";"-";"-";"-";"-";"-";"-";"-";"-";"-";"-";"-";"-"
"15 List 2024 18:43:52";"Stop Loss";"O2-DB-9C4T5Y";"T2-DB-5NQ97J";"-";"USD/JPY";"22 000 Jednost.";"154,300";"-";"-";"-";"-";"0,026367";"90 393,84";"5,22";"14 267,78";"-";"-";"-";"-";"-";"-";"-";"-";"-";"-";"-";"-";"-";"-";"-";"-";"-";"-";"-";"-";"-";"-";"-";"-"
"15 List 2024 18:42:40";"Zmodyfikowano Stop Loss";"O2-DB-9C4T5Y";"-";"O2-DB-9CCZ9E";"USD/JPY";"22 000 Jednost.";"154,309";"-";"154,300";"-";"-";"-";"-";"-";"-";"-";"-";"-";"-";"-";"-";"-";"-";"-";"-";"-";"-";"-";"-";"-";"-";"-";"-";"-";"-";"-";"-";"-";"-"
"15 List 2024 18:41:58";"Zmodyfikowano Stop Loss";"O2-DB-9C4T5Y";"-";"O2-DB-9CCZ9E";"USD/JPY";"22 000 Jednost.";"154,309";"-";"154,350";"-";"-";"-";"-";"-";"-";"-";"-";"-";"-";"-";"-";"-";"-";"-";"-";"-";"-";"-";"-";"-";"-";"-";"-";"-";"-";"-";"-";"-";"-"
"15 List 2024 18:39:52";"Zmodyfikowano Stop Loss";"O2-DB-9C4T5Y";"-";"O2-DB-9CCZ9E";"USD/JPY";"22 000 Jednost.";"154,309";"-";"154,400";"-";"-";"-";"-";"-";"-";"-";"-";"-";"-";"-";"-";"-";"-";"-";"-";"-";"-";"-";"-";"-";"-";"-";"-";"-";"-";"-";"-";"-";"-"
"15 List 2024 18:35:15";"Zmodyfikowano Stop Loss";"O2-DB-9C4T5Y";"-";"O2-DB-9CCZ9E";"USD/JPY";"22 000 Jednost.";"154,309";"-";"154,500";"-";"-";"-";"-";"-";"-";"-";"-";"-";"-";"-";"-";"-";"-";"-";"-";"-";"-";"-";"-";"-";"-";"-";"-";"-";"-";"-";"-";"-";"-"
"15 List 2024 18:31:44";"Zmodyfikowano Transakcję Sprzedaży";"O2-DB-9C4T5Y";"T2-DB-5NJFEE";"-";"USD/JPY";"22 000 Jednost.";"154,309";"-";"154,550";"-";"-";"-";"-";"0,00";"-";"-";"-";"-";"-";"-";"-";"-";"-";"-";"-";"-";"-";"-";"-";"-";"-";"-";"-";"-";"-";"-";"-";"-";"-"
"15 List 2024 17:52:42";" Zmodyfikowano Transakcję Kupna";"O2-DB-9CCHQ3";"T2-DB-5NPW6B";"-";"USD/JPY";"37 000 Jednost.";"155,320";"-";"-";"-";"-";"-";"-";"0,00";"-";"-";"-";"-";"-";"-";"-";"-";"-";"-";"-";"-";"-";"-";"-";"-";"-";"-";"-";"-";"-";"-";"-";"-";"-"
"15 List 2024 17:52:33";" Zmodyfikowano Transakcję Kupna";"O2-DB-9CCHJJ";"T2-DB-5NPW1X";"-";"USD/JPY";"6 000 Jednost.";"155,305";"-";"-";"-";"-";"-";"-";"0,00";"-";"-";"-";"-";"-";"-";"-";"-";"-";"-";"-";"-";"-";"-";"-";"-";"-";"-";"-";"-";"-";"-";"-";"-";"-"
"15 List 2024 17:52:05";" Zamknięcie Transakcji";"O2-DB-9CCW3S";"T2-DB-5NQ5P9";"O2-D9-9BH1F6";"USD/JPY";"6 000 Jednost.";"154,535";"-";"-";"-";"-";"0,026362";"24 689,65";"167,19";"14 262,56";"-";"-";"-";"-";"-";"-";"-";"-";"-";"-";"-";"-";"-";"-";"-";"-";"-";"-";"-";"-";"-";"-";"-";"-"
"15 List 2024 17:51:50";" Zamknięcie Transakcji";"O2-DB-9CCW2Z";"T2-DB-5NQ5NM";"O2-D9-9BKRVE";"USD/JPY";"26 000 Jednost.";"154,547";"-";"-";"-";"-";"0,026359";"106 987,99";"1 025,26";"14 095,37";"-";"-";"-";"-";"-";"-";"-";"-";"-";"-";"-";"-";"-";"-";"-";"-";"-";"-";"-";"-";"-";"-";"-";"-"
"15 List 2024 17:48:56";"Stop Loss";"O2-DB-9CCVHB";"T2-DB-5NQ5H9";"-";"USD/JPY";"30 000 Jednost.";"154,620";"-";"-";"-";"-";"0,02635";"123 437,76";"21,34";"13 070,11";"-";"-";"-";"-";"-";"-";"-";"-";"-";"-";"-";"-";"-";"-";"-";"-";"-";"-";"-";"-";"-";"-";"-";"-"
"15 List 2024 17:48:40";"Zmodyfikowano Transakcję Sprzedaży";"O2-DB-9CCVHB";"T2-DB-5NQ587";"-";"USD/JPY";"30 000 Jednost.";"154,647";"-";"154,620";"-";"-";"-";"-";"0,00";"-";"-";"-";"-";"-";"-";"-";"-";"-";"-";"-";"-";"-";"-";"-";"-";"-";"-";"-";"-";"-";"-";"-";"-";"-"
"15 List 2024 17:46:00";"Transakcja Sprzedaży";"O2-DB-9CCVHB";"T2-DB-5NQ587";"-";"USD/JPY";"30 000 Jednost.";"154,647";"-";"-";"-";"-";"4,116606";"123 498,18";"0,00";"-";"-";"-";"-";"-";"-";"-";"-";"-";"-";"-";"-";"-";"-";"-";"-";"-";"-";"-";"-";"-";"-";"-";"-";"-"
"15 List 2024 17:43:38";" Zamknięcie Transakcji";"O2-DB-9CCV8W";"T2-DB-5NQ52L";"O2-D9-9BJQLQ";"USD/JPY";"20 000 Jednost.";"154,592";"-";"-";"-";"-";"0,026359";"82 315,10";"855,09";"13 048,77";"-";"-";"-";"-";"-";"-";"-";"-";"-";"-";"-";"-";"-";"-";"-";"-";"-";"-";"-";"-";"-";"-";"-";"-"
"15 List 2024 17:36:26";"Stop Loss";"O2-DB-9CCT49";"T2-DB-5NQ4DE";"-";"USD/JPY";"30 000 Jednost.";"154,670";"-";"-";"-";"-";"0,02634";"123 440,49";"118,53";"12 193,68";"-";"-";"-";"-";"-";"-";"-";"-";"-";"-";"-";"-";"-";"-";"-";"-";"-";"-";"-";"-";"-";"-";"-";"-"
"15 List 2024 17:36:07";"Zmodyfikowano Stop Loss";"O2-DB-9CCT49";"-";"O2-DB-9CCTD2";"USD/JPY";"30 000 Jednost.";"154,820";"-";"154,670";"-";"-";"-";"-";"-";"-";"-";"-";"-";"-";"-";"-";"-";"-";"-";"-";"-";"-";"-";"-";"-";"-";"-";"-";"-";"-";"-";"-";"-";"-"
"15 List 2024 17:35:44";"Zmodyfikowano Stop Loss";"O2-DB-9CCT49";"-";"O2-DB-9CCTD2";"USD/JPY";"30 000 Jednost.";"154,820";"-";"154,700";"-";"-";"-";"-";"-";"-";"-";"-";"-";"-";"-";"-";"-";"-";"-";"-";"-";"-";"-";"-";"-";"-";"-";"-";"-";"-";"-";"-";"-";"-"
"15 List 2024 17:35:24";"Zmodyfikowano Transakcję Sprzedaży";"O2-DB-9CCT49";"T2-DB-5NQ43S";"-";"USD/JPY";"30 000 Jednost.";"154,820";"-";"154,730";"-";"-";"-";"-";"0,00";"-";"-";"-";"-";"-";"-";"-";"-";"-";"-";"-";"-";"-";"-";"-";"-";"-";"-";"-";"-";"-";"-";"-";"-";"-"
"15 List 2024 17:33:10";"Transakcja Sprzedaży";"O2-DB-9CCT49";"T2-DB-5NQ43S";"-";"USD/JPY";"30 000 Jednost.";"154,820";"-";"-";"-";"-";"4,115174";"123 455,22";"0,00";"-";"-";"-";"-";"-";"-";"-";"-";"-";"-";"-";"-";"-";"-";"-";"-";"-";"-";"-";"-";"-";"-";"-";"-";"-"
"15 List 2024 17:11:16";"Stop Loss";"O2-DB-9CCQNJ";"T2-DB-5NQ2JR";"-";"USD/JPY";"30 000 Jednost.";"154,705";"-";"-";"-";"-";"0,026383";"123 648,78";"12,66";"12 075,15";"-";"-";"-";"-";"-";"-";"-";"-";"-";"-";"-";"-";"-";"-";"-";"-";"-";"-";"-";"-";"-";"-";"-";"-"
"15 List 2024 17:11:11";"Zmodyfikowano Transakcję Sprzedaży";"O2-DB-9CCQNJ";"T2-DB-5NQ24E";"-";"USD/JPY";"30 000 Jednost.";"154,721";"-";"154,700";"-";"-";"-";"-";"0,00";"-";"-";"-";"-";"-";"-";"-";"-";"-";"-";"-";"-";"-";"-";"-";"-";"-";"-";"-";"-";"-";"-";"-";"-";"-"
"15 List 2024 17:06:41";"Transakcja Sprzedaży";"O2-DB-9CCQNJ";"T2-DB-5NQ24E";"-";"USD/JPY";"30 000 Jednost.";"154,721";"-";"-";"-";"-";"4,121175";"123 635,25";"0,00";"-";"-";"-";"-";"-";"-";"-";"-";"-";"-";"-";"-";"-";"-";"-";"-";"-";"-";"-";"-";"-";"-";"-";"-";"-"
"15 List 2024 16:13:16";" Zmodyfikowano Transakcję Kupna";"O2-DB-9CCHJJ";"T2-DB-5NPW1X";"-";"USD/JPY";"6 000 Jednost.";"155,305";"-";"-";"155,650";"-";"-";"-";"0,00";"-";"-";"-";"-";"-";"-";"-";"-";"-";"-";"-";"-";"-";"-";"-";"-";"-";"-";"-";"-";"-";"-";"-";"-";"-"
"15 List 2024 16:12:56";" Zmodyfikowano Transakcję Kupna";"O2-DB-9CCHQ3";"T2-DB-5NPW6B";"-";"USD/JPY";"37 000 Jednost.";"155,320";"-";"-";"155,650";"-";"-";"-";"0,00";"-";"-";"-";"-";"-";"-";"-";"-";"-";"-";"-";"-";"-";"-";"-";"-";"-";"-";"-";"-";"-";"-";"-";"-";"-"
"15 List 2024 16:12:02";" Transakcja Kupna";"O2-DB-9CCHQ3";"T2-DB-5NPW6B";"-";"USD/JPY";"37 000 Jednost.";"155,320";"-";"-";"-";"-";"4,121356";"152 490,17";"0,00";"-";"-";"-";"-";"-";"-";"-";"-";"-";"-";"-";"-";"-";"-";"-";"-";"-";"-";"-";"-";"-";"-";"-";"-";"-"
"15 List 2024 16:11:01";" Transakcja Kupna";"O2-DB-9CCHJJ";"T2-DB-5NPW1X";"-";"USD/JPY";"6 000 Jednost.";"155,305";"-";"-";"-";"-";"4,120675";"24 724,05";"0,00";"-";"-";"-";"-";"-";"-";"-";"-";"-";"-";"-";"-";"-";"-";"-";"-";"-";"-";"-";"-";"-";"-";"-";"-";"-"
"15 List 2024 15:41:21";"Stop Loss";"O2-DB-9CBLES";"T2-DB-5NPR2K";"-";"USD/JPY";"8 000 Jednost.";"155,630";"-";"-";"-";"-";"0,0264858";"32 980,14";"-18,86";"12 062,49";"-";"-";"-";"-";"-";"-";"-";"-";"-";"-";"-";"-";"-";"-";"-";"-";"-";"-";"-";"-";"-";"-";"-";"-"
"15 List 2024 15:40:43";"Zmodyfikowano Stop Loss";"O2-DB-9CBLES";"-";"O2-DB-9CCCPN";"USD/JPY";"8 000 Jednost.";"155,719";"-";"155,630";"-";"-";"-";"-";"-";"-";"-";"-";"-";"-";"-";"-";"-";"-";"-";"-";"-";"-";"-";"-";"-";"-";"-";"-";"-";"-";"-";"-";"-";"-"
"15 List 2024 15:40:22";" Zmodyfikowano Transakcję Kupna";"O2-DB-9CBLES";"T2-DB-5NP5LG";"-";"USD/JPY";"8 000 Jednost.";"155,719";"-";"155,620";"-";"-";"-";"-";"0,00";"-";"-";"-";"-";"-";"-";"-";"-";"-";"-";"-";"-";"-";"-";"-";"-";"-";"-";"-";"-";"-";"-";"-";"-";"-"
"15 List 2024 15:39:20";"Take Profit";"O2-DB-9CBQ25";"T2-DB-5NPQRM";"-";"USD/JPY";"35 000 Jednost.";"155,620";"-";"-";"-";"-";"0,026244";"144 388,44";"21,13";"12 081,35";"-";"-";"-";"-";"-";"-";"-";"-";"-";"-";"-";"-";"-";"-";"-";"-";"-";"-";"-";"-";"-";"-";"-";"-"
"15 List 2024 15:38:36";" Zmodyfikowano Transakcję Kupna";"O2-DB-9CBQ25";"T2-DB-5NP8C4";"-";"USD/JPY";"35 000 Jednost.";"155,597";"-";"-";"155,620";"-";"-";"-";"0,00";"-";"-";"-";"-";"-";"-";"-";"-";"-";"-";"-";"-";"-";"-";"-";"-";"-";"-";"-";"-";"-";"-";"-";"-";"-"
"15 List 2024 10:11:28";" Transakcja Kupna";"O2-DB-9CBQ25";"T2-DB-5NP8C4";"-";"USD/JPY";"35 000 Jednost.";"155,597";"-";"-";"-";"-";"4,103661";"143 628,13";"0,00";"-";"-";"-";"-";"-";"-";"-";"-";"-";"-";"-";"-";"-";"-";"-";"-";"-";"-";"-";"-";"-";"-";"-";"-";"-"
"15 List 2024 10:04:26";"Stop Loss";"O2-DB-9CBPDZ";"T2-DB-5NP816";"-";"USD/JPY";"35 000 Jednost.";"155,610";"-";"-";"-";"-";"0,026135";"143 777,16";"10,06";"12 060,22";"-";"-";"-";"-";"-";"-";"-";"-";"-";"-";"-";"-";"-";"-";"-";"-";"-";"-";"-";"-";"-";"-";"-";"-"
"15 List 2024 10:04:23";" Zmodyfikowano Transakcję Kupna";"O2-DB-9CBPDZ";"T2-DB-5NP7XZ";"-";"USD/JPY";"35 000 Jednost.";"155,599";"-";"155,610";"-";"-";"-";"-";"0,00";"-";"-";"-";"-";"-";"-";"-";"-";"-";"-";"-";"-";"-";"-";"-";"-";"-";"-";"-";"-";"-";"-";"-";"-";"-"
"15 List 2024 10:02:14";" Transakcja Kupna";"O2-DB-9CBPDZ";"T2-DB-5NP7XZ";"-";"USD/JPY";"35 000 Jednost.";"155,599";"-";"-";"-";"-";"4,109422";"143 829,77";"0,00";"-";"-";"-";"-";"-";"-";"-";"-";"-";"-";"-";"-";"-";"-";"-";"-";"-";"-";"-";"-";"-";"-";"-";"-";"-"
"15 List 2024 10:01:59";"Odrzucono Zlecenie: brak wystarczających środków";"O2-DB-9CBPDB";"-";"-";"USD/JPY";"36 000 Jednost.";"-";"-";"-";"-";"-";"-";"-";"-";"-";"-";"-";"-";"-";"-";"-";"-";"-";"-";"-";"-";"-";"-";"-";"-";"-";"-";"-";"-";"-";"-";"-";"-";"-"
"15 List 2024 09:39:24";" Zamknięcie Transakcji";"O2-DB-9CBMQH";"T2-DB-5NP6MQ";"O2-DB-9C7SP3";"USD/JPY";"36 000 Jednost.";"155,478";"-";"-";"-";"-";"0,0262";"148 116,31";"9,43";"12 050,16";"-";"-";"-";"-";"-";"-";"-";"-";"-";"-";"-";"-";"-";"-";"-";"-";"-";"-";"-";"-";"-";"-";"-";"-"
"15 List 2024 09:26:02";" Transakcja Kupna";"O2-DB-9CBLES";"T2-DB-5NP5LG";"-";"USD/JPY";"8 000 Jednost.";"155,719";"-";"-";"-";"-";"4,119081";"32 952,64";"0,00";"-";"-";"-";"-";"-";"-";"-";"-";"-";"-";"-";"-";"-";"-";"-";"-";"-";"-";"-";"-";"-";"-";"-";"-";"-"
"15 List 2024 09:18:05";" Zamknięcie Transakcji";"O2-DB-9CBKQS";"T2-DB-5NP51J";"O2-DB-9CBKG6";"USD/JPY";"8 000 Jednost.";"155,743";"-";"-";"-";"-";"0,026164";"32 926,44";"3,98";"12 040,73";"-";"-";"-";"-";"-";"-";"-";"-";"-";"-";"-";"-";"-";"-";"-";"-";"-";"-";"-";"-";"-";"-";"-";"-"
"15 List 2024 09:15:53";" Transakcja Kupna";"O2-DB-9CBKG6";"T2-DB-5NP4SW";"-";"USD/JPY";"8 000 Jednost.";"155,724";"-";"-";"-";"-";"4,115935";"32 927,48";"0,00";"-";"-";"-";"-";"-";"-";"-";"-";"-";"-";"-";"-";"-";"-";"-";"-";"-";"-";"-";"-";"-";"-";"-";"-";"-"
"14 List 2024 23:02:11";"Koszty Utrzymania Pozycji";"1388296330";"-";"-";"Rachunek";"-";"-";"-";"-";"-";"-";"-";"-";"-13,51";"12 036,75";"-";"-";"-";"-";"-";"-13,51";"-";"-";"-";"-";"-";"-";"-";"-";"-";"-";"-";"-";"-";"-";"-";"-";"-";"-"
"14 List 2024 23:02:11";"Koszty Utrzymania Pozycji";"O2-D9-9BKRVE";"-";"-";"USD/JPY";"-";"-";"-";"-";"-";"-";"-";"-";"-";"-";"-";"-";"26 000,00";"3,54652%";"10,32";"0,00";"-";"-";"-";"-";"-";"-";"-";"-";"-";"-";"-";"-";"-";"-";"-";"-";"-";"-"
"14 List 2024 23:02:11";"Koszty Utrzymania Pozycji";"O2-D9-9BJZX7";"-";"-";"USD/JPY";"-";"-";"-";"-";"-";"-";"-";"-";"-";"-";"-";"-";"30 000,00";"5,59388%";"-18,97";"0,00";"-";"-";"-";"-";"-";"-";"-";"-";"-";"-";"-";"-";"-";"-";"-";"-";"-";"-"
"14 List 2024 23:02:11";"Koszty Utrzymania Pozycji";"O2-D9-9BB04B";"-";"-";"USD/JPY";"-";"-";"-";"-";"-";"-";"-";"-";"-";"-";"-";"-";"34 000,00";"5,59388%";"-21,50";"0,00";"-";"-";"-";"-";"-";"-";"-";"-";"-";"-";"-";"-";"-";"-";"-";"-";"-";"-"
"14 List 2024 23:02:11";"Koszty Utrzymania Pozycji";"O2-DB-9C9X8L";"-";"-";"USD/JPY";"-";"-";"-";"-";"-";"-";"-";"-";"-";"-";"-";"-";"20 000,00";"3,54652%";"7,94";"0,00";"-";"-";"-";"-";"-";"-";"-";"-";"-";"-";"-";"-";"-";"-";"-";"-";"-";"-"
"14 List 2024 23:02:11";"Koszty Utrzymania Pozycji";"O2-D9-9BS5RZ";"-";"-";"USD/JPY";"-";"-";"-";"-";"-";"-";"-";"-";"-";"-";"-";"-";"22 000,00";"5,59388%";"-13,91";"0,00";"-";"-";"-";"-";"-";"-";"-";"-";"-";"-";"-";"-";"-";"-";"-";"-";"-";"-"
"14 List 2024 23:02:11";"Koszty Utrzymania Pozycji";"O2-DB-9C9XVJ";"-";"-";"USD/JPY";"-";"-";"-";"-";"-";"-";"-";"-";"-";"-";"-";"-";"30 000,00";"3,54652%";"11,91";"0,00";"-";"-";"-";"-";"-";"-";"-";"-";"-";"-";"-";"-";"-";"-";"-";"-";"-";"-"
"14 List 2024 23:02:11";"Koszty Utrzymania Pozycji";"O2-D9-9BJQLQ";"-";"-";"USD/JPY";"-";"-";"-";"-";"-";"-";"-";"-";"-";"-";"-";"-";"20 000,00";"3,54652%";"7,94";"0,00";"-";"-";"-";"-";"-";"-";"-";"-";"-";"-";"-";"-";"-";"-";"-";"-";"-";"-"
"14 List 2024 23:02:11";"Koszty Utrzymania Pozycji";"O2-D9-9BH1F6";"-";"-";"USD/JPY";"-";"-";"-";"-";"-";"-";"-";"-";"-";"-";"-";"-";"6 000,00";"3,54652%";"2,38";"0,00";"-";"-";"-";"-";"-";"-";"-";"-";"-";"-";"-";"-";"-";"-";"-";"-";"-";"-"
"14 List 2024 23:02:11";"Koszty Utrzymania Pozycji";"O2-DB-9C7SP3";"-";"-";"USD/JPY";"-";"-";"-";"-";"-";"-";"-";"-";"-";"-";"-";"-";"36 000,00";"3,54652%";"14,29";"0,00";"-";"-";"-";"-";"-";"-";"-";"-";"-";"-";"-";"-";"-";"-";"-";"-";"-";"-"
"14 List 2024 23:02:11";"Koszty Utrzymania Pozycji";"O2-DB-9C4T5Y";"-";"-";"USD/JPY";"-";"-";"-";"-";"-";"-";"-";"-";"-";"-";"-";"-";"22 000,00";"5,59388%";"-13,91";"0,00";"-";"-";"-";"-";"-";"-";"-";"-";"-";"-";"-";"-";"-";"-";"-";"-";"-";"-"
"14 List 2024 22:38:56";" Transakcja Kupna";"O2-DB-9C9XVJ";"T2-DB-5NNQ09";"-";"USD/JPY";"30 000 Jednost.";"156,291";"-";"-";"-";"-";"4,129181";"123 875,43";"0,00";"-";"-";"-";"-";"-";"-";"-";"-";"-";"-";"-";"-";"-";"-";"-";"-";"-";"-";"-";"-";"-";"-";"-";"-";"-"
"14 List 2024 22:17:51";" Transakcja Kupna";"O2-DB-9C9X8L";"T2-DB-5NNPPT";"-";"USD/JPY";"20 000 Jednost.";"156,347";"-";"-";"-";"-";"4,129903";"82 598,06";"0,00";"-";"-";"-";"-";"-";"-";"-";"-";"-";"-";"-";"-";"-";"-";"-";"-";"-";"-";"-";"-";"-";"-";"-";"-";"-"
"14 List 2024 21:17:54";"Stop Loss";"O2-DB-9C9RKC";"T2-DB-5NNLEM";"-";"USD/JPY";"20 000 Jednost.";"156,330";"-";"-";"-";"-";"0,02616";"82 596,86";"6,80";"12 050,26";"-";"-";"-";"-";"-";"-";"-";"-";"-";"-";"-";"-";"-";"-";"-";"-";"-";"-";"-";"-";"-";"-";"-";"-"
"14 List 2024 21:17:41";"Zmodyfikowano Transakcję Sprzedaży";"O2-DB-9C9RKC";"T2-DB-5NNKX0";"-";"USD/JPY";"20 000 Jednost.";"156,343";"-";"156,330";"-";"-";"-";"-";"0,00";"-";"-";"-";"-";"-";"-";"-";"-";"-";"-";"-";"-";"-";"-";"-";"-";"-";"-";"-";"-";"-";"-";"-";"-";"-"
"14 List 2024 21:10:50";"Transakcja Sprzedaży";"O2-DB-9C9RKC";"T2-DB-5NNKX0";"-";"USD/JPY";"20 000 Jednost.";"156,343";"-";"-";"-";"-";"4,135083";"82 701,66";"0,00";"-";"-";"-";"-";"-";"-";"-";"-";"-";"-";"-";"-";"-";"-";"-";"-";"-";"-";"-";"-";"-";"-";"-";"-";"-"
"14 List 2024 21:08:17";"Stop Loss";"O2-DB-9C8SYN";"T2-DB-5NNKMG";"-";"USD/JPY";"37 000 Jednost.";"156,300";"-";"-";"-";"-";"0,026179";"152 931,73";"289,62";"12 043,46";"-";"-";"-";"-";"-";"-";"-";"-";"-";"-";"-";"-";"-";"-";"-";"-";"-";"-";"-";"-";"-";"-";"-";"-"
"14 List 2024 21:08:17";"Stop Loss";"O2-DB-9C8SXQ";"T2-DB-5NNKMF";"-";"USD/JPY";"20 000 Jednost.";"156,300";"-";"-";"-";"-";"0,026179";"82 665,80";"149,74";"11 753,84";"-";"-";"-";"-";"-";"-";"-";"-";"-";"-";"-";"-";"-";"-";"-";"-";"-";"-";"-";"-";"-";"-";"-";"-"
"14 List 2024 21:07:57";"Zmodyfikowano Stop Loss";"O2-DB-9C8SYN";"-";"O2-DB-9C9QC4";"USD/JPY";"37 000 Jednost.";"156,001";"-";"156,300";"-";"-";"-";"-";"-";"-";"-";"-";"-";"-";"-";"-";"-";"-";"-";"-";"-";"-";"-";"-";"-";"-";"-";"-";"-";"-";"-";"-";"-";"-"
"14 List 2024 21:07:40";"Zmodyfikowano Stop Loss";"O2-DB-9C8SXQ";"-";"O2-DB-9C9Q9P";"USD/JPY";"20 000 Jednost.";"156,014";"-";"156,300";"-";"-";"-";"-";"-";"-";"-";"-";"-";"-";"-";"-";"-";"-";"-";"-";"-";"-";"-";"-";"-";"-";"-";"-";"-";"-";"-";"-";"-";"-"
"14 List 2024 21:05:43";"Zmodyfikowano Stop Loss";"O2-DB-9C8SYN";"-";"O2-DB-9C9QC4";"USD/JPY";"37 000 Jednost.";"156,001";"-";"156,200";"-";"-";"-";"-";"-";"-";"-";"-";"-";"-";"-";"-";"-";"-";"-";"-";"-";"-";"-";"-";"-";"-";"-";"-";"-";"-";"-";"-";"-";"-"
"14 List 2024 21:05:30";"Zmodyfikowano Stop Loss";"O2-DB-9C8SXQ";"-";"O2-DB-9C9Q9P";"USD/JPY";"20 000 Jednost.";"156,014";"-";"156,200";"-";"-";"-";"-";"-";"-";"-";"-";"-";"-";"-";"-";"-";"-";"-";"-";"-";"-";"-";"-";"-";"-";"-";"-";"-";"-";"-";"-";"-";"-"
"14 List 2024 21:04:51";"Zmodyfikowano Stop Loss";"O2-DB-9C8SXQ";"-";"O2-DB-9C9Q9P";"USD/JPY";"20 000 Jednost.";"156,014";"-";"156,150";"-";"-";"-";"-";"-";"-";"-";"-";"-";"-";"-";"-";"-";"-";"-";"-";"-";"-";"-";"-";"-";"-";"-";"-";"-";"-";"-";"-";"-";"-"
"14 List 2024 21:04:39";"Zmodyfikowano Stop Loss";"O2-DB-9C8SYN";"-";"O2-DB-9C9QC4";"USD/JPY";"37 000 Jednost.";"156,001";"-";"156,150";"-";"-";"-";"-";"-";"-";"-";"-";"-";"-";"-";"-";"-";"-";"-";"-";"-";"-";"-";"-";"-";"-";"-";"-";"-";"-";"-";"-";"-";"-"
"14 List 2024 21:04:08";"Zmodyfikowano Stop Loss";"O2-DB-9C8SYN";"-";"O2-DB-9C9QC4";"USD/JPY";"37 000 Jednost.";"156,001";"-";"156,100";"-";"-";"-";"-";"-";"-";"-";"-";"-";"-";"-";"-";"-";"-";"-";"-";"-";"-";"-";"-";"-";"-";"-";"-";"-";"-";"-";"-";"-";"-"
"14 List 2024 21:03:55";"Zmodyfikowano Stop Loss";"O2-DB-9C8SXQ";"-";"O2-DB-9C9Q9P";"USD/JPY";"20 000 Jednost.";"156,014";"-";"156,100";"-";"-";"-";"-";"-";"-";"-";"-";"-";"-";"-";"-";"-";"-";"-";"-";"-";"-";"-";"-";"-";"-";"-";"-";"-";"-";"-";"-";"-";"-"
"14 List 2024 21:03:05";" Zmodyfikowano Transakcję Kupna";"O2-DB-9C8SYN";"T2-DB-5NMT43";"-";"USD/JPY";"37 000 Jednost.";"156,001";"-";"156,080";"-";"-";"-";"-";"0,00";"-";"-";"-";"-";"-";"-";"-";"-";"-";"-";"-";"-";"-";"-";"-";"-";"-";"-";"-";"-";"-";"-";"-";"-";"-"
"14 List 2024 21:02:37";" Zmodyfikowano Transakcję Kupna";"O2-DB-9C8SXQ";"T2-DB-5NMT3N";"-";"USD/JPY";"20 000 Jednost.";"156,014";"-";"156,080";"-";"-";"-";"-";"0,00";"-";"-";"-";"-";"-";"-";"-";"-";"-";"-";"-";"-";"-";"-";"-";"-";"-";"-";"-";"-";"-";"-";"-";"-";"-"
"14 List 2024 21:02:12";" Zmodyfikowano Transakcję Kupna";"O2-DB-9C8SYN";"T2-DB-5NMT43";"-";"USD/JPY";"37 000 Jednost.";"156,001";"-";"-";"-";"-";"-";"-";"0,00";"-";"-";"-";"-";"-";"-";"-";"-";"-";"-";"-";"-";"-";"-";"-";"-";"-";"-";"-";"-";"-";"-";"-";"-";"-"
"14 List 2024 17:28:50";" Zmodyfikowano Transakcję Kupna";"O2-DB-9C8SYN";"T2-DB-5NMT43";"-";"USD/JPY";"37 000 Jednost.";"156,001";"-";"-";"156,200";"-";"-";"-";"0,00";"-";"-";"-";"-";"-";"-";"-";"-";"-";"-";"-";"-";"-";"-";"-";"-";"-";"-";"-";"-";"-";"-";"-";"-";"-"
"14 List 2024 17:28:26";"Zmodyfikowano Take Profit";"O2-DB-9C8SXQ";"-";"O2-DB-9C97EP";"USD/JPY";"20 000 Jednost.";"156,014";"-";"-";"156,200";"-";"-";"-";"-";"-";"-";"-";"-";"-";"-";"-";"-";"-";"-";"-";"-";"-";"-";"-";"-";"-";"-";"-";"-";"-";"-";"-";"-";"-"
"14 List 2024 17:27:07";"Stop Loss";"O2-DB-9C96NC";"T2-DB-5NN6ME";"-";"USD/JPY";"37 000 Jednost.";"155,750";"-";"-";"-";"-";"0,026109";"151 964,84";"149,74";"11 604,10";"-";"-";"-";"-";"-";"-";"-";"-";"-";"-";"-";"-";"-";"-";"-";"-";"-";"-";"-";"-";"-";"-";"-";"-"
"14 List 2024 17:26:42";"Zmodyfikowano Stop Loss";"O2-DB-9C96NC";"-";"O2-DB-9C98NV";"USD/JPY";"37 000 Jednost.";"155,905";"-";"155,750";"-";"-";"-";"-";"-";"-";"-";"-";"-";"-";"-";"-";"-";"-";"-";"-";"-";"-";"-";"-";"-";"-";"-";"-";"-";"-";"-";"-";"-";"-"
"14 List 2024 17:22:56";"Zmodyfikowano Take Profit";"O2-DB-9C96NC";"-";"O2-DB-9C9771";"USD/JPY";"37 000 Jednost.";"155,905";"-";"-";"155,600";"-";"-";"-";"-";"-";"-";"-";"-";"-";"-";"-";"-";"-";"-";"-";"-";"-";"-";"-";"-";"-";"-";"-";"-";"-";"-";"-";"-";"-"
"14 List 2024 17:22:56";"Zmodyfikowano Stop Loss";"O2-DB-9C96NC";"-";"O2-DB-9C98NV";"USD/JPY";"37 000 Jednost.";"155,905";"-";"155,780";"-";"-";"-";"-";"-";"-";"-";"-";"-";"-";"-";"-";"-";"-";"-";"-";"-";"-";"-";"-";"-";"-";"-";"-";"-";"-";"-";"-";"-";"-"
"14 List 2024 17:20:19";"Zmodyfikowano Stop Loss";"O2-DB-9C96NC";"-";"O2-DB-9C98NV";"USD/JPY";"37 000 Jednost.";"155,905";"-";"155,800";"-";"-";"-";"-";"-";"-";"-";"-";"-";"-";"-";"-";"-";"-";"-";"-";"-";"-";"-";"-";"-";"-";"-";"-";"-";"-";"-";"-";"-";"-"
"14 List 2024 17:19:24";"Zmodyfikowano Stop Loss";"O2-DB-9C96NC";"-";"O2-DB-9C98NV";"USD/JPY";"37 000 Jednost.";"155,905";"-";"155,830";"-";"-";"-";"-";"-";"-";"-";"-";"-";"-";"-";"-";"-";"-";"-";"-";"-";"-";"-";"-";"-";"-";"-";"-";"-";"-";"-";"-";"-";"-"
"14 List 2024 17:18:23";"Zmodyfikowano Take Profit";"O2-DB-9C96NC";"-";"O2-DB-9C9771";"USD/JPY";"37 000 Jednost.";"155,905";"-";"-";"155,700";"-";"-";"-";"-";"-";"-";"-";"-";"-";"-";"-";"-";"-";"-";"-";"-";"-";"-";"-";"-";"-";"-";"-";"-";"-";"-";"-";"-";"-"
"14 List 2024 17:18:23";"Zmodyfikowano Stop Loss";"O2-DB-9C96NC";"-";"O2-DB-9C98NV";"USD/JPY";"37 000 Jednost.";"155,905";"-";"155,850";"-";"-";"-";"-";"-";"-";"-";"-";"-";"-";"-";"-";"-";"-";"-";"-";"-";"-";"-";"-";"-";"-";"-";"-";"-";"-";"-";"-";"-";"-"
"14 List 2024 17:17:32";"Zmodyfikowano Transakcję Sprzedaży";"O2-DB-9C96NC";"T2-DB-5NN4E5";"-";"USD/JPY";"37 000 Jednost.";"155,905";"-";"155,860";"155,800";"-";"-";"-";"0,00";"-";"-";"-";"-";"-";"-";"-";"-";"-";"-";"-";"-";"-";"-";"-";"-";"-";"-";"-";"-";"-";"-";"-";"-";"-"
"14 List 2024 17:11:33";" Zmodyfikowano Transakcję Kupna";"O2-DB-9C8SYN";"T2-DB-5NMT43";"-";"USD/JPY";"37 000 Jednost.";"156,001";"-";"-";"-";"-";"-";"-";"0,00";"-";"-";"-";"-";"-";"-";"-";"-";"-";"-";"-";"-";"-";"-";"-";"-";"-";"-";"-";"-";"-";"-";"-";"-";"-"
"14 List 2024 17:11:11";" Zmodyfikowano Transakcję Kupna";"O2-DB-9C8SYN";"T2-DB-5NMT43";"-";"USD/JPY";"37 000 Jednost.";"156,001";"-";"-";"156,040";"-";"-";"-";"0,00";"-";"-";"-";"-";"-";"-";"-";"-";"-";"-";"-";"-";"-";"-";"-";"-";"-";"-";"-";"-";"-";"-";"-";"-";"-"
"14 List 2024 17:01:07";" Zmodyfikowano Transakcję Kupna";"O2-DB-9C8SXQ";"T2-DB-5NMT3N";"-";"USD/JPY";"20 000 Jednost.";"156,014";"-";"-";"156,040";"-";"-";"-";"0,00";"-";"-";"-";"-";"-";"-";"-";"-";"-";"-";"-";"-";"-";"-";"-";"-";"-";"-";"-";"-";"-";"-";"-";"-";"-"
"14 List 2024 16:59:26";"Zmodyfikowano Transakcję Sprzedaży";"O2-DB-9C96NC";"T2-DB-5NN4E5";"-";"USD/JPY";"37 000 Jednost.";"155,905";"-";"-";"155,800";"-";"-";"-";"0,00";"-";"-";"-";"-";"-";"-";"-";"-";"-";"-";"-";"-";"-";"-";"-";"-";"-";"-";"-";"-";"-";"-";"-";"-";"-"
"14 List 2024 16:53:02";"Transakcja Sprzedaży";"O2-DB-9C96NC";"T2-DB-5NN4E5";"-";"USD/JPY";"37 000 Jednost.";"155,905";"-";"-";"-";"-";"4,110254";"152 079,39";"0,00";"-";"-";"-";"-";"-";"-";"-";"-";"-";"-";"-";"-";"-";"-";"-";"-";"-";"-";"-";"-";"-";"-";"-";"-";"-"
"14 List 2024 15:45:57";" Zmodyfikowano Transakcję Kupna";"O2-DB-9C8SXQ";"T2-DB-5NMT3N";"-";"USD/JPY";"20 000 Jednost.";"156,014";"-";"-";"-";"-";"-";"-";"0,00";"-";"-";"-";"-";"-";"-";"-";"-";"-";"-";"-";"-";"-";"-";"-";"-";"-";"-";"-";"-";"-";"-";"-";"-";"-"
"14 List 2024 15:45:46";" Zmodyfikowano Transakcję Kupna";"O2-DB-9C8SYN";"T2-DB-5NMT43";"-";"USD/JPY";"37 000 Jednost.";"156,001";"-";"-";"-";"-";"-";"-";"0,00";"-";"-";"-";"-";"-";"-";"-";"-";"-";"-";"-";"-";"-";"-";"-";"-";"-";"-";"-";"-";"-";"-";"-";"-";"-"
"14 List 2024 15:03:03";" Zmodyfikowano Transakcję Kupna";"O2-DB-9C8SYN";"T2-DB-5NMT43";"-";"USD/JPY";"37 000 Jednost.";"156,001";"-";"-";"156,040";"-";"-";"-";"0,00";"-";"-";"-";"-";"-";"-";"-";"-";"-";"-";"-";"-";"-";"-";"-";"-";"-";"-";"-";"-";"-";"-";"-";"-";"-"
"14 List 2024 15:02:48";" Zmodyfikowano Transakcję Kupna";"O2-DB-9C8SXQ";"T2-DB-5NMT3N";"-";"USD/JPY";"20 000 Jednost.";"156,014";"-";"-";"156,040";"-";"-";"-";"0,00";"-";"-";"-";"-";"-";"-";"-";"-";"-";"-";"-";"-";"-";"-";"-";"-";"-";"-";"-";"-";"-";"-";"-";"-";"-"
"14 List 2024 14:51:09";" Transakcja Kupna";"O2-DB-9C8SYN";"T2-DB-5NMT43";"-";"USD/JPY";"37 000 Jednost.";"156,001";"-";"-";"-";"-";"4,136777";"153 060,74";"0,00";"-";"-";"-";"-";"-";"-";"-";"-";"-";"-";"-";"-";"-";"-";"-";"-";"-";"-";"-";"-";"-";"-";"-";"-";"-"
"14 List 2024 14:50:42";" Transakcja Kupna";"O2-DB-9C8SXQ";"T2-DB-5NMT3N";"-";"USD/JPY";"20 000 Jednost.";"156,014";"-";"-";"-";"-";"4,136356";"82 727,12";"0,00";"-";"-";"-";"-";"-";"-";"-";"-";"-";"-";"-";"-";"-";"-";"-";"-";"-";"-";"-";"-";"-";"-";"-";"-";"-"
"14 List 2024 14:39:45";"Stop Loss";"O2-DB-9C8NNX";"T2-DB-5NMS9P";"-";"USD/JPY";"37 000 Jednost.";"156,100";"-";"-";"-";"-";"0,026285";"153 331,36";"143,94";"11 454,36";"-";"-";"-";"-";"-";"-";"-";"-";"-";"-";"-";"-";"-";"-";"-";"-";"-";"-";"-";"-";"-";"-";"-";"-"
"14 List 2024 14:39:07";"Zmodyfikowano Stop Loss";"O2-DB-9C8NNX";"-";"O2-DB-9C8RNV";"USD/JPY";"37 000 Jednost.";"155,952";"-";"156,100";"-";"-";"-";"-";"-";"-";"-";"-";"-";"-";"-";"-";"-";"-";"-";"-";"-";"-";"-";"-";"-";"-";"-";"-";"-";"-";"-";"-";"-";"-"
"14 List 2024 14:38:49";"Stop Loss";"O2-DB-9C8NKG";"T2-DB-5NMS6Q";"-";"USD/JPY";"20 000 Jednost.";"156,100";"-";"-";"-";"-";"0,02628";"82 883,82";"69,38";"11 310,42";"-";"-";"-";"-";"-";"-";"-";"-";"-";"-";"-";"-";"-";"-";"-";"-";"-";"-";"-";"-";"-";"-";"-";"-"
"14 List 2024 14:38:48";"Zmodyfikowano Stop Loss";"O2-DB-9C8NKG";"-";"O2-DB-9C8RRB";"USD/JPY";"20 000 Jednost.";"155,968";"-";"156,100";"-";"-";"-";"-";"-";"-";"-";"-";"-";"-";"-";"-";"-";"-";"-";"-";"-";"-";"-";"-";"-";"-";"-";"-";"-";"-";"-";"-";"-";"-"
"14 List 2024 14:38:13";"Zmodyfikowano Stop Loss";"O2-DB-9C8NNX";"-";"O2-DB-9C8RNV";"USD/JPY";"37 000 Jednost.";"155,952";"-";"156,050";"-";"-";"-";"-";"-";"-";"-";"-";"-";"-";"-";"-";"-";"-";"-";"-";"-";"-";"-";"-";"-";"-";"-";"-";"-";"-";"-";"-";"-";"-"
"14 List 2024 14:38:02";" Zmodyfikowano Transakcję Kupna";"O2-DB-9C8NKG";"T2-DB-5NMPF6";"-";"USD/JPY";"20 000 Jednost.";"155,968";"-";"156,050";"-";"-";"-";"-";"0,00";"-";"-";"-";"-";"-";"-";"-";"-";"-";"-";"-";"-";"-";"-";"-";"-";"-";"-";"-";"-";"-";"-";"-";"-";"-"
"14 List 2024 14:37:28";" Zmodyfikowano Transakcję Kupna";"O2-DB-9C8NNX";"T2-DB-5NMPHF";"-";"USD/JPY";"37 000 Jednost.";"155,952";"-";"156,000";"-";"-";"-";"-";"0,00";"-";"-";"-";"-";"-";"-";"-";"-";"-";"-";"-";"-";"-";"-";"-";"-";"-";"-";"-";"-";"-";"-";"-";"-";"-"
"14 List 2024 13:38:00";" Transakcja Kupna";"O2-DB-9C8NNX";"T2-DB-5NMPHF";"-";"USD/JPY";"37 000 Jednost.";"155,952";"-";"-";"-";"-";"4,141727";"153 243,89";"0,00";"-";"-";"-";"-";"-";"-";"-";"-";"-";"-";"-";"-";"-";"-";"-";"-";"-";"-";"-";"-";"-";"-";"-";"-";"-"
"14 List 2024 13:34:24";" Transakcja Kupna";"O2-DB-9C8NKG";"T2-DB-5NMPF6";"-";"USD/JPY";"20 000 Jednost.";"155,968";"-";"-";"-";"-";"4,141556";"82 831,12";"0,00";"-";"-";"-";"-";"-";"-";"-";"-";"-";"-";"-";"-";"-";"-";"-";"-";"-";"-";"-";"-";"-";"-";"-";"-";"-"
"14 List 2024 13:32:35";" Zamknięcie Transakcji";"O2-DB-9C8NHH";"T2-DB-5NMPDQ";"O2-DB-9C8MW2";"USD/JPY";"50 000 Jednost.";"156,007";"-";"-";"-";"-";"0,026286";"207 103,85";"42,06";"11 241,04";"-";"-";"-";"-";"-";"-";"-";"-";"-";"-";"-";"-";"-";"-";"-";"-";"-";"-";"-";"-";"-";"-";"-";"-"
"14 List 2024 13:10:46";" Transakcja Kupna";"O2-DB-9C8MW2";"T2-DB-5NMNX9";"-";"USD/JPY";"50 000 Jednost.";"155,975";"-";"-";"-";"-";"4,14334";"207 167,00";"0,00";"-";"-";"-";"-";"-";"-";"-";"-";"-";"-";"-";"-";"-";"-";"-";"-";"-";"-";"-";"-";"-";"-";"-";"-";"-"
"14 List 2024 13:02:12";" Zamknięcie Transakcji";"O2-DB-9C8MLE";"T2-DB-5NMNNZ";"O2-DB-9C7LKE";"USD/JPY";"20 000 Jednost.";"155,866";"-";"-";"-";"-";"0,026305";"82 831,72";"196,24";"11 198,98";"-";"-";"-";"-";"-";"-";"-";"-";"-";"-";"-";"-";"-";"-";"-";"-";"-";"-";"-";"-";"-";"-";"-";"-"
"14 List 2024 13:00:49";" Zamknięcie Transakcji";"O2-DB-9C8MK4";"T2-DB-5NMNN1";"O2-DB-9C7SQ7";"USD/JPY";"30 000 Jednost.";"155,891";"-";"-";"-";"-";"0,026302";"124 262,61";"317,20";"11 002,74";"-";"-";"-";"-";"-";"-";"-";"-";"-";"-";"-";"-";"-";"-";"-";"-";"-";"-";"-";"-";"-";"-";"-";"-"
"14 List 2024 10:16:29";" Zmodyfikowano Transakcję Kupna";"O2-DB-9C7SQ7";"T2-DB-5NLZWJ";"-";"USD/JPY";"30 000 Jednost.";"155,489";"-";"155,700";"-";"-";"-";"-";"0,00";"-";"-";"-";"-";"-";"-";"-";"-";"-";"-";"-";"-";"-";"-";"-";"-";"-";"-";"-";"-";"-";"-";"-";"-";"-"
"13 List 2024 23:02:10";"Koszty Utrzymania Pozycji";"1387915572";"-";"-";"Rachunek";"-";"-";"-";"-";"-";"-";"-";"-";"-40,61";"10 685,54";"-";"-";"-";"-";"-";"-40,61";"-";"-";"-";"-";"-";"-";"-";"-";"-";"-";"-";"-";"-";"-";"-";"-";"-";"-"
"13 List 2024 23:02:10";"Koszty Utrzymania Pozycji";"O2-D9-9BKRVE";"-";"-";"USD/JPY";"-";"-";"-";"-";"-";"-";"-";"-";"-";"-";"-";"-";"26 000,00";"3,54652%";"30,99";"0,00";"-";"-";"-";"-";"-";"-";"-";"-";"-";"-";"-";"-";"-";"-";"-";"-";"-";"-"
"13 List 2024 23:02:10";"Koszty Utrzymania Pozycji";"O2-D9-9BJZX7";"-";"-";"USD/JPY";"-";"-";"-";"-";"-";"-";"-";"-";"-";"-";"-";"-";"30 000,00";"5,59388%";"-56,97";"0,00";"-";"-";"-";"-";"-";"-";"-";"-";"-";"-";"-";"-";"-";"-";"-";"-";"-";"-"
"13 List 2024 23:02:10";"Koszty Utrzymania Pozycji";"O2-D9-9BB04B";"-";"-";"USD/JPY";"-";"-";"-";"-";"-";"-";"-";"-";"-";"-";"-";"-";"34 000,00";"5,59388%";"-64,57";"0,00";"-";"-";"-";"-";"-";"-";"-";"-";"-";"-";"-";"-";"-";"-";"-";"-";"-";"-"
"13 List 2024 23:02:10";"Koszty Utrzymania Pozycji";"O2-DB-9C7SQ7";"-";"-";"USD/JPY";"-";"-";"-";"-";"-";"-";"-";"-";"-";"-";"-";"-";"30 000,00";"3,54652%";"35,76";"0,00";"-";"-";"-";"-";"-";"-";"-";"-";"-";"-";"-";"-";"-";"-";"-";"-";"-";"-"
"13 List 2024 23:02:10";"Koszty Utrzymania Pozycji";"O2-DB-9C7LKE";"-";"-";"USD/JPY";"-";"-";"-";"-";"-";"-";"-";"-";"-";"-";"-";"-";"20 000,00";"3,54652%";"23,84";"0,00";"-";"-";"-";"-";"-";"-";"-";"-";"-";"-";"-";"-";"-";"-";"-";"-";"-";"-"
"13 List 2024 23:02:10";"Koszty Utrzymania Pozycji";"O2-D9-9BS5RZ";"-";"-";"USD/JPY";"-";"-";"-";"-";"-";"-";"-";"-";"-";"-";"-";"-";"22 000,00";"5,59388%";"-41,78";"0,00";"-";"-";"-";"-";"-";"-";"-";"-";"-";"-";"-";"-";"-";"-";"-";"-";"-";"-"
"13 List 2024 23:02:10";"Koszty Utrzymania Pozycji";"O2-D9-9BJQLQ";"-";"-";"USD/JPY";"-";"-";"-";"-";"-";"-";"-";"-";"-";"-";"-";"-";"20 000,00";"3,54652%";"23,84";"0,00";"-";"-";"-";"-";"-";"-";"-";"-";"-";"-";"-";"-";"-";"-";"-";"-";"-";"-"
"13 List 2024 23:02:10";"Koszty Utrzymania Pozycji";"O2-D9-9BH1F6";"-";"-";"USD/JPY";"-";"-";"-";"-";"-";"-";"-";"-";"-";"-";"-";"-";"6 000,00";"3,54652%";"7,15";"0,00";"-";"-";"-";"-";"-";"-";"-";"-";"-";"-";"-";"-";"-";"-";"-";"-";"-";"-"
"13 List 2024 23:02:10";"Koszty Utrzymania Pozycji";"O2-DB-9C7SP3";"-";"-";"USD/JPY";"-";"-";"-";"-";"-";"-";"-";"-";"-";"-";"-";"-";"36 000,00";"3,54652%";"42,91";"0,00";"-";"-";"-";"-";"-";"-";"-";"-";"-";"-";"-";"-";"-";"-";"-";"-";"-";"-"
"13 List 2024 23:02:10";"Koszty Utrzymania Pozycji";"O2-DB-9C4T5Y";"-";"-";"USD/JPY";"-";"-";"-";"-";"-";"-";"-";"-";"-";"-";"-";"-";"22 000,00";"5,59388%";"-41,78";"0,00";"-";"-";"-";"-";"-";"-";"-";"-";"-";"-";"-";"-";"-";"-";"-";"-";"-";"-"
"13 List 2024 22:58:47";" Transakcja Kupna";"O2-DB-9C7SQ7";"T2-DB-5NLZWJ";"-";"USD/JPY";"30 000 Jednost.";"155,489";"-";"-";"-";"-";"4,130294";"123 908,82";"0,00";"-";"-";"-";"-";"-";"-";"-";"-";"-";"-";"-";"-";"-";"-";"-";"-";"-";"-";"-";"-";"-";"-";"-";"-";"-"
"13 List 2024 22:57:31";" Transakcja Kupna";"O2-DB-9C7SP3";"T2-DB-5NLZVM";"-";"USD/JPY";"36 000 Jednost.";"155,468";"-";"-";"-";"-";"4,130093";"148 683,34";"0,00";"-";"-";"-";"-";"-";"-";"-";"-";"-";"-";"-";"-";"-";"-";"-";"-";"-";"-";"-";"-";"-";"-";"-";"-";"-"
"13 List 2024 21:16:58";" Zamknięcie Transakcji";"O2-DB-9C7P8R";"T2-DB-5NLX1E";"O2-DB-9C7LKE";"USD/JPY";"16 000 Jednost.";"155,520";"-";"-";"-";"-";"0,026286";"66 068,35";"11,36";"10 726,15";"-";"-";"-";"-";"-";"-";"-";"-";"-";"-";"-";"-";"-";"-";"-";"-";"-";"-";"-";"-";"-";"-";"-";"-"
"13 List 2024 20:38:48";" Zamknięcie Transakcji";"O2-DB-9C7MBZ";"T2-DB-5NLV8L";"O2-DB-9C4QW4";"USD/JPY";"20 000 Jednost.";"155,434";"-";"-";"-";"-";"0,026281";"82 522,70";"500,92";"10 714,79";"-";"-";"-";"-";"-";"-";"-";"-";"-";"-";"-";"-";"-";"-";"-";"-";"-";"-";"-";"-";"-";"-";"-";"-"
"13 List 2024 20:23:26";" Transakcja Kupna";"O2-DB-9C7LKE";"T2-DB-5NLTHX";"-";"USD/JPY";"36 000 Jednost.";"155,493";"-";"-";"-";"-";"4,126957";"148 570,45";"0,00";"-";"-";"-";"-";"-";"-";"-";"-";"-";"-";"-";"-";"-";"-";"-";"-";"-";"-";"-";"-";"-";"-";"-";"-";"-"
"13 List 2024 20:03:10";"Stop Loss";"O2-DB-9C7K6Q";"T2-DB-5NLSG8";"-";"USD/JPY";"36 000 Jednost.";"155,585";"-";"-";"-";"-";"0,026284";"148 702,46";"18,92";"10 213,87";"-";"-";"-";"-";"-";"-";"-";"-";"-";"-";"-";"-";"-";"-";"-";"-";"-";"-";"-";"-";"-";"-";"-";"-"
"13 List 2024 20:01:59";" Zmodyfikowano Transakcję Kupna";"O2-DB-9C7K6Q";"T2-DB-5NLS7S";"-";"USD/JPY";"36 000 Jednost.";"155,565";"-";"155,590";"-";"-";"-";"-";"0,00";"-";"-";"-";"-";"-";"-";"-";"-";"-";"-";"-";"-";"-";"-";"-";"-";"-";"-";"-";"-";"-";"-";"-";"-";"-"
"13 List 2024 19:57:58";" Transakcja Kupna";"O2-DB-9C7K6Q";"T2-DB-5NLS7S";"-";"USD/JPY";"36 000 Jednost.";"155,565";"-";"-";"-";"-";"4,132127";"148 756,57";"0,00";"-";"-";"-";"-";"-";"-";"-";"-";"-";"-";"-";"-";"-";"-";"-";"-";"-";"-";"-";"-";"-";"-";"-";"-";"-"
"13 List 2024 17:51:04";" Zamknięcie Transakcji";"O2-DB-9C7C3G";"T2-DB-5NLKYE";"O2-DB-9C4QW4";"USD/JPY";"10 000 Jednost.";"155,233";"-";"-";"-";"-";"0,02633";"41 281,79";"198,00";"10 194,95";"-";"-";"-";"-";"-";"-";"-";"-";"-";"-";"-";"-";"-";"-";"-";"-";"-";"-";"-";"-";"-";"-";"-";"-"
"13 List 2024 17:50:29";" Zamknięcie Transakcji";"O2-DB-9C7C2C";"T2-DB-5NLKXH";"O2-DB-9C4QW4";"USD/JPY";"4 000 Jednost.";"155,218";"-";"-";"-";"-";"0,026329";"16 511,83";"77,62";"9 996,95";"-";"-";"-";"-";"-";"-";"-";"-";"-";"-";"-";"-";"-";"-";"-";"-";"-";"-";"-";"-";"-";"-";"-";"-"
"13 List 2024 17:46:58";"Stop Loss";"O2-DB-9C664E";"T2-DB-5NLKNG";"-";"USD/JPY";"18 000 Jednost.";"155,210";"-";"-";"-";"-";"0,026332";"74 310,48";"27,96";"9 919,33";"-";"-";"-";"-";"-";"-";"-";"-";"-";"-";"-";"-";"-";"-";"-";"-";"-";"-";"-";"-";"-";"-";"-";"-"
"13 List 2024 17:46:55";" Zmodyfikowano Transakcję Kupna";"O2-DB-9C664E";"T2-DB-5NKKCR";"-";"USD/JPY";"18 000 Jednost.";"155,151";"-";"155,210";"-";"-";"-";"-";"0,00";"-";"-";"-";"-";"-";"-";"-";"-";"-";"-";"-";"-";"-";"-";"-";"-";"-";"-";"-";"-";"-";"-";"-";"-";"-"
"13 List 2024 17:45:46";"Stop Loss";"O2-DB-9C6639";"T2-DB-5NLKKH";"-";"USD/JPY";"22 000 Jednost.";"155,200";"-";"-";"-";"-";"0,026335";"90 820,62";"9,85";"9 891,37";"-";"-";"-";"-";"-";"-";"-";"-";"-";"-";"-";"-";"-";"-";"-";"-";"-";"-";"-";"-";"-";"-";"-";"-"
"13 List 2024 17:45:41";" Zmodyfikowano Transakcję Kupna";"O2-DB-9C6639";"T2-DB-5NKKBY";"-";"USD/JPY";"22 000 Jednost.";"155,183";"-";"155,200";"-";"-";"-";"-";"0,00";"-";"-";"-";"-";"-";"-";"-";"-";"-";"-";"-";"-";"-";"-";"-";"-";"-";"-";"-";"-";"-";"-";"-";"-";"-"
"13 List 2024 16:06:30";" Wpłata";"1387770269";"BD.18486261";"-";"Rachunek";"-";"-";"-";"-";"-";"-";"-";"-";"2 500,00";"9 881,52";"2 500,00";"0,00";"-";"-";"-";"-";"-";"-";"-";"-";"-";"-";"-";"-";"-";"-";"-";"-";"-";"-";"-";"-";"-";"-"
"13 List 2024 09:10:30";" Transakcja Kupna";"O2-DB-9C664E";"T2-DB-5NKKCR";"-";"USD/JPY";"18 000 Jednost.";"155,151";"-";"-";"-";"-";"4,131045";"74 358,81";"0,00";"-";"-";"-";"-";"-";"-";"-";"-";"-";"-";"-";"-";"-";"-";"-";"-";"-";"-";"-";"-";"-";"-";"-";"-";"-"
"13 List 2024 09:09:55";" Transakcja Kupna";"O2-DB-9C6639";"T2-DB-5NKKBY";"-";"USD/JPY";"22 000 Jednost.";"155,183";"-";"-";"-";"-";"4,129492";"90 848,82";"0,00";"-";"-";"-";"-";"-";"-";"-";"-";"-";"-";"-";"-";"-";"-";"-";"-";"-";"-";"-";"-";"-";"-";"-";"-";"-"
"13 List 2024 08:55:47";" Zamknięcie Transakcji";"O2-DB-9C654F";"T2-DB-5NKJKJ";"O2-DB-9C62PF";"USD/JPY";"18 000 Jednost.";"155,089";"-";"-";"-";"-";"0,026328";"74 232,73";"8,06";"7 381,52";"-";"-";"-";"-";"-";"-";"-";"-";"-";"-";"-";"-";"-";"-";"-";"-";"-";"-";"-";"-";"-";"-";"-";"-"
"13 List 2024 08:55:44";"Take Profit";"O2-DB-9C62LZ";"T2-DB-5NKJKF";"-";"USD/JPY";"22 000 Jednost.";"155,080";"-";"-";"-";"-";"0,026328";"90 728,90";"4,05";"7 373,46";"-";"-";"-";"-";"-";"-";"-";"-";"-";"-";"-";"-";"-";"-";"-";"-";"-";"-";"-";"-";"-";"-";"-";"-"
"13 List 2024 08:54:32";" Zmodyfikowano Transakcję Kupna";"O2-DB-9C62LZ";"T2-DB-5NKGNZ";"-";"USD/JPY";"22 000 Jednost.";"155,073";"-";"-";"155,080";"-";"-";"-";"0,00";"-";"-";"-";"-";"-";"-";"-";"-";"-";"-";"-";"-";"-";"-";"-";"-";"-";"-";"-";"-";"-";"-";"-";"-";"-"
"13 List 2024 07:33:08";" Transakcja Kupna";"O2-DB-9C62PF";"T2-DB-5NKGQF";"-";"USD/JPY";"18 000 Jednost.";"155,072";"-";"-";"-";"-";"4,122017";"74 196,30";"0,00";"-";"-";"-";"-";"-";"-";"-";"-";"-";"-";"-";"-";"-";"-";"-";"-";"-";"-";"-";"-";"-";"-";"-";"-";"-"
"13 List 2024 07:32:56";"Odrzucono Zlecenie: brak wystarczających środków";"O2-DB-9C62P1";"-";"-";"USD/JPY";"20 000 Jednost.";"-";"-";"-";"-";"-";"-";"-";"-";"-";"-";"-";"-";"-";"-";"-";"-";"-";"-";"-";"-";"-";"-";"-";"-";"-";"-";"-";"-";"-";"-";"-";"-";"-"
"13 List 2024 07:31:21";" Transakcja Kupna";"O2-DB-9C62LZ";"T2-DB-5NKGNZ";"-";"USD/JPY";"22 000 Jednost.";"155,073";"-";"-";"-";"-";"4,122538";"90 695,83";"0,00";"-";"-";"-";"-";"-";"-";"-";"-";"-";"-";"-";"-";"-";"-";"-";"-";"-";"-";"-";"-";"-";"-";"-";"-";"-"
"13 List 2024 07:30:57";"Zmodyfikowano Transakcję Sprzedaży";"O2-DB-9C4T5Y";"T2-DB-5NJFEE";"-";"USD/JPY";"22 000 Jednost.";"154,309";"-";"-";"-";"-";"-";"-";"0,00";"-";"-";"-";"-";"-";"-";"-";"-";"-";"-";"-";"-";"-";"-";"-";"-";"-";"-";"-";"-";"-";"-";"-";"-";"-"
"12 List 2024 23:47:16";"Zmodyfikowano Transakcję Sprzedaży";"O2-DB-9C4T5Y";"T2-DB-5NJFEE";"-";"USD/JPY";"22 000 Jednost.";"154,309";"-";"-";"154,280";"-";"-";"-";"0,00";"-";"-";"-";"-";"-";"-";"-";"-";"-";"-";"-";"-";"-";"-";"-";"-";"-";"-";"-";"-";"-";"-";"-";"-";"-"
"12 List 2024 23:02:10";"Koszty Utrzymania Pozycji";"1387577170";"-";"-";"Rachunek";"-";"-";"-";"-";"-";"-";"-";"-";"-34,07";"7 369,41";"-";"-";"-";"-";"-";"-34,07";"-";"-";"-";"-";"-";"-";"-";"-";"-";"-";"-";"-";"-";"-";"-";"-";"-";"-"
"12 List 2024 23:02:10";"Koszty Utrzymania Pozycji";"O2-D9-9BKRVE";"-";"-";"USD/JPY";"-";"-";"-";"-";"-";"-";"-";"-";"-";"-";"-";"-";"26 000,00";"3,54652%";"10,29";"0,00";"-";"-";"-";"-";"-";"-";"-";"-";"-";"-";"-";"-";"-";"-";"-";"-";"-";"-"
"12 List 2024 23:02:10";"Koszty Utrzymania Pozycji";"O2-D9-9BJZX7";"-";"-";"USD/JPY";"-";"-";"-";"-";"-";"-";"-";"-";"-";"-";"-";"-";"30 000,00";"5,59388%";"-18,92";"0,00";"-";"-";"-";"-";"-";"-";"-";"-";"-";"-";"-";"-";"-";"-";"-";"-";"-";"-"
"12 List 2024 23:02:10";"Koszty Utrzymania Pozycji";"O2-D9-9BB04B";"-";"-";"USD/JPY";"-";"-";"-";"-";"-";"-";"-";"-";"-";"-";"-";"-";"34 000,00";"5,59388%";"-21,44";"0,00";"-";"-";"-";"-";"-";"-";"-";"-";"-";"-";"-";"-";"-";"-";"-";"-";"-";"-"
"12 List 2024 23:02:10";"Koszty Utrzymania Pozycji";"O2-D9-9BS5RZ";"-";"-";"USD/JPY";"-";"-";"-";"-";"-";"-";"-";"-";"-";"-";"-";"-";"22 000,00";"5,59388%";"-13,88";"0,00";"-";"-";"-";"-";"-";"-";"-";"-";"-";"-";"-";"-";"-";"-";"-";"-";"-";"-"
"12 List 2024 23:02:10";"Koszty Utrzymania Pozycji";"O2-DB-9C4QW4";"-";"-";"USD/JPY";"-";"-";"-";"-";"-";"-";"-";"-";"-";"-";"-";"-";"34 000,00";"3,54652%";"13,46";"0,00";"-";"-";"-";"-";"-";"-";"-";"-";"-";"-";"-";"-";"-";"-";"-";"-";"-";"-"
"12 List 2024 23:02:10";"Koszty Utrzymania Pozycji";"O2-D9-9BJQLQ";"-";"-";"USD/JPY";"-";"-";"-";"-";"-";"-";"-";"-";"-";"-";"-";"-";"20 000,00";"3,54652%";"7,92";"0,00";"-";"-";"-";"-";"-";"-";"-";"-";"-";"-";"-";"-";"-";"-";"-";"-";"-";"-"
"12 List 2024 23:02:10";"Koszty Utrzymania Pozycji";"O2-D9-9BH1F6";"-";"-";"USD/JPY";"-";"-";"-";"-";"-";"-";"-";"-";"-";"-";"-";"-";"6 000,00";"3,54652%";"2,38";"0,00";"-";"-";"-";"-";"-";"-";"-";"-";"-";"-";"-";"-";"-";"-";"-";"-";"-";"-"
"12 List 2024 23:02:10";"Koszty Utrzymania Pozycji";"O2-DB-9C4T5Y";"-";"-";"USD/JPY";"-";"-";"-";"-";"-";"-";"-";"-";"-";"-";"-";"-";"22 000,00";"5,59388%";"-13,88";"0,00";"-";"-";"-";"-";"-";"-";"-";"-";"-";"-";"-";"-";"-";"-";"-";"-";"-";"-"
"12 List 2024 15:45:20";"Transakcja Sprzedaży";"O2-DB-9C4T5Y";"T2-DB-5NJFEE";"-";"USD/JPY";"22 000 Jednost.";"154,309";"-";"-";"-";"-";"4,117358";"90 581,87";"0,00";"-";"-";"-";"-";"-";"-";"-";"-";"-";"-";"-";"-";"-";"-";"-";"-";"-";"-";"-";"-";"-";"-";"-";"-";"-"
"12 List 2024 15:45:06";"Odrzucono Zlecenie: brak wystarczających środków";"O2-DB-9C4T52";"-";"-";"USD/JPY";"25 000 Jednost.";"-";"-";"-";"-";"-";"-";"-";"-";"-";"-";"-";"-";"-";"-";"-";"-";"-";"-";"-";"-";"-";"-";"-";"-";"-";"-";"-";"-";"-";"-";"-";"-";"-"
"12 List 2024 15:44:56";"Odrzucono Zlecenie: brak wystarczających środków";"O2-DB-9C4T4K";"-";"-";"USD/JPY";"28 000 Jednost.";"-";"-";"-";"-";"-";"-";"-";"-";"-";"-";"-";"-";"-";"-";"-";"-";"-";"-";"-";"-";"-";"-";"-";"-";"-";"-";"-";"-";"-";"-";"-";"-";"-"
"12 List 2024 15:27:31";" Transakcja Kupna";"O2-DB-9C4QW4";"T2-DB-5NJDF5";"-";"USD/JPY";"34 000 Jednost.";"154,481";"-";"-";"-";"-";"4,11821";"140 019,14";"0,00";"-";"-";"-";"-";"-";"-";"-";"-";"-";"-";"-";"-";"-";"-";"-";"-";"-";"-";"-";"-";"-";"-";"-";"-";"-"
"12 List 2024 09:43:29";"Stop Loss";"O2-DB-9C477M";"T2-DB-5NHZ1L";"-";"USD/JPY";"54 000 Jednost.";"153,930";"-";"-";"-";"-";"0,026538";"222 834,56";"27,23";"7 403,48";"-";"-";"-";"-";"-";"-";"-";"-";"-";"-";"-";"-";"-";"-";"-";"-";"-";"-";"-";"-";"-";"-";"-";"-"
"12 List 2024 09:42:35";" Zmodyfikowano Transakcję Kupna";"O2-DB-9C477M";"T2-DB-5NHYZ4";"-";"USD/JPY";"54 000 Jednost.";"153,911";"-";"153,930";"-";"-";"-";"-";"0,00";"-";"-";"-";"-";"-";"-";"-";"-";"-";"-";"-";"-";"-";"-";"-";"-";"-";"-";"-";"-";"-";"-";"-";"-";"-"
"12 List 2024 09:41:08";" Transakcja Kupna";"O2-DB-9C477M";"T2-DB-5NHYZ4";"-";"USD/JPY";"54 000 Jednost.";"153,911";"-";"-";"-";"-";"4,125614";"222 783,15";"0,00";"-";"-";"-";"-";"-";"-";"-";"-";"-";"-";"-";"-";"-";"-";"-";"-";"-";"-";"-";"-";"-";"-";"-";"-";"-"
"12 List 2024 09:15:15";"Stop Loss";"O2-DB-9C44YP";"T2-DB-5NHXS7";"-";"USD/JPY";"34 000 Jednost.";"153,840";"-";"-";"-";"-";"0,026547";"140 254,18";"92,97";"7 376,25";"-";"-";"-";"-";"-";"-";"-";"-";"-";"-";"-";"-";"-";"-";"-";"-";"-";"-";"-";"-";"-";"-";"-";"-"
"12 List 2024 09:15:06";"Zmodyfikowano Stop Loss";"O2-DB-9C44YP";"-";"O2-DB-9C45GH";"USD/JPY";"34 000 Jednost.";"153,737";"-";"153,840";"-";"-";"-";"-";"-";"-";"-";"-";"-";"-";"-";"-";"-";"-";"-";"-";"-";"-";"-";"-";"-";"-";"-";"-";"-";"-";"-";"-";"-";"-"
"12 List 2024 09:14:31";"Zmodyfikowano Stop Loss";"O2-DB-9C44YP";"-";"O2-DB-9C45GH";"USD/JPY";"34 000 Jednost.";"153,737";"-";"153,820";"-";"-";"-";"-";"-";"-";"-";"-";"-";"-";"-";"-";"-";"-";"-";"-";"-";"-";"-";"-";"-";"-";"-";"-";"-";"-";"-";"-";"-";"-"
"12 List 2024 09:12:50";" Zmodyfikowano Transakcję Kupna";"O2-DB-9C44YP";"T2-DB-5NHX53";"-";"USD/JPY";"34 000 Jednost.";"153,737";"-";"153,800";"-";"-";"-";"-";"0,00";"-";"-";"-";"-";"-";"-";"-";"-";"-";"-";"-";"-";"-";"-";"-";"-";"-";"-";"-";"-";"-";"-";"-";"-";"-"
"12 List 2024 09:04:31";" Transakcja Kupna";"O2-DB-9C44YP";"T2-DB-5NHX53";"-";"USD/JPY";"34 000 Jednost.";"153,737";"-";"-";"-";"-";"4,125554";"140 268,83";"0,00";"-";"-";"-";"-";"-";"-";"-";"-";"-";"-";"-";"-";"-";"-";"-";"-";"-";"-";"-";"-";"-";"-";"-";"-";"-"
"12 List 2024 08:55:52";"Stop Loss";"O2-DB-9C43TM";"T2-DB-5NHWKK";"-";"USD/JPY";"34 000 Jednost.";"153,780";"-";"-";"-";"-";"0,026539";"140 163,23";"39,70";"7 283,28";"-";"-";"-";"-";"-";"-";"-";"-";"-";"-";"-";"-";"-";"-";"-";"-";"-";"-";"-";"-";"-";"-";"-";"-"
"12 List 2024 08:55:31";"Zmodyfikowano Stop Loss";"O2-DB-9C43TM";"-";"O2-DB-9C447M";"USD/JPY";"34 000 Jednost.";"153,736";"-";"153,780";"-";"-";"-";"-";"-";"-";"-";"-";"-";"-";"-";"-";"-";"-";"-";"-";"-";"-";"-";"-";"-";"-";"-";"-";"-";"-";"-";"-";"-";"-"
"12 List 2024 08:54:43";" Zmodyfikowano Transakcję Kupna";"O2-DB-9C43TM";"T2-DB-5NHW81";"-";"USD/JPY";"34 000 Jednost.";"153,736";"-";"153,770";"-";"-";"-";"-";"0,00";"-";"-";"-";"-";"-";"-";"-";"-";"-";"-";"-";"-";"-";"-";"-";"-";"-";"-";"-";"-";"-";"-";"-";"-";"-"
"12 List 2024 08:46:39";" Transakcja Kupna";"O2-DB-9C43TM";"T2-DB-5NHW81";"-";"USD/JPY";"34 000 Jednost.";"153,736";"-";"-";"-";"-";"4,120725";"140 104,65";"0,00";"-";"-";"-";"-";"-";"-";"-";"-";"-";"-";"-";"-";"-";"-";"-";"-";"-";"-";"-";"-";"-";"-";"-";"-";"-"
"12 List 2024 08:24:02";"Stop Loss";"O2-DB-9C42CE";"T2-DB-5NHV0F";"-";"USD/JPY";"34 000 Jednost.";"153,790";"-";"-";"-";"-";"0,026558";"140 269,17";"18,96";"7 243,58";"-";"-";"-";"-";"-";"-";"-";"-";"-";"-";"-";"-";"-";"-";"-";"-";"-";"-";"-";"-";"-";"-";"-";"-"
"12 List 2024 08:24:02";" Zmodyfikowano Transakcję Kupna";"O2-DB-9C42CE";"T2-DB-5NHTW8";"-";"USD/JPY";"34 000 Jednost.";"153,769";"-";"153,790";"-";"-";"-";"-";"0,00";"-";"-";"-";"-";"-";"-";"-";"-";"-";"-";"-";"-";"-";"-";"-";"-";"-";"-";"-";"-";"-";"-";"-";"-";"-"
"12 List 2024 08:19:10";" Transakcja Kupna";"O2-DB-9C42CE";"T2-DB-5NHTW8";"-";"USD/JPY";"34 000 Jednost.";"153,769";"-";"-";"-";"-";"4,122378";"140 160,85";"0,00";"-";"-";"-";"-";"-";"-";"-";"-";"-";"-";"-";"-";"-";"-";"-";"-";"-";"-";"-";"-";"-";"-";"-";"-";"-"
"12 List 2024 08:14:49";"Stop Loss";"O2-DB-9C41DL";"T2-DB-5NHTRJ";"-";"USD/JPY";"34 000 Jednost.";"153,820";"-";"-";"-";"-";"0,026539";"140 186,72";"31,58";"7 224,62";"-";"-";"-";"-";"-";"-";"-";"-";"-";"-";"-";"-";"-";"-";"-";"-";"-";"-";"-";"-";"-";"-";"-";"-"
"12 List 2024 08:14:47";"Zmodyfikowano Stop Loss";"O2-DB-9C41DL";"-";"O2-DB-9C423J";"USD/JPY";"34 000 Jednost.";"153,785";"-";"153,820";"-";"-";"-";"-";"-";"-";"-";"-";"-";"-";"-";"-";"-";"-";"-";"-";"-";"-";"-";"-";"-";"-";"-";"-";"-";"-";"-";"-";"-";"-"
"12 List 2024 08:13:14";" Zmodyfikowano Transakcję Kupna";"O2-DB-9C41DL";"T2-DB-5NHT56";"-";"USD/JPY";"34 000 Jednost.";"153,785";"-";"153,800";"-";"-";"-";"-";"0,00";"-";"-";"-";"-";"-";"-";"-";"-";"-";"-";"-";"-";"-";"-";"-";"-";"-";"-";"-";"-";"-";"-";"-";"-";"-"
"12 List 2024 07:59:43";" Transakcja Kupna";"O2-DB-9C41DL";"T2-DB-5NHT56";"-";"USD/JPY";"34 000 Jednost.";"153,785";"-";"-";"-";"-";"4,121777";"140 140,41";"0,00";"-";"-";"-";"-";"-";"-";"-";"-";"-";"-";"-";"-";"-";"-";"-";"-";"-";"-";"-";"-";"-";"-";"-";"-";"-"
"12 List 2024 07:46:53";"Stop Loss";"O2-DB-9C405G";"T2-DB-5NHSYT";"-";"USD/JPY";"34 000 Jednost.";"153,800";"-";"-";"-";"-";"0,026535";"140 164,25";"32,48";"7 193,04";"-";"-";"-";"-";"-";"-";"-";"-";"-";"-";"-";"-";"-";"-";"-";"-";"-";"-";"-";"-";"-";"-";"-";"-"
"12 List 2024 07:46:39";" Zmodyfikowano Transakcję Kupna";"O2-DB-9C405G";"T2-DB-5NHS8M";"-";"USD/JPY";"34 000 Jednost.";"153,764";"-";"153,800";"-";"-";"-";"-";"0,00";"-";"-";"-";"-";"-";"-";"-";"-";"-";"-";"-";"-";"-";"-";"-";"-";"-";"-";"-";"-";"-";"-";"-";"-";"-"
"12 List 2024 07:14:47";" Transakcja Kupna";"O2-DB-9C405G";"T2-DB-5NHS8M";"-";"USD/JPY";"34 000 Jednost.";"153,764";"-";"-";"-";"-";"4,121757";"140 139,73";"0,00";"-";"-";"-";"-";"-";"-";"-";"-";"-";"-";"-";"-";"-";"-";"-";"-";"-";"-";"-";"-";"-";"-";"-";"-";"-"
"11 List 2024 23:02:06";"Koszty Utrzymania Pozycji";"1387220093";"-";"-";"Rachunek";"-";"-";"-";"-";"-";"-";"-";"-";"-33,72";"7 160,56";"-";"-";"-";"-";"-";"-33,72";"-";"-";"-";"-";"-";"-";"-";"-";"-";"-";"-";"-";"-";"-";"-";"-";"-";"-"
"11 List 2024 23:02:06";"Koszty Utrzymania Pozycji";"O2-D9-9BKRVE";"-";"-";"USD/JPY";"-";"-";"-";"-";"-";"-";"-";"-";"-";"-";"-";"-";"26 000,00";"3,56309%";"10,34";"0,00";"-";"-";"-";"-";"-";"-";"-";"-";"-";"-";"-";"-";"-";"-";"-";"-";"-";"-"
"11 List 2024 23:02:06";"Koszty Utrzymania Pozycji";"O2-D9-9BJZX7";"-";"-";"USD/JPY";"-";"-";"-";"-";"-";"-";"-";"-";"-";"-";"-";"-";"30 000,00";"5,61063%";"-18,98";"0,00";"-";"-";"-";"-";"-";"-";"-";"-";"-";"-";"-";"-";"-";"-";"-";"-";"-";"-"
"11 List 2024 23:02:06";"Koszty Utrzymania Pozycji";"O2-D9-9BB04B";"-";"-";"USD/JPY";"-";"-";"-";"-";"-";"-";"-";"-";"-";"-";"-";"-";"34 000,00";"5,61063%";"-21,51";"0,00";"-";"-";"-";"-";"-";"-";"-";"-";"-";"-";"-";"-";"-";"-";"-";"-";"-";"-"
"11 List 2024 23:02:06";"Koszty Utrzymania Pozycji";"O2-D9-9BS5RZ";"-";"-";"USD/JPY";"-";"-";"-";"-";"-";"-";"-";"-";"-";"-";"-";"-";"22 000,00";"5,61063%";"-13,92";"0,00";"-";"-";"-";"-";"-";"-";"-";"-";"-";"-";"-";"-";"-";"-";"-";"-";"-";"-"
"11 List 2024 23:02:06";"Koszty Utrzymania Pozycji";"O2-D9-9BJQLQ";"-";"-";"USD/JPY";"-";"-";"-";"-";"-";"-";"-";"-";"-";"-";"-";"-";"20 000,00";"3,56309%";"7,96";"0,00";"-";"-";"-";"-";"-";"-";"-";"-";"-";"-";"-";"-";"-";"-";"-";"-";"-";"-"
"11 List 2024 23:02:06";"Koszty Utrzymania Pozycji";"O2-D9-9BH1F6";"-";"-";"USD/JPY";"-";"-";"-";"-";"-";"-";"-";"-";"-";"-";"-";"-";"6 000,00";"3,56309%";"2,39";"0,00";"-";"-";"-";"-";"-";"-";"-";"-";"-";"-";"-";"-";"-";"-";"-";"-";"-";"-"
"11 List 2024 15:46:32";" Zamknięcie Transakcji";"O2-DB-9C2ZHT";"T2-DB-5NGXY5";"O2-DB-9C2XX8";"USD/JPY";"34 000 Jednost.";"153,815";"-";"-";"-";"-";"0,026388";"139 380,00";"33,20";"7 194,28";"-";"-";"-";"-";"-";"-";"-";"-";"-";"-";"-";"-";"-";"-";"-";"-";"-";"-";"-";"-";"-";"-";"-";"-"
"11 List 2024 15:38:14";" Transakcja Kupna";"O2-DB-9C2XX8";"T2-DB-5NGWG0";"-";"USD/JPY";"34 000 Jednost.";"153,778";"-";"-";"-";"-";"4,093841";"139 190,59";"0,00";"-";"-";"-";"-";"-";"-";"-";"-";"-";"-";"-";"-";"-";"-";"-";"-";"-";"-";"-";"-";"-";"-";"-";"-";"-"
"11 List 2024 09:22:47";" Zamknięcie Transakcji";"O2-DB-9C2BME";"T2-DB-5NGD25";"O2-D9-9BH1F6";"USD/JPY";"3 000 Jednost.";"153,793";"-";"-";"-";"-";"0,026269";"12 241,54";"24,82";"7 161,08";"-";"-";"-";"-";"-";"-";"-";"-";"-";"-";"-";"-";"-";"-";"-";"-";"-";"-";"-";"-";"-";"-";"-";"-"
"10 List 2024 22:10:07";" Zamknięcie Transakcji";"O2-DB-9C1T54";"T2-DB-5NFYHC";"O2-D9-9C1QMJ";"USD/JPY";"31 000 Jednost.";"152,605";"-";"-";"-";"-";"0,026314";"125 798,27";"23,66";"7 136,26";"-";"-";"-";"-";"-";"-";"-";"-";"-";"-";"-";"-";"-";"-";"-";"-";"-";"-";"-";"-";"-";"-";"-";"-"
"08 List 2024 23:02:10";"Koszty Utrzymania Pozycji";"1386863722";"-";"-";"Rachunek";"-";"-";"-";"-";"-";"-";"-";"-";"-19,78";"7 112,60";"-";"-";"-";"-";"-";"-19,78";"-";"-";"-";"-";"-";"-";"-";"-";"-";"-";"-";"-";"-";"-";"-";"-";"-";"-"
"08 List 2024 23:02:10";"Koszty Utrzymania Pozycji";"O2-D9-9BKRVE";"-";"-";"USD/JPY";"-";"-";"-";"-";"-";"-";"-";"-";"-";"-";"-";"-";"26 000,00";"3,57703%";"10,23";"0,00";"-";"-";"-";"-";"-";"-";"-";"-";"-";"-";"-";"-";"-";"-";"-";"-";"-";"-"
"08 List 2024 23:02:10";"Koszty Utrzymania Pozycji";"O2-D9-9BJZX7";"-";"-";"USD/JPY";"-";"-";"-";"-";"-";"-";"-";"-";"-";"-";"-";"-";"30 000,00";"5,61260%";"-18,70";"0,00";"-";"-";"-";"-";"-";"-";"-";"-";"-";"-";"-";"-";"-";"-";"-";"-";"-";"-"
"08 List 2024 23:02:10";"Koszty Utrzymania Pozycji";"O2-D9-9BB04B";"-";"-";"USD/JPY";"-";"-";"-";"-";"-";"-";"-";"-";"-";"-";"-";"-";"34 000,00";"5,61260%";"-21,20";"0,00";"-";"-";"-";"-";"-";"-";"-";"-";"-";"-";"-";"-";"-";"-";"-";"-";"-";"-"
"08 List 2024 23:02:10";"Koszty Utrzymania Pozycji";"O2-D9-9BS5RZ";"-";"-";"USD/JPY";"-";"-";"-";"-";"-";"-";"-";"-";"-";"-";"-";"-";"22 000,00";"5,61260%";"-13,72";"0,00";"-";"-";"-";"-";"-";"-";"-";"-";"-";"-";"-";"-";"-";"-";"-";"-";"-";"-"
"08 List 2024 23:02:10";"Koszty Utrzymania Pozycji";"O2-D9-9BH1F6";"-";"-";"USD/JPY";"-";"-";"-";"-";"-";"-";"-";"-";"-";"-";"-";"-";"9 000,00";"3,57703%";"3,54";"0,00";"-";"-";"-";"-";"-";"-";"-";"-";"-";"-";"-";"-";"-";"-";"-";"-";"-";"-"
"08 List 2024 23:02:10";"Koszty Utrzymania Pozycji";"O2-D9-9C1QMJ";"-";"-";"USD/JPY";"-";"-";"-";"-";"-";"-";"-";"-";"-";"-";"-";"-";"31 000,00";"3,57703%";"12,20";"0,00";"-";"-";"-";"-";"-";"-";"-";"-";"-";"-";"-";"-";"-";"-";"-";"-";"-";"-"
"08 List 2024 23:02:10";"Koszty Utrzymania Pozycji";"O2-D9-9BJQLQ";"-";"-";"USD/JPY";"-";"-";"-";"-";"-";"-";"-";"-";"-";"-";"-";"-";"20 000,00";"3,57703%";"7,87";"0,00";"-";"-";"-";"-";"-";"-";"-";"-";"-";"-";"-";"-";"-";"-";"-";"-";"-";"-"
"08 List 2024 21:55:12";" Transakcja Kupna";"O2-D9-9C1QMJ";"T2-D9-5NFX3X";"-";"USD/JPY";"31 000 Jednost.";"152,576";"-";"-";"-";"-";"4,058601";"125 816,63";"0,00";"-";"-";"-";"-";"-";"-";"-";"-";"-";"-";"-";"-";"-";"-";"-";"-";"-";"-";"-";"-";"-";"-";"-";"-";"-"
"08 List 2024 07:42:25";" Zamknięcie Transakcji";"O2-D9-9C01PE";"T2-D9-5NEJKZ";"O2-D9-9BLC3T";"USD/JPY";"1 000 Jednost.";"152,726";"-";"-";"-";"-";"0,026084";"4 023,89";"6,76";"7 132,38";"-";"-";"-";"-";"-";"-";"-";"-";"-";"-";"-";"-";"-";"-";"-";"-";"-";"-";"-";"-";"-";"-";"-";"-"
"08 List 2024 02:30:38";"Take Profit";"O2-D9-9BZFRY";"T2-D9-5NECZL";"-";"USD/JPY";"30 000 Jednost.";"153,350";"-";"-";"-";"-";"0,025962";"120 627,75";"163,56";"7 125,62";"-";"-";"-";"-";"-";"-";"-";"-";"-";"-";"-";"-";"-";"-";"-";"-";"-";"-";"-";"-";"-";"-";"-";"-"
"07 List 2024 23:02:13";"Koszty Utrzymania Pozycji";"1386515667";"-";"-";"Rachunek";"-";"-";"-";"-";"-";"-";"-";"-";"-19,58";"6 962,06";"-";"-";"-";"-";"-";"-19,58";"-";"-";"-";"-";"-";"-";"-";"-";"-";"-";"-";"-";"-";"-";"-";"-";"-";"-"
"07 List 2024 23:02:13";"Koszty Utrzymania Pozycji";"O2-D9-9BKRVE";"-";"-";"USD/JPY";"-";"-";"-";"-";"-";"-";"-";"-";"-";"-";"-";"-";"26 000,00";"3,57703%";"10,12";"0,00";"-";"-";"-";"-";"-";"-";"-";"-";"-";"-";"-";"-";"-";"-";"-";"-";"-";"-"
"07 List 2024 23:02:13";"Koszty Utrzymania Pozycji";"O2-D9-9BLC3T";"-";"-";"USD/JPY";"-";"-";"-";"-";"-";"-";"-";"-";"-";"-";"-";"-";"1 000,00";"3,57703%";"0,39";"0,00";"-";"-";"-";"-";"-";"-";"-";"-";"-";"-";"-";"-";"-";"-";"-";"-";"-";"-"
"07 List 2024 23:02:13";"Koszty Utrzymania Pozycji";"O2-D9-9BJZX7";"-";"-";"USD/JPY";"-";"-";"-";"-";"-";"-";"-";"-";"-";"-";"-";"-";"30 000,00";"5,61260%";"-18,51";"0,00";"-";"-";"-";"-";"-";"-";"-";"-";"-";"-";"-";"-";"-";"-";"-";"-";"-";"-"
"07 List 2024 23:02:13";"Koszty Utrzymania Pozycji";"O2-D9-9BB04B";"-";"-";"USD/JPY";"-";"-";"-";"-";"-";"-";"-";"-";"-";"-";"-";"-";"34 000,00";"5,61260%";"-20,97";"0,00";"-";"-";"-";"-";"-";"-";"-";"-";"-";"-";"-";"-";"-";"-";"-";"-";"-";"-"
"07 List 2024 23:02:13";"Koszty Utrzymania Pozycji";"O2-D9-9BS5RZ";"-";"-";"USD/JPY";"-";"-";"-";"-";"-";"-";"-";"-";"-";"-";"-";"-";"22 000,00";"5,61260%";"-13,57";"0,00";"-";"-";"-";"-";"-";"-";"-";"-";"-";"-";"-";"-";"-";"-";"-";"-";"-";"-"
"07 List 2024 23:02:13";"Koszty Utrzymania Pozycji";"O2-D9-9BZFRY";"-";"-";"USD/JPY";"-";"-";"-";"-";"-";"-";"-";"-";"-";"-";"-";"-";"30 000,00";"3,57703%";"11,68";"0,00";"-";"-";"-";"-";"-";"-";"-";"-";"-";"-";"-";"-";"-";"-";"-";"-";"-";"-"
"07 List 2024 23:02:13";"Koszty Utrzymania Pozycji";"O2-D9-9BH1F6";"-";"-";"USD/JPY";"-";"-";"-";"-";"-";"-";"-";"-";"-";"-";"-";"-";"9 000,00";"3,57703%";"3,50";"0,00";"-";"-";"-";"-";"-";"-";"-";"-";"-";"-";"-";"-";"-";"-";"-";"-";"-";"-"
"07 List 2024 23:02:13";"Koszty Utrzymania Pozycji";"O2-D9-9BJQLQ";"-";"-";"USD/JPY";"-";"-";"-";"-";"-";"-";"-";"-";"-";"-";"-";"-";"20 000,00";"3,57703%";"7,78";"0,00";"-";"-";"-";"-";"-";"-";"-";"-";"-";"-";"-";"-";"-";"-";"-";"-";"-";"-"
"07 List 2024 21:57:53";" Zmodyfikowano Transakcję Kupna";"O2-D9-9BZFRY";"T2-D9-5NE2H4";"-";"USD/JPY";"30 000 Jednost.";"153,140";"-";"-";"153,350";"-";"-";"-";"0,00";"-";"-";"-";"-";"-";"-";"-";"-";"-";"-";"-";"-";"-";"-";"-";"-";"-";"-";"-";"-";"-";"-";"-";"-";"-"
"07 List 2024 21:50:42";"Stop Loss";"O2-D9-9BZGJ1";"T2-D9-5NE7FG";"-";"USD/JPY";"27 000 Jednost.";"153,020";"-";"-";"-";"-";"0,02596";"108 343,95";"8,41";"6 981,64";"-";"-";"-";"-";"-";"-";"-";"-";"-";"-";"-";"-";"-";"-";"-";"-";"-";"-";"-";"-";"-";"-";"-";"-"
"07 List 2024 21:49:55";" Zmodyfikowano Transakcję Kupna";"O2-D9-9BZGJ1";"T2-D9-5NE32V";"-";"USD/JPY";"27 000 Jednost.";"153,008";"-";"153,020";"-";"-";"-";"-";"0,00";"-";"-";"-";"-";"-";"-";"-";"-";"-";"-";"-";"-";"-";"-";"-";"-";"-";"-";"-";"-";"-";"-";"-";"-";"-"
"07 List 2024 20:56:31";" Transakcja Kupna";"O2-D9-9BZGJ1";"T2-D9-5NE32V";"-";"USD/JPY";"27 000 Jednost.";"153,008";"-";"-";"-";"-";"4,017058";"108 460,56";"0,00";"-";"-";"-";"-";"-";"-";"-";"-";"-";"-";"-";"-";"-";"-";"-";"-";"-";"-";"-";"-";"-";"-";"-";"-";"-"
"07 List 2024 20:56:21";"Odrzucono Zlecenie: brak wystarczających środków";"O2-D9-9BZGHN";"-";"-";"USD/JPY";"30 000 Jednost.";"-";"-";"-";"-";"-";"-";"-";"-";"-";"-";"-";"-";"-";"-";"-";"-";"-";"-";"-";"-";"-";"-";"-";"-";"-";"-";"-";"-";"-";"-";"-";"-";"-"
"07 List 2024 20:49:45";" Transakcja Kupna";"O2-D9-9BZFRY";"T2-D9-5NE2H4";"-";"USD/JPY";"30 000 Jednost.";"153,140";"-";"-";"-";"-";"4,01801";"120 540,30";"0,00";"-";"-";"-";"-";"-";"-";"-";"-";"-";"-";"-";"-";"-";"-";"-";"-";"-";"-";"-";"-";"-";"-";"-";"-";"-"
"07 List 2024 20:44:24";"Stop Loss";"O2-D9-9BZ1ZK";"T2-D9-5NE1Z9";"-";"USD/JPY";"27 000 Jednost.";"153,300";"-";"-";"-";"-";"0,025989";"108 581,49";"70,17";"6 973,23";"-";"-";"-";"-";"-";"-";"-";"-";"-";"-";"-";"-";"-";"-";"-";"-";"-";"-";"-";"-";"-";"-";"-";"-"
"07 List 2024 20:43:58";"Stop Loss";"O2-D9-9BZEGP";"T2-D9-5NE1WH";"-";"USD/JPY";"27 000 Jednost.";"153,395";"-";"-";"-";"-";"0,025966";"108 662,39";"35,05";"6 903,06";"-";"-";"-";"-";"-";"-";"-";"-";"-";"-";"-";"-";"-";"-";"-";"-";"-";"-";"-";"-";"-";"-";"-";"-"
"07 List 2024 20:43:51";" Zmodyfikowano Transakcję Kupna";"O2-D9-9BZEGP";"T2-D9-5NE1D1";"-";"USD/JPY";"27 000 Jednost.";"153,345";"-";"153,400";"-";"-";"-";"-";"0,00";"-";"-";"-";"-";"-";"-";"-";"-";"-";"-";"-";"-";"-";"-";"-";"-";"-";"-";"-";"-";"-";"-";"-";"-";"-"
"07 List 2024 20:41:58";" Zmodyfikowano Transakcję Kupna";"O2-D9-9BZ1ZK";"T2-D9-5NDR26";"-";"USD/JPY";"27 000 Jednost.";"153,200";"-";"153,300";"-";"-";"-";"-";"0,00";"-";"-";"-";"-";"-";"-";"-";"-";"-";"-";"-";"-";"-";"-";"-";"-";"-";"-";"-";"-";"-";"-";"-";"-";"-"
"07 List 2024 20:40:44";" Transakcja Kupna";"O2-D9-9BZEGP";"T2-D9-5NE1D1";"-";"USD/JPY";"27 000 Jednost.";"153,345";"-";"-";"-";"-";"4,019122";"108 516,29";"0,00";"-";"-";"-";"-";"-";"-";"-";"-";"-";"-";"-";"-";"-";"-";"-";"-";"-";"-";"-";"-";"-";"-";"-";"-";"-"
"07 List 2024 17:21:53";" Transakcja Kupna";"O2-D9-9BZ1ZK";"T2-D9-5NDR26";"-";"USD/JPY";"27 000 Jednost.";"153,200";"-";"-";"-";"-";"4,019573";"108 528,47";"0,00";"-";"-";"-";"-";"-";"-";"-";"-";"-";"-";"-";"-";"-";"-";"-";"-";"-";"-";"-";"-";"-";"-";"-";"-";"-"
"07 List 2024 16:35:17";" Zamknięcie Transakcji";"O2-D9-9BYXKW";"T2-D9-5NDM8G";"O2-D9-9BLC3T";"USD/JPY";"1 000 Jednost.";"152,926";"-";"-";"-";"-";"0,025943";"4 006,90";"11,91";"6 868,01";"-";"-";"-";"-";"-";"-";"-";"-";"-";"-";"-";"-";"-";"-";"-";"-";"-";"-";"-";"-";"-";"-";"-";"-"
"07 List 2024 16:34:56";" Zamknięcie Transakcji";"O2-D9-9BYXJZ";"T2-D9-5NDM7D";"O2-D9-9BLC3T";"USD/JPY";"2 000 Jednost.";"152,907";"-";"-";"-";"-";"0,025939";"8 013,23";"22,83";"6 856,10";"-";"-";"-";"-";"-";"-";"-";"-";"-";"-";"-";"-";"-";"-";"-";"-";"-";"-";"-";"-";"-";"-";"-";"-"
"07 List 2024 16:34:24";" Zamknięcie Transakcji";"O2-D9-9BYXGH";"T2-D9-5NDM52";"O2-D9-9BLC3T";"USD/JPY";"2 000 Jednost.";"152,906";"-";"-";"-";"-";"0,025943";"8 013,37";"22,78";"6 833,27";"-";"-";"-";"-";"-";"-";"-";"-";"-";"-";"-";"-";"-";"-";"-";"-";"-";"-";"-";"-";"-";"-";"-";"-"
"07 List 2024 09:12:32";" Zamknięcie Transakcji";"O2-D9-9BXY96";"T2-D9-5NCSYY";"O2-D9-9BXX85";"USD/JPY";"25 000 Jednost.";"153,969";"-";"-";"-";"-";"0,0263215";"101 317,97";"-61,86";"6 810,49";"-";"-";"-";"-";"-";"-";"-";"-";"-";"-";"-";"-";"-";"-";"-";"-";"-";"-";"-";"-";"-";"-";"-";"-"
"07 List 2024 09:01:56";" Transakcja Kupna";"O2-D9-9BXX85";"T2-D9-5NCS4S";"-";"USD/JPY";"25 000 Jednost.";"154,063";"-";"-";"-";"-";"4,057939";"101 448,47";"0,00";"-";"-";"-";"-";"-";"-";"-";"-";"-";"-";"-";"-";"-";"-";"-";"-";"-";"-";"-";"-";"-";"-";"-";"-";"-"
"07 List 2024 08:49:03";" Zamknięcie Transakcji";"O2-D9-9BXWL0";"T2-D9-5NCRK6";"O2-D9-9BH1F6";"USD/JPY";"1 000 Jednost.";"153,846";"-";"-";"-";"-";"0,026104";"4 056,22";"9,61";"6 872,35";"-";"-";"-";"-";"-";"-";"-";"-";"-";"-";"-";"-";"-";"-";"-";"-";"-";"-";"-";"-";"-";"-";"-";"-"
"07 List 2024 08:44:50";" Zamknięcie Transakcji";"O2-D9-9BXWEV";"T2-D9-5NCRF2";"O2-D9-9BH1F6";"USD/JPY";"3 000 Jednost.";"153,801";"-";"-";"-";"-";"0,026098";"12 163,29";"25,29";"6 862,74";"-";"-";"-";"-";"-";"-";"-";"-";"-";"-";"-";"-";"-";"-";"-";"-";"-";"-";"-";"-";"-";"-";"-";"-"
"06 List 2024 23:02:06";"Koszty Utrzymania Pozycji";"1386106593";"-";"-";"Rachunek";"-";"-";"-";"-";"-";"-";"-";"-";"-86,63";"6 837,45";"-";"-";"-";"-";"-";"-86,63";"-";"-";"-";"-";"-";"-";"-";"-";"-";"-";"-";"-";"-";"-";"-";"-";"-";"-"
"06 List 2024 23:02:06";"Koszty Utrzymania Pozycji";"O2-D9-9BLC3T";"-";"-";"USD/JPY";"-";"-";"-";"-";"-";"-";"-";"-";"-";"-";"-";"-";"6 000,00";"3,82187%";"7,61";"0,00";"-";"-";"-";"-";"-";"-";"-";"-";"-";"-";"-";"-";"-";"-";"-";"-";"-";"-"
"06 List 2024 23:02:06";"Koszty Utrzymania Pozycji";"O2-D9-9BKRVE";"-";"-";"USD/JPY";"-";"-";"-";"-";"-";"-";"-";"-";"-";"-";"-";"-";"26 000,00";"3,82187%";"32,97";"0,00";"-";"-";"-";"-";"-";"-";"-";"-";"-";"-";"-";"-";"-";"-";"-";"-";"-";"-"
"06 List 2024 23:02:06";"Koszty Utrzymania Pozycji";"O2-D9-9BJZX7";"-";"-";"USD/JPY";"-";"-";"-";"-";"-";"-";"-";"-";"-";"-";"-";"-";"30 000,00";"5,86501%";"-58,97";"0,00";"-";"-";"-";"-";"-";"-";"-";"-";"-";"-";"-";"-";"-";"-";"-";"-";"-";"-"
"06 List 2024 23:02:06";"Koszty Utrzymania Pozycji";"O2-D9-9BH1F6";"-";"-";"USD/JPY";"-";"-";"-";"-";"-";"-";"-";"-";"-";"-";"-";"-";"13 000,00";"3,82187%";"16,49";"0,00";"-";"-";"-";"-";"-";"-";"-";"-";"-";"-";"-";"-";"-";"-";"-";"-";"-";"-"
"06 List 2024 23:02:06";"Koszty Utrzymania Pozycji";"O2-D9-9BB04B";"-";"-";"USD/JPY";"-";"-";"-";"-";"-";"-";"-";"-";"-";"-";"-";"-";"34 000,00";"5,86501%";"-66,84";"0,00";"-";"-";"-";"-";"-";"-";"-";"-";"-";"-";"-";"-";"-";"-";"-";"-";"-";"-"
"06 List 2024 23:02:06";"Koszty Utrzymania Pozycji";"O2-D9-9BS5RZ";"-";"-";"USD/JPY";"-";"-";"-";"-";"-";"-";"-";"-";"-";"-";"-";"-";"22 000,00";"5,86501%";"-43,25";"0,00";"-";"-";"-";"-";"-";"-";"-";"-";"-";"-";"-";"-";"-";"-";"-";"-";"-";"-"
"06 List 2024 23:02:06";"Koszty Utrzymania Pozycji";"O2-D9-9BJQLQ";"-";"-";"USD/JPY";"-";"-";"-";"-";"-";"-";"-";"-";"-";"-";"-";"-";"20 000,00";"3,82187%";"25,36";"0,00";"-";"-";"-";"-";"-";"-";"-";"-";"-";"-";"-";"-";"-";"-";"-";"-";"-";"-"
"06 List 2024 16:42:09";" Zamknięcie Transakcji";"O2-D9-9BWPFK";"T2-D9-5NBRWN";"O2-D9-9BH1F6";"USD/JPY";"13 000 Jednost.";"154,234";"-";"-";"-";"-";"0,026205";"53 075,86";"257,54";"6 924,08";"-";"-";"-";"-";"-";"-";"-";"-";"-";"-";"-";"-";"-";"-";"-";"-";"-";"-";"-";"-";"-";"-";"-";"-"
"06 List 2024 16:19:23";" Wpłata";"1385982618";"BD.71324115";"-";"Rachunek";"-";"-";"-";"-";"-";"-";"-";"-";"2 500,00";"6 666,54";"2 500,00";"0,00";"-";"-";"-";"-";"-";"-";"-";"-";"-";"-";"-";"-";"-";"-";"-";"-";"-";"-";"-";"-";"-";"-"
"05 List 2024 23:02:08";"Koszty Utrzymania Pozycji";"1385548663";"-";"-";"Rachunek";"-";"-";"-";"-";"-";"-";"-";"-";"-22,95";"4 166,54";"-";"-";"-";"-";"-";"-22,95";"-";"-";"-";"-";"-";"-";"-";"-";"-";"-";"-";"-";"-";"-";"-";"-";"-";"-"
"05 List 2024 23:02:08";"Koszty Utrzymania Pozycji";"O2-D9-9BLC3T";"-";"-";"USD/JPY";"-";"-";"-";"-";"-";"-";"-";"-";"-";"-";"-";"-";"6 000,00";"3,82187%";"2,49";"0,00";"-";"-";"-";"-";"-";"-";"-";"-";"-";"-";"-";"-";"-";"-";"-";"-";"-";"-"
"05 List 2024 23:02:08";"Koszty Utrzymania Pozycji";"O2-D9-9BH1F6";"-";"-";"USD/JPY";"-";"-";"-";"-";"-";"-";"-";"-";"-";"-";"-";"-";"26 000,00";"3,82187%";"10,79";"0,00";"-";"-";"-";"-";"-";"-";"-";"-";"-";"-";"-";"-";"-";"-";"-";"-";"-";"-"
"05 List 2024 23:02:08";"Koszty Utrzymania Pozycji";"O2-D9-9BKRVE";"-";"-";"USD/JPY";"-";"-";"-";"-";"-";"-";"-";"-";"-";"-";"-";"-";"26 000,00";"3,82187%";"10,79";"0,00";"-";"-";"-";"-";"-";"-";"-";"-";"-";"-";"-";"-";"-";"-";"-";"-";"-";"-"
"05 List 2024 23:02:08";"Koszty Utrzymania Pozycji";"O2-D9-9BJZX7";"-";"-";"USD/JPY";"-";"-";"-";"-";"-";"-";"-";"-";"-";"-";"-";"-";"30 000,00";"5,86501%";"-19,30";"0,00";"-";"-";"-";"-";"-";"-";"-";"-";"-";"-";"-";"-";"-";"-";"-";"-";"-";"-"
"05 List 2024 23:02:08";"Koszty Utrzymania Pozycji";"O2-D9-9BB04B";"-";"-";"USD/JPY";"-";"-";"-";"-";"-";"-";"-";"-";"-";"-";"-";"-";"34 000,00";"5,86501%";"-21,87";"0,00";"-";"-";"-";"-";"-";"-";"-";"-";"-";"-";"-";"-";"-";"-";"-";"-";"-";"-"
"05 List 2024 23:02:08";"Koszty Utrzymania Pozycji";"O2-D9-9BS5RZ";"-";"-";"USD/JPY";"-";"-";"-";"-";"-";"-";"-";"-";"-";"-";"-";"-";"22 000,00";"5,86501%";"-14,15";"0,00";"-";"-";"-";"-";"-";"-";"-";"-";"-";"-";"-";"-";"-";"-";"-";"-";"-";"-"
"05 List 2024 23:02:08";"Koszty Utrzymania Pozycji";"O2-D9-9BJQLQ";"-";"-";"USD/JPY";"-";"-";"-";"-";"-";"-";"-";"-";"-";"-";"-";"-";"20 000,00";"3,82187%";"8,30";"0,00";"-";"-";"-";"-";"-";"-";"-";"-";"-";"-";"-";"-";"-";"-";"-";"-";"-";"-"
"05 List 2024 19:20:03";"Transakcja Sprzedaży";"O2-D9-9BS5RZ";"T2-D9-5N8226";"-";"USD/JPY";"22 000 Jednost.";"151,428";"-";"-";"-";"-";"4,003821";"88 084,06";"0,00";"-";"-";"-";"-";"-";"-";"-";"-";"-";"-";"-";"-";"-";"-";"-";"-";"-";"-";"-";"-";"-";"-";"-";"-";"-"
"05 List 2024 18:43:35";"Stop Loss";"O2-D9-9BS3MQ";"T2-D9-5N808V";"-";"USD/JPY";"25 000 Jednost.";"151,630";"-";"-";"-";"-";"0,026164";"100 165,92";"16,35";"4 189,49";"-";"-";"-";"-";"-";"-";"-";"-";"-";"-";"-";"-";"-";"-";"-";"-";"-";"-";"-";"-";"-";"-";"-";"-"
"05 List 2024 18:42:53";"Zmodyfikowano Transakcję Sprzedaży";"O2-D9-9BS3MQ";"T2-D9-5N803Y";"-";"USD/JPY";"25 000 Jednost.";"151,655";"-";"151,630";"-";"-";"-";"-";"0,00";"-";"-";"-";"-";"-";"-";"-";"-";"-";"-";"-";"-";"-";"-";"-";"-";"-";"-";"-";"-";"-";"-";"-";"-";"-"
"05 List 2024 18:39:13";" Zmodyfikowano Transakcję Kupna";"O2-D9-9BJQLQ";"T2-D9-5N1XB7";"-";"USD/JPY";"20 000 Jednost.";"152,970";"-";"-";"-";"-";"-";"-";"0,00";"-";"-";"-";"-";"-";"-";"-";"-";"-";"-";"-";"-";"-";"-";"-";"-";"-";"-";"-";"-";"-";"-";"-";"-";"-"
"05 List 2024 18:38:33";"Transakcja Sprzedaży";"O2-D9-9BS3MQ";"T2-D9-5N803Y";"-";"USD/JPY";"25 000 Jednost.";"151,655";"-";"-";"-";"-";"4,007459";"100 186,47";"0,00";"-";"-";"-";"-";"-";"-";"-";"-";"-";"-";"-";"-";"-";"-";"-";"-";"-";"-";"-";"-";"-";"-";"-";"-";"-"
"04 List 2024 23:02:06";"Koszty Utrzymania Pozycji";"1385238918";"-";"-";"Rachunek";"-";"-";"-";"-";"-";"-";"-";"-";"-8,84";"4 173,14";"-";"-";"-";"-";"-";"-8,84";"-";"-";"-";"-";"-";"-";"-";"-";"-";"-";"-";"-";"-";"-";"-";"-";"-";"-"
"04 List 2024 23:02:06";"Koszty Utrzymania Pozycji";"O2-D9-9BLC3T";"-";"-";"USD/JPY";"-";"-";"-";"-";"-";"-";"-";"-";"-";"-";"-";"-";"6 000,00";"3,82187%";"2,50";"0,00";"-";"-";"-";"-";"-";"-";"-";"-";"-";"-";"-";"-";"-";"-";"-";"-";"-";"-"
"04 List 2024 23:02:06";"Koszty Utrzymania Pozycji";"O2-D9-9BH1F6";"-";"-";"USD/JPY";"-";"-";"-";"-";"-";"-";"-";"-";"-";"-";"-";"-";"26 000,00";"3,82187%";"10,85";"0,00";"-";"-";"-";"-";"-";"-";"-";"-";"-";"-";"-";"-";"-";"-";"-";"-";"-";"-"
"04 List 2024 23:02:06";"Koszty Utrzymania Pozycji";"O2-D9-9BKRVE";"-";"-";"USD/JPY";"-";"-";"-";"-";"-";"-";"-";"-";"-";"-";"-";"-";"26 000,00";"3,82187%";"10,85";"0,00";"-";"-";"-";"-";"-";"-";"-";"-";"-";"-";"-";"-";"-";"-";"-";"-";"-";"-"
"04 List 2024 23:02:06";"Koszty Utrzymania Pozycji";"O2-D9-9BJZX7";"-";"-";"USD/JPY";"-";"-";"-";"-";"-";"-";"-";"-";"-";"-";"-";"-";"30 000,00";"5,86501%";"-19,40";"0,00";"-";"-";"-";"-";"-";"-";"-";"-";"-";"-";"-";"-";"-";"-";"-";"-";"-";"-"
"04 List 2024 23:02:06";"Koszty Utrzymania Pozycji";"O2-D9-9BB04B";"-";"-";"USD/JPY";"-";"-";"-";"-";"-";"-";"-";"-";"-";"-";"-";"-";"34 000,00";"5,86501%";"-21,99";"0,00";"-";"-";"-";"-";"-";"-";"-";"-";"-";"-";"-";"-";"-";"-";"-";"-";"-";"-"
"04 List 2024 23:02:06";"Koszty Utrzymania Pozycji";"O2-D9-9BJQLQ";"-";"-";"USD/JPY";"-";"-";"-";"-";"-";"-";"-";"-";"-";"-";"-";"-";"20 000,00";"3,82187%";"8,35";"0,00";"-";"-";"-";"-";"-";"-";"-";"-";"-";"-";"-";"-";"-";"-";"-";"-";"-";"-"
"04 List 2024 22:47:29";" Zmodyfikowano Transakcję Kupna";"O2-D9-9BJQLQ";"T2-D9-5N1XB7";"-";"USD/JPY";"20 000 Jednost.";"152,970";"-";"-";"153,100";"-";"-";"-";"0,00";"-";"-";"-";"-";"-";"-";"-";"-";"-";"-";"-";"-";"-";"-";"-";"-";"-";"-";"-";"-";"-";"-";"-";"-";"-"
"04 List 2024 09:32:06";"Stop Loss";"O2-D9-9BJSN4";"T2-D9-5N5QWZ";"-";"USD/JPY";"27 000 Jednost.";"152,050";"-";"-";"-";"-";"0,026148";"108 407,80";"35,30";"4 181,98";"-";"-";"-";"-";"-";"-";"-";"-";"-";"-";"-";"-";"-";"-";"-";"-";"-";"-";"-";"-";"-";"-";"-";"-"
"04 List 2024 09:31:11";"Zmodyfikowano Stop Loss";"O2-D9-9BJSN4";"-";"O2-D9-9BPBQG";"USD/JPY";"27 000 Jednost.";"152,100";"-";"152,050";"-";"-";"-";"-";"-";"-";"-";"-";"-";"-";"-";"-";"-";"-";"-";"-";"-";"-";"-";"-";"-";"-";"-";"-";"-";"-";"-";"-";"-";"-"
"04 List 2024 09:28:47";"Zmodyfikowano Transakcję Sprzedaży";"O2-D9-9BJSN4";"T2-D9-5N1YL7";"-";"USD/JPY";"27 000 Jednost.";"152,100";"-";"152,080";"-";"-";"-";"-";"0,00";"-";"-";"-";"-";"-";"-";"-";"-";"-";"-";"-";"-";"-";"-";"-";"-";"-";"-";"-";"-";"-";"-";"-";"-";"-"
"01 List 2024 22:02:03";"Koszty Utrzymania Pozycji";"1384905734";"-";"-";"Rachunek";"-";"-";"-";"-";"-";"-";"-";"-";"-26,45";"4 146,68";"-";"-";"-";"-";"-";"-26,45";"-";"-";"-";"-";"-";"-";"-";"-";"-";"-";"-";"-";"-";"-";"-";"-";"-";"-"
"01 List 2024 22:02:03";"Koszty Utrzymania Pozycji";"O2-D9-9BJZX7";"-";"-";"USD/JPY";"-";"-";"-";"-";"-";"-";"-";"-";"-";"-";"-";"-";"30 000,00";"5,86501%";"-19,51";"0,00";"-";"-";"-";"-";"-";"-";"-";"-";"-";"-";"-";"-";"-";"-";"-";"-";"-";"-"
"01 List 2024 22:02:03";"Koszty Utrzymania Pozycji";"O2-D9-9BB04B";"-";"-";"USD/JPY";"-";"-";"-";"-";"-";"-";"-";"-";"-";"-";"-";"-";"34 000,00";"5,86501%";"-22,11";"0,00";"-";"-";"-";"-";"-";"-";"-";"-";"-";"-";"-";"-";"-";"-";"-";"-";"-";"-"
"01 List 2024 22:02:03";"Koszty Utrzymania Pozycji";"O2-D9-9BJQLQ";"-";"-";"USD/JPY";"-";"-";"-";"-";"-";"-";"-";"-";"-";"-";"-";"-";"20 000,00";"3,82187%";"8,39";"0,00";"-";"-";"-";"-";"-";"-";"-";"-";"-";"-";"-";"-";"-";"-";"-";"-";"-";"-"
"01 List 2024 22:02:03";"Koszty Utrzymania Pozycji";"O2-D9-9BLC3T";"-";"-";"USD/JPY";"-";"-";"-";"-";"-";"-";"-";"-";"-";"-";"-";"-";"6 000,00";"3,82187%";"2,52";"0,00";"-";"-";"-";"-";"-";"-";"-";"-";"-";"-";"-";"-";"-";"-";"-";"-";"-";"-"
"01 List 2024 22:02:03";"Koszty Utrzymania Pozycji";"O2-D9-9BJSN4";"-";"-";"USD/JPY";"-";"-";"-";"-";"-";"-";"-";"-";"-";"-";"-";"-";"27 000,00";"5,86501%";"-17,56";"0,00";"-";"-";"-";"-";"-";"-";"-";"-";"-";"-";"-";"-";"-";"-";"-";"-";"-";"-"
"01 List 2024 22:02:03";"Koszty Utrzymania Pozycji";"O2-D9-9BH1F6";"-";"-";"USD/JPY";"-";"-";"-";"-";"-";"-";"-";"-";"-";"-";"-";"-";"26 000,00";"3,82187%";"10,91";"0,00";"-";"-";"-";"-";"-";"-";"-";"-";"-";"-";"-";"-";"-";"-";"-";"-";"-";"-"
"01 List 2024 22:02:03";"Koszty Utrzymania Pozycji";"O2-D9-9BKRVE";"-";"-";"USD/JPY";"-";"-";"-";"-";"-";"-";"-";"-";"-";"-";"-";"-";"26 000,00";"3,82187%";"10,91";"0,00";"-";"-";"-";"-";"-";"-";"-";"-";"-";"-";"-";"-";"-";"-";"-";"-";"-";"-"
"01 List 2024 16:18:53";" Zamknięcie Transakcji";"O2-D9-9BN8JV";"T2-D9-5N4T0P";"O2-D9-9BJQR9";"USD/JPY";"3 000 Jednost.";"152,890";"-";"-";"-";"-";"0,026118";"12 099,87";"1,41";"4 173,13";"-";"-";"-";"-";"-";"-";"-";"-";"-";"-";"-";"-";"-";"-";"-";"-";"-";"-";"-";"-";"-";"-";"-";"-"
"01 List 2024 15:05:52";"Stop Loss";"O2-D9-9BMXLF";"T2-D9-5N4JJ3";"-";"USD/JPY";"20 000 Jednost.";"152,700";"-";"-";"-";"-";"0,026136";"80 636,14";"117,61";"4 171,72";"-";"-";"-";"-";"-";"-";"-";"-";"-";"-";"-";"-";"-";"-";"-";"-";"-";"-";"-";"-";"-";"-";"-";"-"
"01 List 2024 15:04:02";"Zmodyfikowano Stop Loss";"O2-D9-9BMXLF";"-";"O2-D9-9BMYK3";"USD/JPY";"20 000 Jednost.";"152,475";"-";"152,700";"-";"-";"-";"-";"-";"-";"-";"-";"-";"-";"-";"-";"-";"-";"-";"-";"-";"-";"-";"-";"-";"-";"-";"-";"-";"-";"-";"-";"-";"-"
"01 List 2024 15:03:34";"Zmodyfikowano Stop Loss";"O2-D9-9BMXLF";"-";"O2-D9-9BMYK3";"USD/JPY";"20 000 Jednost.";"152,475";"-";"152,650";"-";"-";"-";"-";"-";"-";"-";"-";"-";"-";"-";"-";"-";"-";"-";"-";"-";"-";"-";"-";"-";"-";"-";"-";"-";"-";"-";"-";"-";"-"
"01 List 2024 15:02:54";"Zmodyfikowano Stop Loss";"O2-D9-9BMXLF";"-";"O2-D9-9BMYK3";"USD/JPY";"20 000 Jednost.";"152,475";"-";"152,620";"-";"-";"-";"-";"-";"-";"-";"-";"-";"-";"-";"-";"-";"-";"-";"-";"-";"-";"-";"-";"-";"-";"-";"-";"-";"-";"-";"-";"-";"-"
"01 List 2024 15:02:31";" Zmodyfikowano Transakcję Kupna";"O2-D9-9BMXLF";"T2-D9-5N4H7Z";"-";"USD/JPY";"20 000 Jednost.";"152,475";"-";"152,550";"-";"-";"-";"-";"0,00";"-";"-";"-";"-";"-";"-";"-";"-";"-";"-";"-";"-";"-";"-";"-";"-";"-";"-";"-";"-";"-";"-";"-";"-";"-"
"01 List 2024 14:53:50";" Transakcja Kupna";"O2-D9-9BMXLF";"T2-D9-5N4H7Z";"-";"USD/JPY";"20 000 Jednost.";"152,475";"-";"-";"-";"-";"4,028811";"80 576,22";"0,00";"-";"-";"-";"-";"-";"-";"-";"-";"-";"-";"-";"-";"-";"-";"-";"-";"-";"-";"-";"-";"-";"-";"-";"-";"-"
"01 List 2024 11:47:01";" Zamknięcie Transakcji";"O2-D9-9BMFW2";"T2-D9-5N44D1";"O2-D9-9BLC3T";"USD/JPY";"1 000 Jednost.";"152,734";"-";"-";"-";"-";"0,026173";"4 038,06";"6,99";"4 054,11";"-";"-";"-";"-";"-";"-";"-";"-";"-";"-";"-";"-";"-";"-";"-";"-";"-";"-";"-";"-";"-";"-";"-";"-"
"01 List 2024 09:53:34";" Zamknięcie Transakcji";"O2-D9-9BMCCS";"T2-D9-5N41JK";"O2-D9-9BLC3T";"USD/JPY";"20 000 Jednost.";"152,655";"-";"-";"-";"-";"0,026133";"80 587,44";"98,26";"4 047,12";"-";"-";"-";"-";"-";"-";"-";"-";"-";"-";"-";"-";"-";"-";"-";"-";"-";"-";"-";"-";"-";"-";"-";"-"
"31 Paź 2024 22:42:34";" Zamknięcie Transakcji";"O2-D9-9BLSWW";"T2-D9-5N3NKG";"O2-D9-9BJSN4";"USD/JPY";"1 000 Jednost.";"152,045";"-";"-";"-";"-";"0,02617";"4 018,11";"1,44";"3 948,86";"-";"-";"-";"-";"-";"-";"-";"-";"-";"-";"-";"-";"-";"-";"-";"-";"-";"-";"-";"-";"-";"-";"-";"-"
"31 Paź 2024 22:02:09";"Koszty Utrzymania Pozycji";"1384583253";"-";"-";"Rachunek";"-";"-";"-";"-";"-";"-";"-";"-";"-16,81";"3 947,42";"-";"-";"-";"-";"-";"-16,81";"-";"-";"-";"-";"-";"-";"-";"-";"-";"-";"-";"-";"-";"-";"-";"-";"-";"-"
"31 Paź 2024 22:02:09";"Koszty Utrzymania Pozycji";"O2-D9-9BJQR9";"-";"-";"USD/JPY";"-";"-";"-";"-";"-";"-";"-";"-";"-";"-";"-";"-";"3 000,00";"3,83148%";"1,25";"0,00";"-";"-";"-";"-";"-";"-";"-";"-";"-";"-";"-";"-";"-";"-";"-";"-";"-";"-"
"31 Paź 2024 22:02:09";"Koszty Utrzymania Pozycji";"O2-D9-9BJSN4";"-";"-";"USD/JPY";"-";"-";"-";"-";"-";"-";"-";"-";"-";"-";"-";"-";"28 000,00";"5,86507%";"-18,09";"0,00";"-";"-";"-";"-";"-";"-";"-";"-";"-";"-";"-";"-";"-";"-";"-";"-";"-";"-"
"31 Paź 2024 22:02:09";"Koszty Utrzymania Pozycji";"O2-D9-9BH1F6";"-";"-";"USD/JPY";"-";"-";"-";"-";"-";"-";"-";"-";"-";"-";"-";"-";"26 000,00";"3,83148%";"10,87";"0,00";"-";"-";"-";"-";"-";"-";"-";"-";"-";"-";"-";"-";"-";"-";"-";"-";"-";"-"
"31 Paź 2024 22:02:09";"Koszty Utrzymania Pozycji";"O2-D9-9BKRVE";"-";"-";"USD/JPY";"-";"-";"-";"-";"-";"-";"-";"-";"-";"-";"-";"-";"26 000,00";"3,83148%";"10,87";"0,00";"-";"-";"-";"-";"-";"-";"-";"-";"-";"-";"-";"-";"-";"-";"-";"-";"-";"-"
"31 Paź 2024 22:02:09";"Koszty Utrzymania Pozycji";"O2-D9-9BJZX7";"-";"-";"USD/JPY";"-";"-";"-";"-";"-";"-";"-";"-";"-";"-";"-";"-";"30 000,00";"5,86507%";"-19,38";"0,00";"-";"-";"-";"-";"-";"-";"-";"-";"-";"-";"-";"-";"-";"-";"-";"-";"-";"-"
"31 Paź 2024 22:02:09";"Koszty Utrzymania Pozycji";"O2-D9-9BB04B";"-";"-";"USD/JPY";"-";"-";"-";"-";"-";"-";"-";"-";"-";"-";"-";"-";"34 000,00";"5,86507%";"-21,97";"0,00";"-";"-";"-";"-";"-";"-";"-";"-";"-";"-";"-";"-";"-";"-";"-";"-";"-";"-"
"31 Paź 2024 22:02:09";"Koszty Utrzymania Pozycji";"O2-D9-9BJQLQ";"-";"-";"USD/JPY";"-";"-";"-";"-";"-";"-";"-";"-";"-";"-";"-";"-";"20 000,00";"3,83148%";"8,36";"0,00";"-";"-";"-";"-";"-";"-";"-";"-";"-";"-";"-";"-";"-";"-";"-";"-";"-";"-"
"31 Paź 2024 22:02:09";"Koszty Utrzymania Pozycji";"O2-D9-9BLC3T";"-";"-";"USD/JPY";"-";"-";"-";"-";"-";"-";"-";"-";"-";"-";"-";"-";"27 000,00";"3,83148%";"11,28";"0,00";"-";"-";"-";"-";"-";"-";"-";"-";"-";"-";"-";"-";"-";"-";"-";"-";"-";"-"
"31 Paź 2024 17:34:26";"Zmodyfikowano Transakcję Sprzedaży";"O2-D9-9BJSN4";"T2-D9-5N1YL7";"-";"USD/JPY";"28 000 Jednost.";"152,100";"-";"-";"-";"-";"-";"-";"0,00";"-";"-";"-";"-";"-";"-";"-";"-";"-";"-";"-";"-";"-";"-";"-";"-";"-";"-";"-";"-";"-";"-";"-";"-";"-"
"31 Paź 2024 17:34:18";" Transakcja Kupna";"O2-D9-9BLC3T";"T2-D9-5N382P";"-";"USD/JPY";"27 000 Jednost.";"152,467";"-";"-";"-";"-";"4,026927";"108 727,02";"0,00";"-";"-";"-";"-";"-";"-";"-";"-";"-";"-";"-";"-";"-";"-";"-";"-";"-";"-";"-";"-";"-";"-";"-";"-";"-"
"31 Paź 2024 17:27:16";"Zmodyfikowano Transakcję Sprzedaży";"O2-D9-9BJSN4";"T2-D9-5N1YL7";"-";"USD/JPY";"28 000 Jednost.";"152,100";"-";"-";"152,060";"-";"-";"-";"0,00";"-";"-";"-";"-";"-";"-";"-";"-";"-";"-";"-";"-";"-";"-";"-";"-";"-";"-";"-";"-";"-";"-";"-";"-";"-"
"31 Paź 2024 17:26:28";"Stop Loss";"O2-D9-9BL83K";"T2-D9-5N37L1";"-";"USD/JPY";"28 000 Jednost.";"152,380";"-";"-";"-";"-";"0,026166";"112 773,05";"27,84";"3 964,23";"-";"-";"-";"-";"-";"-";"-";"-";"-";"-";"-";"-";"-";"-";"-";"-";"-";"-";"-";"-";"-";"-";"-";"-"
"31 Paź 2024 17:24:26";" Zmodyfikowano Transakcję Kupna";"O2-D9-9BL83K";"T2-D9-5N35HY";"-";"USD/JPY";"28 000 Jednost.";"152,342";"-";"152,380";"-";"-";"-";"-";"0,00";"-";"-";"-";"-";"-";"-";"-";"-";"-";"-";"-";"-";"-";"-";"-";"-";"-";"-";"-";"-";"-";"-";"-";"-";"-"
"31 Paź 2024 16:58:49";" Transakcja Kupna";"O2-D9-9BL83K";"T2-D9-5N35HY";"-";"USD/JPY";"28 000 Jednost.";"152,342";"-";"-";"-";"-";"4,028741";"112 804,74";"0,00";"-";"-";"-";"-";"-";"-";"-";"-";"-";"-";"-";"-";"-";"-";"-";"-";"-";"-";"-";"-";"-";"-";"-";"-";"-"
"31 Paź 2024 15:27:55";" Zamknięcie Transakcji";"O2-D9-9BKWW5";"T2-D9-5N2V6S";"O2-D9-9BJWL8";"USD/JPY";"27 000 Jednost.";"152,633";"-";"-";"-";"-";"0,026089";"108 606,63";"197,94";"3 936,39";"-";"-";"-";"-";"-";"-";"-";"-";"-";"-";"-";"-";"-";"-";"-";"-";"-";"-";"-";"-";"-";"-";"-";"-"
"31 Paź 2024 15:04:14";" Transakcja Kupna";"O2-D9-9BKRVE";"T2-D9-5N2QN7";"-";"USD/JPY";"26 000 Jednost.";"153,051";"-";"-";"-";"-";"4,027529";"104 715,75";"0,00";"-";"-";"-";"-";"-";"-";"-";"-";"-";"-";"-";"-";"-";"-";"-";"-";"-";"-";"-";"-";"-";"-";"-";"-";"-"
"31 Paź 2024 12:41:32";"Stop Loss";"O2-D9-9BK8W9";"T2-D9-5N2BLL";"-";"USD/JPY";"27 000 Jednost.";"152,800";"-";"-";"-";"-";"0,026097";"108 752,19";"33,82";"3 738,45";"-";"-";"-";"-";"-";"-";"-";"-";"-";"-";"-";"-";"-";"-";"-";"-";"-";"-";"-";"-";"-";"-";"-";"-"
"31 Paź 2024 12:38:50";"Zmodyfikowano Stop Loss";"O2-D9-9BK8W9";"-";"O2-D9-9BK94Q";"USD/JPY";"27 000 Jednost.";"152,752";"-";"152,800";"-";"-";"-";"-";"-";"-";"-";"-";"-";"-";"-";"-";"-";"-";"-";"-";"-";"-";"-";"-";"-";"-";"-";"-";"-";"-";"-";"-";"-";"-"
"31 Paź 2024 12:34:13";" Zmodyfikowano Transakcję Kupna";"O2-D9-9BK8W9";"T2-D9-5N2B5P";"-";"USD/JPY";"27 000 Jednost.";"152,752";"-";"152,770";"-";"-";"-";"-";"0,00";"-";"-";"-";"-";"-";"-";"-";"-";"-";"-";"-";"-";"-";"-";"-";"-";"-";"-";"-";"-";"-";"-";"-";"-";"-"
"31 Paź 2024 12:27:35";" Transakcja Kupna";"O2-D9-9BK8W9";"T2-D9-5N2B5P";"-";"USD/JPY";"27 000 Jednost.";"152,752";"-";"-";"-";"-";"4,026787";"108 723,24";"0,00";"-";"-";"-";"-";"-";"-";"-";"-";"-";"-";"-";"-";"-";"-";"-";"-";"-";"-";"-";"-";"-";"-";"-";"-";"-"
"31 Paź 2024 11:00:47";"Stop Loss";"O2-D9-9BK3P2";"T2-D9-5N270R";"-";"USD/JPY";"28 000 Jednost.";"152,520";"-";"-";"-";"-";"0,026133";"112 742,75";"79,76";"3 704,63";"-";"-";"-";"-";"-";"-";"-";"-";"-";"-";"-";"-";"-";"-";"-";"-";"-";"-";"-";"-";"-";"-";"-";"-"
"31 Paź 2024 10:59:03";"Zmodyfikowano Stop Loss";"O2-D9-9BK3P2";"-";"O2-D9-9BK49P";"USD/JPY";"28 000 Jednost.";"152,411";"-";"152,520";"-";"-";"-";"-";"-";"-";"-";"-";"-";"-";"-";"-";"-";"-";"-";"-";"-";"-";"-";"-";"-";"-";"-";"-";"-";"-";"-";"-";"-";"-"
"31 Paź 2024 10:58:01";" Zmodyfikowano Transakcję Kupna";"O2-D9-9BK3P2";"T2-D9-5N26G4";"-";"USD/JPY";"28 000 Jednost.";"152,411";"-";"152,460";"-";"-";"-";"-";"0,00";"-";"-";"-";"-";"-";"-";"-";"-";"-";"-";"-";"-";"-";"-";"-";"-";"-";"-";"-";"-";"-";"-";"-";"-";"-"
"31 Paź 2024 10:46:36";" Transakcja Kupna";"O2-D9-9BK3P2";"T2-D9-5N26G4";"-";"USD/JPY";"28 000 Jednost.";"152,411";"-";"-";"-";"-";"4,02802";"112 784,56";"0,00";"-";"-";"-";"-";"-";"-";"-";"-";"-";"-";"-";"-";"-";"-";"-";"-";"-";"-";"-";"-";"-";"-";"-";"-";"-"
"31 Paź 2024 10:36:56";" Zamknięcie Transakcji";"O2-D9-9BK35X";"T2-D9-5N2628";"O2-D9-9BJWL8";"USD/JPY";"3 000 Jednost.";"152,463";"-";"-";"-";"-";"0,026162";"12 087,30";"8,71";"3 624,87";"-";"-";"-";"-";"-";"-";"-";"-";"-";"-";"-";"-";"-";"-";"-";"-";"-";"-";"-";"-";"-";"-";"-";"-"
"31 Paź 2024 09:59:45";"Stop Loss";"O2-D9-9BJT81";"T2-D9-5N24P8";"-";"USD/JPY";"20 000 Jednost.";"152,390";"-";"-";"-";"-";"0,026188";"80 628,52";"9,95";"3 616,16";"-";"-";"-";"-";"-";"-";"-";"-";"-";"-";"-";"-";"-";"-";"-";"-";"-";"-";"-";"-";"-";"-";"-";"-"
"31 Paź 2024 09:57:34";" Zmodyfikowano Transakcję Kupna";"O2-D9-9BJT81";"T2-D9-5N1Z1R";"-";"USD/JPY";"20 000 Jednost.";"152,371";"-";"152,390";"-";"-";"-";"-";"0,00";"-";"-";"-";"-";"-";"-";"-";"-";"-";"-";"-";"-";"-";"-";"-";"-";"-";"-";"-";"-";"-";"-";"-";"-";"-"
"31 Paź 2024 09:43:10";" Zamknięcie Transakcji";"O2-D9-9BK0JC";"T2-D9-5N23TZ";"O2-D9-9BJTDS";"USD/JPY";"19 000 Jednost.";"152,190";"-";"-";"-";"-";"0,026221";"76 586,24";"26,90";"3 606,21";"-";"-";"-";"-";"-";"-";"-";"-";"-";"-";"-";"-";"-";"-";"-";"-";"-";"-";"-";"-";"-";"-";"-";"-"
"31 Paź 2024 09:31:38";"Transakcja Sprzedaży";"O2-D9-9BJZX7";"T2-D9-5N239Y";"-";"USD/JPY";"30 000 Jednost.";"151,960";"-";"-";"-";"-";"4,030374";"120 911,22";"0,00";"-";"-";"-";"-";"-";"-";"-";"-";"-";"-";"-";"-";"-";"-";"-";"-";"-";"-";"-";"-";"-";"-";"-";"-";"-"
"31 Paź 2024 09:06:35";" Zamknięcie Transakcji";"O2-D9-9BJXXL";"T2-D9-5N21PL";"O2-D9-9BJTDS";"USD/JPY";"5 000 Jednost.";"152,155";"-";"-";"-";"-";"0,026242";"20 161,34";"11,68";"3 579,31";"-";"-";"-";"-";"-";"-";"-";"-";"-";"-";"-";"-";"-";"-";"-";"-";"-";"-";"-";"-";"-";"-";"-";"-"
"31 Paź 2024 08:50:30";" Transakcja Kupna";"O2-D9-9BJWL8";"T2-D9-5N20JQ";"-";"USD/JPY";"30 000 Jednost.";"152,352";"-";"-";"-";"-";"4,027238";"120 817,14";"0,00";"-";"-";"-";"-";"-";"-";"-";"-";"-";"-";"-";"-";"-";"-";"-";"-";"-";"-";"-";"-";"-";"-";"-";"-";"-"
"31 Paź 2024 08:34:26";" Zamknięcie Transakcji";"O2-D9-9BJVGX";"T2-D9-5N1ZX8";"O2-D9-9BJT81";"USD/JPY";"5 000 Jednost.";"152,413";"-";"-";"-";"-";"0,026166";"20 141,75";"5,49";"3 567,63";"-";"-";"-";"-";"-";"-";"-";"-";"-";"-";"-";"-";"-";"-";"-";"-";"-";"-";"-";"-";"-";"-";"-";"-"
"31 Paź 2024 08:13:24";"Transakcja Sprzedaży";"O2-D9-9BJTDS";"T2-D9-5N1Z60";"-";"USD/JPY";"24 000 Jednost.";"152,244";"-";"-";"-";"-";"4,031757";"96 762,16";"0,00";"-";"-";"-";"-";"-";"-";"-";"-";"-";"-";"-";"-";"-";"-";"-";"-";"-";"-";"-";"-";"-";"-";"-";"-";"-"
"31 Paź 2024 08:13:11";"Odrzucono Zlecenie: brak wystarczających środków";"O2-D9-9BJTD9";"-";"-";"USD/JPY";"25 000 Jednost.";"-";"-";"-";"-";"-";"-";"-";"-";"-";"-";"-";"-";"-";"-";"-";"-";"-";"-";"-";"-";"-";"-";"-";"-";"-";"-";"-";"-";"-";"-";"-";"-";"-"
"31 Paź 2024 08:11:55";" Transakcja Kupna";"O2-D9-9BJT81";"T2-D9-5N1Z1R";"-";"USD/JPY";"25 000 Jednost.";"152,371";"-";"-";"-";"-";"4,031476";"100 786,90";"0,00";"-";"-";"-";"-";"-";"-";"-";"-";"-";"-";"-";"-";"-";"-";"-";"-";"-";"-";"-";"-";"-";"-";"-";"-";"-"
"31 Paź 2024 08:03:33";"Transakcja Sprzedaży";"O2-D9-9BJSN4";"T2-D9-5N1YL7";"-";"USD/JPY";"28 000 Jednost.";"152,100";"-";"-";"-";"-";"4,031577";"112 884,15";"0,00";"-";"-";"-";"-";"-";"-";"-";"-";"-";"-";"-";"-";"-";"-";"-";"-";"-";"-";"-";"-";"-";"-";"-";"-";"-"
"31 Paź 2024 07:53:44";" Zamknięcie Transakcji";"O2-D9-9BJRSY";"T2-D9-5N1Y11";"O2-D9-9BJR8G";"USD/JPY";"18 000 Jednost.";"152,232";"-";"-";"-";"-";"0,026219";"72 555,03";"84,48";"3 562,14";"-";"-";"-";"-";"-";"-";"-";"-";"-";"-";"-";"-";"-";"-";"-";"-";"-";"-";"-";"-";"-";"-";"-";"-"
"31 Paź 2024 07:46:53";"Transakcja Sprzedaży";"O2-D9-9BJR8G";"T2-D9-5N1XMZ";"-";"USD/JPY";"18 000 Jednost.";"152,411";"-";"-";"-";"-";"4,031076";"72 559,36";"0,00";"-";"-";"-";"-";"-";"-";"-";"-";"-";"-";"-";"-";"-";"-";"-";"-";"-";"-";"-";"-";"-";"-";"-";"-";"-"
"31 Paź 2024 07:37:17";" Transakcja Kupna";"O2-D9-9BJQR9";"T2-D9-5N1XCS";"-";"USD/JPY";"3 000 Jednost.";"152,872";"-";"-";"-";"-";"4,03344";"12 100,32";"0,00";"-";"-";"-";"-";"-";"-";"-";"-";"-";"-";"-";"-";"-";"-";"-";"-";"-";"-";"-";"-";"-";"-";"-";"-";"-"
"31 Paź 2024 07:33:24";" Transakcja Kupna";"O2-D9-9BJQLQ";"T2-D9-5N1XB7";"-";"USD/JPY";"20 000 Jednost.";"152,970";"-";"-";"-";"-";"4,033541";"80 670,82";"0,00";"-";"-";"-";"-";"-";"-";"-";"-";"-";"-";"-";"-";"-";"-";"-";"-";"-";"-";"-";"-";"-";"-";"-";"-";"-"
"31 Paź 2024 07:33:14";"Odrzucono Zlecenie: brak wystarczających środków";"O2-D9-9BJQLE";"-";"-";"USD/JPY";"24 000 Jednost.";"-";"-";"-";"-";"-";"-";"-";"-";"-";"-";"-";"-";"-";"-";"-";"-";"-";"-";"-";"-";"-";"-";"-";"-";"-";"-";"-";"-";"-";"-";"-";"-";"-"
"31 Paź 2024 07:32:58";"Odrzucono Zlecenie: brak wystarczających środków";"O2-D9-9BJQKY";"-";"-";"USD/JPY";"26 000 Jednost.";"-";"-";"-";"-";"-";"-";"-";"-";"-";"-";"-";"-";"-";"-";"-";"-";"-";"-";"-";"-";"-";"-";"-";"-";"-";"-";"-";"-";"-";"-";"-";"-";"-"
"31 Paź 2024 07:32:47";"Odrzucono Zlecenie: brak wystarczających środków";"O2-D9-9BJQKJ";"-";"-";"USD/JPY";"28 000 Jednost.";"-";"-";"-";"-";"-";"-";"-";"-";"-";"-";"-";"-";"-";"-";"-";"-";"-";"-";"-";"-";"-";"-";"-";"-";"-";"-";"-";"-";"-";"-";"-";"-";"-"
"31 Paź 2024 07:31:19";"Stop Loss";"O2-D9-9BJ2YX";"T2-D9-5N1X8M";"-";"USD/JPY";"6 500 Jednost.";"152,870";"-";"-";"-";"-";"0,026124";"26 215,15";"78,45";"3 477,66";"-";"-";"-";"-";"-";"-";"-";"-";"-";"-";"-";"-";"-";"-";"-";"-";"-";"-";"-";"-";"-";"-";"-";"-"
"31 Paź 2024 07:22:24";"Zmodyfikowano Stop Loss";"O2-D9-9BJ2YX";"-";"O2-D9-9BJPTV";"USD/JPY";"6 500 Jednost.";"153,332";"-";"152,870";"-";"-";"-";"-";"-";"-";"-";"-";"-";"-";"-";"-";"-";"-";"-";"-";"-";"-";"-";"-";"-";"-";"-";"-";"-";"-";"-";"-";"-";"-"
"31 Paź 2024 07:18:15";"Zmodyfikowano Transakcję Sprzedaży";"O2-D9-9BJ2YX";"T2-D9-5N1KXP";"-";"USD/JPY";"6 500 Jednost.";"153,332";"-";"153,000";"-";"-";"-";"-";"0,00";"-";"-";"-";"-";"-";"-";"-";"-";"-";"-";"-";"-";"-";"-";"-";"-";"-";"-";"-";"-";"-";"-";"-";"-";"-"
"30 Paź 2024 22:02:09";"Koszty Utrzymania Pozycji";"1384201326";"-";"-";"Rachunek";"-";"-";"-";"-";"-";"-";"-";"-";"-45,61";"3 399,21";"-";"-";"-";"-";"-";"-45,61";"-";"-";"-";"-";"-";"-";"-";"-";"-";"-";"-";"-";"-";"-";"-";"-";"-";"-"
"30 Paź 2024 22:02:09";"Koszty Utrzymania Pozycji";"O2-D9-9BH1F6";"-";"-";"USD/JPY";"-";"-";"-";"-";"-";"-";"-";"-";"-";"-";"-";"-";"26 000,00";"3,73911%";"31,89";"0,00";"-";"-";"-";"-";"-";"-";"-";"-";"-";"-";"-";"-";"-";"-";"-";"-";"-";"-"
"30 Paź 2024 22:02:09";"Koszty Utrzymania Pozycji";"O2-D9-9BB04B";"-";"-";"USD/JPY";"-";"-";"-";"-";"-";"-";"-";"-";"-";"-";"-";"-";"34 000,00";"5,77485%";"-65,06";"0,00";"-";"-";"-";"-";"-";"-";"-";"-";"-";"-";"-";"-";"-";"-";"-";"-";"-";"-"
"30 Paź 2024 22:02:09";"Koszty Utrzymania Pozycji";"O2-D9-9BJ2YX";"-";"-";"USD/JPY";"-";"-";"-";"-";"-";"-";"-";"-";"-";"-";"-";"-";"6 500,00";"5,77485%";"-12,44";"0,00";"-";"-";"-";"-";"-";"-";"-";"-";"-";"-";"-";"-";"-";"-";"-";"-";"-";"-"
"30 Paź 2024 21:15:18";"Transakcja Sprzedaży";"O2-D9-9BJ2YX";"T2-D9-5N1KXP";"-";"USD/JPY";"6 500 Jednost.";"153,332";"-";"-";"-";"-";"4,029973";"26 194,82";"0,00";"-";"-";"-";"-";"-";"-";"-";"-";"-";"-";"-";"-";"-";"-";"-";"-";"-";"-";"-";"-";"-";"-";"-";"-";"-"
"30 Paź 2024 21:15:09";"Odrzucono Zlecenie: brak wystarczających środków";"O2-D9-9BJ2YP";"-";"-";"USD/JPY";"7 000 Jednost.";"-";"-";"-";"-";"-";"-";"-";"-";"-";"-";"-";"-";"-";"-";"-";"-";"-";"-";"-";"-";"-";"-";"-";"-";"-";"-";"-";"-";"-";"-";"-";"-";"-"
"30 Paź 2024 20:39:36";" Zamknięcie Transakcji";"O2-D9-9BHZXN";"T2-D9-5N1GVR";"O2-D9-9BHZ8Q";"USD/JPY";"6 000 Jednost.";"153,336";"-";"-";"-";"-";"0,026016";"24 174,43";"10,30";"3 444,82";"-";"-";"-";"-";"-";"-";"-";"-";"-";"-";"-";"-";"-";"-";"-";"-";"-";"-";"-";"-";"-";"-";"-";"-"
"30 Paź 2024 20:24:15";"Transakcja Sprzedaży";"O2-D9-9BHZ8Q";"T2-D9-5N1G9E";"-";"USD/JPY";"6 000 Jednost.";"153,402";"-";"-";"-";"-";"4,030024";"24 180,14";"0,00";"-";"-";"-";"-";"-";"-";"-";"-";"-";"-";"-";"-";"-";"-";"-";"-";"-";"-";"-";"-";"-";"-";"-";"-";"-"
"30 Paź 2024 20:24:08";"Odrzucono Zlecenie: brak wystarczających środków";"O2-D9-9BHZ8G";"-";"-";"USD/JPY";"7 000 Jednost.";"-";"-";"-";"-";"-";"-";"-";"-";"-";"-";"-";"-";"-";"-";"-";"-";"-";"-";"-";"-";"-";"-";"-";"-";"-";"-";"-";"-";"-";"-";"-";"-";"-"
"30 Paź 2024 20:23:50";"Odrzucono Zlecenie: brak wystarczających środków";"O2-D9-9BHZ84";"-";"-";"USD/JPY";"8 000 Jednost.";"-";"-";"-";"-";"-";"-";"-";"-";"-";"-";"-";"-";"-";"-";"-";"-";"-";"-";"-";"-";"-";"-";"-";"-";"-";"-";"-";"-";"-";"-";"-";"-";"-"
"30 Paź 2024 20:23:42";"Odrzucono Zlecenie: brak wystarczających środków";"O2-D9-9BHZ81";"-";"-";"USD/JPY";"10 000 Jednost.";"-";"-";"-";"-";"-";"-";"-";"-";"-";"-";"-";"-";"-";"-";"-";"-";"-";"-";"-";"-";"-";"-";"-";"-";"-";"-";"-";"-";"-";"-";"-";"-";"-"
"30 Paź 2024 20:13:46";" Zamknięcie Transakcji";"O2-D9-9BHYSH";"T2-D9-5N1FW7";"O2-D9-9BHXGE";"USD/JPY";"22 000 Jednost.";"153,346";"-";"-";"-";"-";"0,026012";"88 636,26";"65,24";"3 434,52";"-";"-";"-";"-";"-";"-";"-";"-";"-";"-";"-";"-";"-";"-";"-";"-";"-";"-";"-";"-";"-";"-";"-";"-"
"30 Paź 2024 20:04:30";"Zmodyfikowano Stop Loss";"O2-D9-9BHXGE";"-";"O2-D9-9BHY92";"USD/JPY";"22 000 Jednost.";"153,232";"-";"153,280";"-";"-";"-";"-";"-";"-";"-";"-";"-";"-";"-";"-";"-";"-";"-";"-";"-";"-";"-";"-";"-";"-";"-";"-";"-";"-";"-";"-";"-";"-"
"30 Paź 2024 20:03:55";" Zmodyfikowano Transakcję Kupna";"O2-D9-9BHXGE";"T2-D9-5N1ENB";"-";"USD/JPY";"22 000 Jednost.";"153,232";"-";"153,250";"-";"-";"-";"-";"0,00";"-";"-";"-";"-";"-";"-";"-";"-";"-";"-";"-";"-";"-";"-";"-";"-";"-";"-";"-";"-";"-";"-";"-";"-";"-"
"30 Paź 2024 19:38:33";" Transakcja Kupna";"O2-D9-9BHXGE";"T2-D9-5N1ENB";"-";"USD/JPY";"22 000 Jednost.";"153,232";"-";"-";"-";"-";"4,025404";"88 558,88";"0,00";"-";"-";"-";"-";"-";"-";"-";"-";"-";"-";"-";"-";"-";"-";"-";"-";"-";"-";"-";"-";"-";"-";"-";"-";"-"
"30 Paź 2024 18:58:12";" Zamknięcie Transakcji";"O2-D9-9BHVTY";"T2-D9-5N1DCV";"O2-D9-9BHV6F";"USD/JPY";"20 000 Jednost.";"153,207";"-";"-";"-";"-";"0,026022";"80 537,74";"4,68";"3 369,28";"-";"-";"-";"-";"-";"-";"-";"-";"-";"-";"-";"-";"-";"-";"-";"-";"-";"-";"-";"-";"-";"-";"-";"-"
"30 Paź 2024 18:45:27";" Transakcja Kupna";"O2-D9-9BHV6F";"T2-D9-5N1CTC";"-";"USD/JPY";"20 000 Jednost.";"153,198";"-";"-";"-";"-";"4,026957";"80 539,14";"0,00";"-";"-";"-";"-";"-";"-";"-";"-";"-";"-";"-";"-";"-";"-";"-";"-";"-";"-";"-";"-";"-";"-";"-";"-";"-"
"30 Paź 2024 18:38:36";" Zamknięcie Transakcji";"O2-D9-9BHTP5";"T2-D9-5N1CDD";"O2-D9-9BHSKJ";"USD/JPY";"6 000 Jednost.";"153,174";"-";"-";"-";"-";"0,026025";"24 157,83";"5,00";"3 364,60";"-";"-";"-";"-";"-";"-";"-";"-";"-";"-";"-";"-";"-";"-";"-";"-";"-";"-";"-";"-";"-";"-";"-";"-"
"30 Paź 2024 18:14:33";"Transakcja Sprzedaży";"O2-D9-9BHSKJ";"T2-D9-5N1B9K";"-";"USD/JPY";"6 000 Jednost.";"153,206";"-";"-";"-";"-";"4,029472";"24 176,83";"0,00";"-";"-";"-";"-";"-";"-";"-";"-";"-";"-";"-";"-";"-";"-";"-";"-";"-";"-";"-";"-";"-";"-";"-";"-";"-"
"30 Paź 2024 18:14:14";"Odrzucono Zlecenie: brak wystarczających środków";"O2-D9-9BHSJR";"-";"-";"USD/JPY";"7 000 Jednost.";"-";"-";"-";"-";"-";"-";"-";"-";"-";"-";"-";"-";"-";"-";"-";"-";"-";"-";"-";"-";"-";"-";"-";"-";"-";"-";"-";"-";"-";"-";"-";"-";"-"
"30 Paź 2024 18:14:05";"Odrzucono Zlecenie: brak wystarczających środków";"O2-D9-9BHSJL";"-";"-";"USD/JPY";"9 000 Jednost.";"-";"-";"-";"-";"-";"-";"-";"-";"-";"-";"-";"-";"-";"-";"-";"-";"-";"-";"-";"-";"-";"-";"-";"-";"-";"-";"-";"-";"-";"-";"-";"-";"-"
"30 Paź 2024 18:13:50";"Odrzucono Zlecenie: brak wystarczających środków";"O2-D9-9BHSJ9";"-";"-";"USD/JPY";"10 000 Jednost.";"-";"-";"-";"-";"-";"-";"-";"-";"-";"-";"-";"-";"-";"-";"-";"-";"-";"-";"-";"-";"-";"-";"-";"-";"-";"-";"-";"-";"-";"-";"-";"-";"-"
"30 Paź 2024 18:08:43";"Stop Loss";"O2-D9-9BHR23";"T2-D9-5N1B3Z";"-";"USD/JPY";"21 000 Jednost.";"153,200";"-";"-";"-";"-";"0,026047";"84 647,32";"59,07";"3 359,60";"-";"-";"-";"-";"-";"-";"-";"-";"-";"-";"-";"-";"-";"-";"-";"-";"-";"-";"-";"-";"-";"-";"-";"-"
"30 Paź 2024 18:06:54";"Zmodyfikowano Stop Loss";"O2-D9-9BHR23";"-";"O2-D9-9BHS1F";"USD/JPY";"21 000 Jednost.";"153,092";"-";"153,200";"-";"-";"-";"-";"-";"-";"-";"-";"-";"-";"-";"-";"-";"-";"-";"-";"-";"-";"-";"-";"-";"-";"-";"-";"-";"-";"-";"-";"-";"-"
"30 Paź 2024 18:04:38";"Zmodyfikowano Stop Loss";"O2-D9-9BHR23";"-";"O2-D9-9BHS1F";"USD/JPY";"21 000 Jednost.";"153,092";"-";"153,160";"-";"-";"-";"-";"-";"-";"-";"-";"-";"-";"-";"-";"-";"-";"-";"-";"-";"-";"-";"-";"-";"-";"-";"-";"-";"-";"-";"-";"-";"-"
"30 Paź 2024 18:02:24";" Zmodyfikowano Transakcję Kupna";"O2-D9-9BHR23";"T2-D9-5N1934";"-";"USD/JPY";"21 000 Jednost.";"153,092";"-";"153,120";"-";"-";"-";"-";"0,00";"-";"-";"-";"-";"-";"-";"-";"-";"-";"-";"-";"-";"-";"-";"-";"-";"-";"-";"-";"-";"-";"-";"-";"-";"-"
"30 Paź 2024 17:39:06";" Transakcja Kupna";"O2-D9-9BHR23";"T2-D9-5N1934";"-";"USD/JPY";"21 000 Jednost.";"153,092";"-";"-";"-";"-";"4,027358";"84 574,51";"0,00";"-";"-";"-";"-";"-";"-";"-";"-";"-";"-";"-";"-";"-";"-";"-";"-";"-";"-";"-";"-";"-";"-";"-";"-";"-"
"30 Paź 2024 17:38:57";"Odrzucono Zlecenie: brak wystarczających środków";"O2-D9-9BHR1T";"-";"-";"USD/JPY";"24 000 Jednost.";"-";"-";"-";"-";"-";"-";"-";"-";"-";"-";"-";"-";"-";"-";"-";"-";"-";"-";"-";"-";"-";"-";"-";"-";"-";"-";"-";"-";"-";"-";"-";"-";"-"
"30 Paź 2024 17:38:48";"Odrzucono Zlecenie: brak wystarczających środków";"O2-D9-9BHR1J";"-";"-";"USD/JPY";"26 000 Jednost.";"-";"-";"-";"-";"-";"-";"-";"-";"-";"-";"-";"-";"-";"-";"-";"-";"-";"-";"-";"-";"-";"-";"-";"-";"-";"-";"-";"-";"-";"-";"-";"-";"-"
"30 Paź 2024 17:02:31";" Zmodyfikowano Transakcję Kupna";"O2-D9-9BH1F6";"T2-D9-5N0NG2";"-";"USD/JPY";"26 000 Jednost.";"153,478";"-";"-";"-";"-";"-";"-";"0,00";"-";"-";"-";"-";"-";"-";"-";"-";"-";"-";"-";"-";"-";"-";"-";"-";"-";"-";"-";"-";"-";"-";"-";"-";"-"
"30 Paź 2024 17:02:22";" Zamknięcie Transakcji";"O2-D9-9BHP4J";"T2-D9-5N17L1";"O2-D9-9BGWJC";"USD/JPY";"19 000 Jednost.";"153,116";"-";"-";"-";"-";"0,026025";"76 478,87";"101,37";"3 300,53";"-";"-";"-";"-";"-";"-";"-";"-";"-";"-";"-";"-";"-";"-";"-";"-";"-";"-";"-";"-";"-";"-";"-";"-"
"30 Paź 2024 16:01:33";" Zmodyfikowano Transakcję Kupna";"O2-D9-9BH1F6";"T2-D9-5N0NG2";"-";"USD/JPY";"26 000 Jednost.";"153,478";"-";"-";"153,600";"-";"-";"-";"0,00";"-";"-";"-";"-";"-";"-";"-";"-";"-";"-";"-";"-";"-";"-";"-";"-";"-";"-";"-";"-";"-";"-";"-";"-";"-"
"30 Paź 2024 15:00:00";"Stop Loss";"O2-D9-9BH33N";"T2-D9-5N0Y3P";"-";"USD/JPY";"24 000 Jednost.";"152,980";"-";"-";"-";"-";"0,026085";"96 710,95";"167,15";"3 199,16";"-";"-";"-";"-";"-";"-";"-";"-";"-";"-";"-";"-";"-";"-";"-";"-";"-";"-";"-";"-";"-";"-";"-";"-"
"30 Paź 2024 14:56:38";"Zmodyfikowano Stop Loss";"O2-D9-9BH33N";"-";"O2-D9-9BH99L";"USD/JPY";"24 000 Jednost.";"153,247";"-";"152,980";"-";"-";"-";"-";"-";"-";"-";"-";"-";"-";"-";"-";"-";"-";"-";"-";"-";"-";"-";"-";"-";"-";"-";"-";"-";"-";"-";"-";"-";"-"
"30 Paź 2024 14:56:03";"Zmodyfikowano Stop Loss";"O2-D9-9BH33N";"-";"O2-D9-9BH99L";"USD/JPY";"24 000 Jednost.";"153,247";"-";"153,020";"-";"-";"-";"-";"-";"-";"-";"-";"-";"-";"-";"-";"-";"-";"-";"-";"-";"-";"-";"-";"-";"-";"-";"-";"-";"-";"-";"-";"-";"-"
"30 Paź 2024 14:54:55";"Zmodyfikowano Stop Loss";"O2-D9-9BH33N";"-";"O2-D9-9BH99L";"USD/JPY";"24 000 Jednost.";"153,247";"-";"153,050";"-";"-";"-";"-";"-";"-";"-";"-";"-";"-";"-";"-";"-";"-";"-";"-";"-";"-";"-";"-";"-";"-";"-";"-";"-";"-";"-";"-";"-";"-"
"30 Paź 2024 14:49:03";"Zmodyfikowano Transakcję Sprzedaży";"O2-D9-9BH33N";"T2-D9-5N0PXW";"-";"USD/JPY";"24 000 Jednost.";"153,247";"-";"153,100";"-";"-";"-";"-";"0,00";"-";"-";"-";"-";"-";"-";"-";"-";"-";"-";"-";"-";"-";"-";"-";"-";"-";"-";"-";"-";"-";"-";"-";"-";"-"
"30 Paź 2024 13:55:27";" Zmodyfikowano Transakcję Kupna";"O2-D9-9BH1F6";"T2-D9-5N0NG2";"-";"USD/JPY";"26 000 Jednost.";"153,478";"-";"-";"-";"-";"-";"-";"0,00";"-";"-";"-";"-";"-";"-";"-";"-";"-";"-";"-";"-";"-";"-";"-";"-";"-";"-";"-";"-";"-";"-";"-";"-";"-"
"30 Paź 2024 13:54:29";"Transakcja Sprzedaży";"O2-D9-9BH33N";"T2-D9-5N0PXW";"-";"USD/JPY";"24 000 Jednost.";"153,247";"-";"-";"-";"-";"4,034292";"96 823,00";"0,00";"-";"-";"-";"-";"-";"-";"-";"-";"-";"-";"-";"-";"-";"-";"-";"-";"-";"-";"-";"-";"-";"-";"-";"-";"-"
"30 Paź 2024 13:54:06";"Odrzucono Zlecenie: brak wystarczających środków";"O2-D9-9BH32E";"-";"-";"USD/JPY";"26 000 Jednost.";"-";"-";"-";"-";"-";"-";"-";"-";"-";"-";"-";"-";"-";"-";"-";"-";"-";"-";"-";"-";"-";"-";"-";"-";"-";"-";"-";"-";"-";"-";"-";"-";"-"
"30 Paź 2024 13:43:54";" Zmodyfikowano Transakcję Kupna";"O2-D9-9BH1F6";"T2-D9-5N0NG2";"-";"USD/JPY";"26 000 Jednost.";"153,478";"-";"-";"153,600";"-";"-";"-";"0,00";"-";"-";"-";"-";"-";"-";"-";"-";"-";"-";"-";"-";"-";"-";"-";"-";"-";"-";"-";"-";"-";"-";"-";"-";"-"
"30 Paź 2024 13:31:04";" Transakcja Kupna";"O2-D9-9BH1F6";"T2-D9-5N0NG2";"-";"USD/JPY";"26 000 Jednost.";"153,478";"-";"-";"-";"-";"4,03803";"104 988,78";"0,00";"-";"-";"-";"-";"-";"-";"-";"-";"-";"-";"-";"-";"-";"-";"-";"-";"-";"-";"-";"-";"-";"-";"-";"-";"-"
"30 Paź 2024 13:16:25";" Zamknięcie Transakcji";"O2-D9-9BH0EN";"T2-D9-5N0MHG";"O2-D9-9BGWJC";"USD/JPY";"9 000 Jednost.";"153,275";"-";"-";"-";"-";"0,026054";"36 302,04";"85,35";"3 032,01";"-";"-";"-";"-";"-";"-";"-";"-";"-";"-";"-";"-";"-";"-";"-";"-";"-";"-";"-";"-";"-";"-";"-";"-"
"30 Paź 2024 13:15:46";" Zamknięcie Transakcji";"O2-D9-9BH0D5";"T2-D9-5N0MG5";"O2-D9-9B6B2E";"USD/JPY";"19 600 Jednost.";"153,289";"-";"-";"-";"-";"0,026058";"79 059,36";"87,34";"2 946,66";"-";"-";"-";"-";"-";"-";"-";"-";"-";"-";"-";"-";"-";"-";"-";"-";"-";"-";"-";"-";"-";"-";"-";"-"
"30 Paź 2024 11:51:54";"Zmodyfikowano Transakcję Sprzedaży";"O2-D9-9BB04B";"T2-D9-5MVGZ2";"-";"USD/JPY";"34 000 Jednost.";"151,815";"-";"-";"-";"-";"-";"-";"0,00";"-";"-";"-";"-";"-";"-";"-";"-";"-";"-";"-";"-";"-";"-";"-";"-";"-";"-";"-";"-";"-";"-";"-";"-";"-"
"30 Paź 2024 11:50:48";" Transakcja Kupna";"O2-D9-9BGWJC";"T2-D9-5N0J51";"-";"USD/JPY";"28 000 Jednost.";"152,911";"-";"-";"-";"-";"4,022479";"112 629,41";"0,00";"-";"-";"-";"-";"-";"-";"-";"-";"-";"-";"-";"-";"-";"-";"-";"-";"-";"-";"-";"-";"-";"-";"-";"-";"-"
"29 Paź 2024 22:02:24";"Koszty Utrzymania Pozycji";"1383879528";"-";"-";"Rachunek";"-";"-";"-";"-";"-";"-";"-";"-";"-13,68";"2 859,32";"-";"-";"-";"-";"-";"-13,68";"-";"-";"-";"-";"-";"-";"-";"-";"-";"-";"-";"-";"-";"-";"-";"-";"-";"-"
"29 Paź 2024 22:02:24";"Koszty Utrzymania Pozycji";"O2-D9-9BB04B";"-";"-";"USD/JPY";"-";"-";"-";"-";"-";"-";"-";"-";"-";"-";"-";"-";"34 000,00";"5,78141%";"-21,71";"0,00";"-";"-";"-";"-";"-";"-";"-";"-";"-";"-";"-";"-";"-";"-";"-";"-";"-";"-"
"29 Paź 2024 22:02:24";"Koszty Utrzymania Pozycji";"O2-D9-9B6B2E";"-";"-";"USD/JPY";"-";"-";"-";"-";"-";"-";"-";"-";"-";"-";"-";"-";"19 600,00";"3,74562%";"8,03";"0,00";"-";"-";"-";"-";"-";"-";"-";"-";"-";"-";"-";"-";"-";"-";"-";"-";"-";"-"
"29 Paź 2024 06:30:38";"Zmodyfikowano Transakcję Sprzedaży";"O2-D9-9BB04B";"T2-D9-5MVGZ2";"-";"USD/JPY";"34 000 Jednost.";"151,815";"-";"-";"151,700";"-";"-";"-";"0,00";"-";"-";"-";"-";"-";"-";"-";"-";"-";"-";"-";"-";"-";"-";"-";"-";"-";"-";"-";"-";"-";"-";"-";"-";"-"
"28 Paź 2024 22:02:05";"Koszty Utrzymania Pozycji";"1383533722";"-";"-";"Rachunek";"-";"-";"-";"-";"-";"-";"-";"-";"-13,73";"2 873,00";"-";"-";"-";"-";"-";"-13,73";"-";"-";"-";"-";"-";"-";"-";"-";"-";"-";"-";"-";"-";"-";"-";"-";"-";"-"
"28 Paź 2024 22:02:05";"Koszty Utrzymania Pozycji";"O2-D9-9BB04B";"-";"-";"USD/JPY";"-";"-";"-";"-";"-";"-";"-";"-";"-";"-";"-";"-";"34 000,00";"5,78141%";"-21,78";"0,00";"-";"-";"-";"-";"-";"-";"-";"-";"-";"-";"-";"-";"-";"-";"-";"-";"-";"-"
"28 Paź 2024 22:02:05";"Koszty Utrzymania Pozycji";"O2-D9-9B6B2E";"-";"-";"USD/JPY";"-";"-";"-";"-";"-";"-";"-";"-";"-";"-";"-";"-";"19 600,00";"3,74562%";"8,05";"0,00";"-";"-";"-";"-";"-";"-";"-";"-";"-";"-";"-";"-";"-";"-";"-";"-";"-";"-"
"28 Paź 2024 18:11:27";" Zamknięcie Transakcji";"O2-D9-9BDW90";"T2-D9-5MXZPT";"O2-D9-9BDVYB";"USD/JPY";"28 000 Jednost.";"153,254";"-";"-";"-";"-";"0,026116";"113 190,81";"1,46";"2 886,73";"-";"-";"-";"-";"-";"-";"-";"-";"-";"-";"-";"-";"-";"-";"-";"-";"-";"-";"-";"-";"-";"-";"-";"-"
"28 Paź 2024 18:01:48";" Transakcja Kupna";"O2-D9-9BDVYB";"T2-D9-5MXZE6";"-";"USD/JPY";"28 000 Jednost.";"153,252";"-";"-";"-";"-";"4,042288";"113 184,06";"0,00";"-";"-";"-";"-";"-";"-";"-";"-";"-";"-";"-";"-";"-";"-";"-";"-";"-";"-";"-";"-";"-";"-";"-";"-";"-"
"28 Paź 2024 17:11:35";" Zamknięcie Transakcji";"O2-D9-9BDSD4";"T2-D9-5MXX5P";"O2-D9-9BDQZW";"USD/JPY";"28 000 Jednost.";"153,213";"-";"-";"-";"-";"0,02611";"113 133,27";"11,70";"2 885,27";"-";"-";"-";"-";"-";"-";"-";"-";"-";"-";"-";"-";"-";"-";"-";"-";"-";"-";"-";"-";"-";"-";"-";"-"
"28 Paź 2024 16:52:06";" Transakcja Kupna";"O2-D9-9BDQZW";"T2-D9-5MXW1B";"-";"USD/JPY";"28 000 Jednost.";"153,197";"-";"-";"-";"-";"4,041176";"113 152,92";"0,00";"-";"-";"-";"-";"-";"-";"-";"-";"-";"-";"-";"-";"-";"-";"-";"-";"-";"-";"-";"-";"-";"-";"-";"-";"-"
"28 Paź 2024 16:51:56";"Odrzucono Zlecenie: brak wystarczających środków";"O2-D9-9BDQZG";"-";"-";"USD/JPY";"30 000 Jednost.";"-";"-";"-";"-";"-";"-";"-";"-";"-";"-";"-";"-";"-";"-";"-";"-";"-";"-";"-";"-";"-";"-";"-";"-";"-";"-";"-";"-";"-";"-";"-";"-";"-"
"28 Paź 2024 15:48:23";" Zamknięcie Transakcji";"O2-D9-9BDLGM";"T2-D9-5MXQZP";"O2-D9-9BDJGE";"USD/JPY";"28 000 Jednost.";"153,022";"-";"-";"-";"-";"0,026139";"113 120,67";"7,32";"2 873,57";"-";"-";"-";"-";"-";"-";"-";"-";"-";"-";"-";"-";"-";"-";"-";"-";"-";"-";"-";"-";"-";"-";"-";"-"
"28 Paź 2024 15:24:53";" Transakcja Kupna";"O2-D9-9BDJGE";"T2-D9-5MXP8C";"-";"USD/JPY";"28 000 Jednost.";"153,012";"-";"-";"-";"-";"4,041527";"113 162,75";"0,00";"-";"-";"-";"-";"-";"-";"-";"-";"-";"-";"-";"-";"-";"-";"-";"-";"-";"-";"-";"-";"-";"-";"-";"-";"-"
"28 Paź 2024 15:10:49";"Stop Loss";"O2-D9-9BDBH6";"T2-D9-5MXNCH";"-";"USD/JPY";"26 000 Jednost.";"152,900";"-";"-";"-";"-";"0,026171";"105 096,88";"110,23";"2 866,25";"-";"-";"-";"-";"-";"-";"-";"-";"-";"-";"-";"-";"-";"-";"-";"-";"-";"-";"-";"-";"-";"-";"-";"-"
"28 Paź 2024 15:09:18";"Zmodyfikowano Stop Loss";"O2-D9-9BDBH6";"-";"O2-D9-9BDGTV";"USD/JPY";"26 000 Jednost.";"152,738";"-";"152,900";"-";"-";"-";"-";"-";"-";"-";"-";"-";"-";"-";"-";"-";"-";"-";"-";"-";"-";"-";"-";"-";"-";"-";"-";"-";"-";"-";"-";"-";"-"
"28 Paź 2024 15:05:46";" Zmodyfikowano Transakcję Kupna";"O2-D9-9BDBH6";"T2-D9-5MXH8L";"-";"USD/JPY";"26 000 Jednost.";"152,738";"-";"152,820";"-";"-";"-";"-";"0,00";"-";"-";"-";"-";"-";"-";"-";"-";"-";"-";"-";"-";"-";"-";"-";"-";"-";"-";"-";"-";"-";"-";"-";"-";"-"
"28 Paź 2024 14:14:10";" Transakcja Kupna";"O2-D9-9BDBH6";"T2-D9-5MXH8L";"-";"USD/JPY";"26 000 Jednost.";"152,738";"-";"-";"-";"-";"4,040925";"105 064,05";"0,00";"-";"-";"-";"-";"-";"-";"-";"-";"-";"-";"-";"-";"-";"-";"-";"-";"-";"-";"-";"-";"-";"-";"-";"-";"-"
"28 Paź 2024 14:09:32";" Zamknięcie Transakcji";"O2-D9-9BDB8T";"T2-D9-5MXH1R";"O2-D9-9BD9XG";"USD/JPY";"14 400 Jednost.";"152,693";"-";"-";"-";"-";"0,0262";"58 190,04";"6,04";"2 756,02";"-";"-";"-";"-";"-";"-";"-";"-";"-";"-";"-";"-";"-";"-";"-";"-";"-";"-";"-";"-";"-";"-";"-";"-"
"28 Paź 2024 14:03:09";" Transakcja Kupna";"O2-D9-9BD9XG";"T2-D9-5MXGR5";"-";"USD/JPY";"14 400 Jednost.";"152,677";"-";"-";"-";"-";"4,042178";"58 207,36";"0,00";"-";"-";"-";"-";"-";"-";"-";"-";"-";"-";"-";"-";"-";"-";"-";"-";"-";"-";"-";"-";"-";"-";"-";"-";"-"
"28 Paź 2024 13:29:02";" Zamknięcie Transakcji";"O2-D9-9BD7Z0";"T2-D9-5MXEZN";"O2-D9-9BD7RE";"USD/JPY";"20 000 Jednost.";"152,586";"-";"-";"-";"-";"0,026211";"80 800,88";"36,70";"2 749,98";"-";"-";"-";"-";"-";"-";"-";"-";"-";"-";"-";"-";"-";"-";"-";"-";"-";"-";"-";"-";"-";"-";"-";"-"
"28 Paź 2024 13:24:41";" Transakcja Kupna";"O2-D9-9BD7RE";"T2-D9-5MXEV8";"-";"USD/JPY";"20 000 Jednost.";"152,516";"-";"-";"-";"-";"4,038881";"80 777,62";"0,00";"-";"-";"-";"-";"-";"-";"-";"-";"-";"-";"-";"-";"-";"-";"-";"-";"-";"-";"-";"-";"-";"-";"-";"-";"-"
"28 Paź 2024 13:07:00";"Stop Loss";"O2-D9-9BD4KQ";"T2-D9-5MXDZ7";"-";"USD/JPY";"14 400 Jednost.";"152,590";"-";"-";"-";"-";"0,0264628";"58 162,63";"-16,77";"2 713,28";"-";"-";"-";"-";"-";"-";"-";"-";"-";"-";"-";"-";"-";"-";"-";"-";"-";"-";"-";"-";"-";"-";"-";"-"
"28 Paź 2024 12:52:05";" Zmodyfikowano Transakcję Kupna";"O2-D9-9BD4KQ";"T2-D9-5MXC0W";"-";"USD/JPY";"14 400 Jednost.";"152,634";"-";"152,590";"-";"-";"-";"-";"0,00";"-";"-";"-";"-";"-";"-";"-";"-";"-";"-";"-";"-";"-";"-";"-";"-";"-";"-";"-";"-";"-";"-";"-";"-";"-"
"28 Paź 2024 12:15:23";" Transakcja Kupna";"O2-D9-9BD4KQ";"T2-D9-5MXC0W";"-";"USD/JPY";"14 400 Jednost.";"152,634";"-";"-";"-";"-";"4,039623";"58 170,57";"0,00";"-";"-";"-";"-";"-";"-";"-";"-";"-";"-";"-";"-";"-";"-";"-";"-";"-";"-";"-";"-";"-";"-";"-";"-";"-"
"25 Paź 2024 23:02:07";"Koszty Utrzymania Pozycji";"1383203820";"-";"-";"Rachunek";"-";"-";"-";"-";"-";"-";"-";"-";"-13,77";"2 730,05";"-";"-";"-";"-";"-";"-13,77";"-";"-";"-";"-";"-";"-";"-";"-";"-";"-";"-";"-";"-";"-";"-";"-";"-";"-"
"25 Paź 2024 23:02:07";"Koszty Utrzymania Pozycji";"O2-D9-9BB04B";"-";"-";"USD/JPY";"-";"-";"-";"-";"-";"-";"-";"-";"-";"-";"-";"-";"34 000,00";"5,81255%";"-21,89";"0,00";"-";"-";"-";"-";"-";"-";"-";"-";"-";"-";"-";"-";"-";"-";"-";"-";"-";"-"
"25 Paź 2024 23:02:07";"Koszty Utrzymania Pozycji";"O2-D9-9B6B2E";"-";"-";"USD/JPY";"-";"-";"-";"-";"-";"-";"-";"-";"-";"-";"-";"-";"19 600,00";"3,77653%";"8,12";"0,00";"-";"-";"-";"-";"-";"-";"-";"-";"-";"-";"-";"-";"-";"-";"-";"-";"-";"-"
"25 Paź 2024 22:42:23";" Zamknięcie Transakcji";"O2-D9-9BC606";"T2-D9-5MWK2Q";"O2-D9-9BBRLG";"USD/JPY";"28 000 Jednost.";"152,313";"-";"-";"-";"-";"0,026295";"113 279,18";"26,51";"2 743,82";"-";"-";"-";"-";"-";"-";"-";"-";"-";"-";"-";"-";"-";"-";"-";"-";"-";"-";"-";"-";"-";"-";"-";"-"
"25 Paź 2024 21:04:39";" Zamknięcie Transakcji";"O2-D9-9BC2J0";"T2-D9-5MWFPQ";"O2-D9-9BBT52";"USD/JPY";"26 000 Jednost.";"152,302";"-";"-";"-";"-";"0,026573";"105 222,18";"-84,98";"2 717,31";"-";"-";"-";"-";"-";"-";"-";"-";"-";"-";"-";"-";"-";"-";"-";"-";"-";"-";"-";"-";"-";"-";"-";"-"
"25 Paź 2024 19:25:48";"Transakcja Sprzedaży";"O2-D9-9BBT52";"T2-D9-5MW6VZ";"-";"USD/JPY";"26 000 Jednost.";"152,179";"-";"-";"-";"-";"4,044492";"105 156,79";"0,00";"-";"-";"-";"-";"-";"-";"-";"-";"-";"-";"-";"-";"-";"-";"-";"-";"-";"-";"-";"-";"-";"-";"-";"-";"-"
"25 Paź 2024 19:04:31";"Zmodyfikowano Transakcję Sprzedaży";"O2-D9-9BB04B";"T2-D9-5MVGZ2";"-";"USD/JPY";"34 000 Jednost.";"151,815";"-";"-";"-";"-";"-";"-";"0,00";"-";"-";"-";"-";"-";"-";"-";"-";"-";"-";"-";"-";"-";"-";"-";"-";"-";"-";"-";"-";"-";"-";"-";"-";"-"
"25 Paź 2024 19:04:00";" Transakcja Kupna";"O2-D9-9BBRLG";"T2-D9-5MW5B7";"-";"USD/JPY";"28 000 Jednost.";"152,277";"-";"-";"-";"-";"4,043541";"113 219,14";"0,00";"-";"-";"-";"-";"-";"-";"-";"-";"-";"-";"-";"-";"-";"-";"-";"-";"-";"-";"-";"-";"-";"-";"-";"-";"-"
"25 Paź 2024 19:03:50";"Odrzucono Zlecenie: brak wystarczających środków";"O2-D9-9BBRL7";"-";"-";"USD/JPY";"29 000 Jednost.";"-";"-";"-";"-";"-";"-";"-";"-";"-";"-";"-";"-";"-";"-";"-";"-";"-";"-";"-";"-";"-";"-";"-";"-";"-";"-";"-";"-";"-";"-";"-";"-";"-"
"25 Paź 2024 18:34:08";" Zamknięcie Transakcji";"O2-D9-9BBQE0";"T2-D9-5MW48V";"O2-D9-9BBPPZ";"USD/JPY";"20 000 Jednost.";"152,216";"-";"-";"-";"-";"0,026295";"80 862,80";"16,30";"2 802,29";"-";"-";"-";"-";"-";"-";"-";"-";"-";"-";"-";"-";"-";"-";"-";"-";"-";"-";"-";"-";"-";"-";"-";"-"
"25 Paź 2024 18:22:11";" Transakcja Kupna";"O2-D9-9BBPPZ";"T2-D9-5MW3MN";"-";"USD/JPY";"20 000 Jednost.";"152,185";"-";"-";"-";"-";"4,042589";"80 851,78";"0,00";"-";"-";"-";"-";"-";"-";"-";"-";"-";"-";"-";"-";"-";"-";"-";"-";"-";"-";"-";"-";"-";"-";"-";"-";"-"
"25 Paź 2024 17:20:01";"Stop Loss";"O2-D9-9BBHTF";"T2-D9-5MVZE5";"-";"USD/JPY";"25 000 Jednost.";"151,990";"-";"-";"-";"-";"0,026288";"100 876,10";"19,72";"2 785,99";"-";"-";"-";"-";"-";"-";"-";"-";"-";"-";"-";"-";"-";"-";"-";"-";"-";"-";"-";"-";"-";"-";"-";"-"
"25 Paź 2024 17:19:57";" Zmodyfikowano Transakcję Kupna";"O2-D9-9BBHTF";"T2-D9-5MVYHR";"-";"USD/JPY";"25 000 Jednost.";"151,960";"-";"151,990";"-";"-";"-";"-";"0,00";"-";"-";"-";"-";"-";"-";"-";"-";"-";"-";"-";"-";"-";"-";"-";"-";"-";"-";"-";"-";"-";"-";"-";"-";"-"
"25 Paź 2024 17:05:17";" Transakcja Kupna";"O2-D9-9BBHTF";"T2-D9-5MVYHR";"-";"USD/JPY";"25 000 Jednost.";"151,960";"-";"-";"-";"-";"4,032408";"100 810,20";"0,00";"-";"-";"-";"-";"-";"-";"-";"-";"-";"-";"-";"-";"-";"-";"-";"-";"-";"-";"-";"-";"-";"-";"-";"-";"-"
"25 Paź 2024 16:59:07";" Zamknięcie Transakcji";"O2-D9-9BBHCH";"T2-D9-5MVY5D";"O2-D9-9BBGJH";"USD/JPY";"25 000 Jednost.";"152,032";"-";"-";"-";"-";"0,026266";"100 839,02";"17,07";"2 766,27";"-";"-";"-";"-";"-";"-";"-";"-";"-";"-";"-";"-";"-";"-";"-";"-";"-";"-";"-";"-";"-";"-";"-";"-"
"25 Paź 2024 16:49:02";" Transakcja Kupna";"O2-D9-9BBGJH";"T2-D9-5MVXH6";"-";"USD/JPY";"25 000 Jednost.";"152,006";"-";"-";"-";"-";"4,033851";"100 846,27";"0,00";"-";"-";"-";"-";"-";"-";"-";"-";"-";"-";"-";"-";"-";"-";"-";"-";"-";"-";"-";"-";"-";"-";"-";"-";"-"
"25 Paź 2024 16:48:17";"Odrzucono Zlecenie: brak wystarczających środków";"O2-D9-9BBGF2";"-";"-";"USD/JPY";"30 000 Jednost.";"-";"-";"-";"-";"-";"-";"-";"-";"-";"-";"-";"-";"-";"-";"-";"-";"-";"-";"-";"-";"-";"-";"-";"-";"-";"-";"-";"-";"-";"-";"-";"-";"-"
"25 Paź 2024 15:09:51";"Zmodyfikowano Transakcję Sprzedaży";"O2-D9-9BB04B";"T2-D9-5MVGZ2";"-";"USD/JPY";"34 000 Jednost.";"151,815";"-";"-";"151,760";"-";"-";"-";"0,00";"-";"-";"-";"-";"-";"-";"-";"-";"-";"-";"-";"-";"-";"-";"-";"-";"-";"-";"-";"-";"-";"-";"-";"-";"-"
"25 Paź 2024 14:01:46";"Transakcja Sprzedaży";"O2-D9-9BB04B";"T2-D9-5MVGZ2";"-";"USD/JPY";"34 000 Jednost.";"151,815";"-";"-";"-";"-";"4,036717";"137 248,37";"0,00";"-";"-";"-";"-";"-";"-";"-";"-";"-";"-";"-";"-";"-";"-";"-";"-";"-";"-";"-";"-";"-";"-";"-";"-";"-"
"24 Paź 2024 23:02:21";"Koszty Utrzymania Pozycji";"1382925452";"-";"-";"Rachunek";"-";"-";"-";"-";"-";"-";"-";"-";"7,98";"2 749,20";"-";"-";"-";"-";"-";"7,98";"-";"-";"-";"-";"-";"-";"-";"-";"-";"-";"-";"-";"-";"-";"-";"-";"-";"-"
"24 Paź 2024 23:02:21";"Koszty Utrzymania Pozycji";"O2-D9-9B6B2E";"-";"-";"USD/JPY";"-";"-";"-";"-";"-";"-";"-";"-";"-";"-";"-";"-";"19 600,00";"3,72007%";"7,98";"0,00";"-";"-";"-";"-";"-";"-";"-";"-";"-";"-";"-";"-";"-";"-";"-";"-";"-";"-"
"24 Paź 2024 21:55:39";" Zamknięcie Transakcji";"O2-D9-9B98Q7";"T2-D9-5MTWNF";"O2-D9-9B8602";"USD/JPY";"21 500 Jednost.";"151,842";"-";"-";"-";"-";"0,026302";"86 728,65";"7,92";"2 741,22";"-";"-";"-";"-";"-";"-";"-";"-";"-";"-";"-";"-";"-";"-";"-";"-";"-";"-";"-";"-";"-";"-";"-";"-"
"24 Paź 2024 21:47:09";" Zamknięcie Transakcji";"O2-D9-9B98EL";"T2-D9-5MTWE6";"O2-D9-9B8T38";"USD/JPY";"25 000 Jednost.";"151,861";"-";"-";"-";"-";"0,026558";"100 828,25";"-43,16";"2 733,30";"-";"-";"-";"-";"-";"-";"-";"-";"-";"-";"-";"-";"-";"-";"-";"-";"-";"-";"-";"-";"-";"-";"-";"-"
"24 Paź 2024 19:04:35";" Zamknięcie Transakcji";"O2-D9-9B91RT";"T2-D9-5MTPJQ";"O2-D9-9B8602";"USD/JPY";"5 000 Jednost.";"151,750";"-";"-";"-";"-";"0,026345";"20 189,29";"13,96";"2 776,46";"-";"-";"-";"-";"-";"-";"-";"-";"-";"-";"-";"-";"-";"-";"-";"-";"-";"-";"-";"-";"-";"-";"-";"-"
"24 Paź 2024 17:50:56";" Zamknięcie Transakcji";"O2-D9-9B8WDQ";"T2-D9-5MTJXP";"O2-D9-9B8602";"USD/JPY";"8 000 Jednost.";"151,812";"-";"-";"-";"-";"0,026362";"32 337,42";"9,28";"2 762,50";"-";"-";"-";"-";"-";"-";"-";"-";"-";"-";"-";"-";"-";"-";"-";"-";"-";"-";"-";"-";"-";"-";"-";"-"
"24 Paź 2024 17:22:01";" Zmodyfikowano Transakcję Kupna";"O2-D9-9B8T38";"T2-D9-5MTGRH";"-";"USD/JPY";"25 000 Jednost.";"151,926";"-";"-";"152,080";"-";"-";"-";"0,00";"-";"-";"-";"-";"-";"-";"-";"-";"-";"-";"-";"-";"-";"-";"-";"-";"-";"-";"-";"-";"-";"-";"-";"-";"-"
"24 Paź 2024 17:21:25";"Zmodyfikowano Transakcję Sprzedaży";"O2-D9-9B8602";"T2-D9-5MSY8D";"-";"USD/JPY";"34 500 Jednost.";"151,856";"-";"-";"-";"-";"-";"-";"0,00";"-";"-";"-";"-";"-";"-";"-";"-";"-";"-";"-";"-";"-";"-";"-";"-";"-";"-";"-";"-";"-";"-";"-";"-";"-"
"24 Paź 2024 17:20:44";" Transakcja Kupna";"O2-D9-9B8T38";"T2-D9-5MTGRH";"-";"USD/JPY";"25 000 Jednost.";"151,926";"-";"-";"-";"-";"4,04344";"101 086,00";"0,00";"-";"-";"-";"-";"-";"-";"-";"-";"-";"-";"-";"-";"-";"-";"-";"-";"-";"-";"-";"-";"-";"-";"-";"-";"-"
"24 Paź 2024 17:11:08";"Zmodyfikowano Take Profit";"O2-D9-9B8602";"-";"O2-D9-9B8S96";"USD/JPY";"34 500 Jednost.";"151,856";"-";"-";"151,700";"-";"-";"-";"-";"-";"-";"-";"-";"-";"-";"-";"-";"-";"-";"-";"-";"-";"-";"-";"-";"-";"-";"-";"-";"-";"-";"-";"-";"-"
"24 Paź 2024 17:09:18";"Zmodyfikowano Transakcję Sprzedaży";"O2-D9-9B8602";"T2-D9-5MSY8D";"-";"USD/JPY";"34 500 Jednost.";"151,856";"-";"-";"151,800";"-";"-";"-";"0,00";"-";"-";"-";"-";"-";"-";"-";"-";"-";"-";"-";"-";"-";"-";"-";"-";"-";"-";"-";"-";"-";"-";"-";"-";"-"
"24 Paź 2024 16:14:11";" Zamknięcie Transakcji";"O2-D9-9B8LMN";"T2-D9-5MT9RT";"O2-D9-9B8LJL";"USD/JPY";"25 000 Jednost.";"152,167";"-";"-";"-";"-";"0,026285";"101 006,85";"11,83";"2 753,22";"-";"-";"-";"-";"-";"-";"-";"-";"-";"-";"-";"-";"-";"-";"-";"-";"-";"-";"-";"-";"-";"-";"-";"-"
"24 Paź 2024 16:13:19";" Transakcja Kupna";"O2-D9-9B8LJL";"T2-D9-5MT9PC";"-";"USD/JPY";"25 000 Jednost.";"152,149";"-";"-";"-";"-";"4,040945";"101 023,62";"0,00";"-";"-";"-";"-";"-";"-";"-";"-";"-";"-";"-";"-";"-";"-";"-";"-";"-";"-";"-";"-";"-";"-";"-";"-";"-"
"24 Paź 2024 16:09:03";" Zamknięcie Transakcji";"O2-D9-9B8L3W";"T2-D9-5MT9BB";"O2-D9-9B8L27";"USD/JPY";"25 000 Jednost.";"152,108";"-";"-";"-";"-";"0,026303";"101 045,67";"10,52";"2 741,39";"-";"-";"-";"-";"-";"-";"-";"-";"-";"-";"-";"-";"-";"-";"-";"-";"-";"-";"-";"-";"-";"-";"-";"-"
"24 Paź 2024 16:08:31";" Transakcja Kupna";"O2-D9-9B8L27";"T2-D9-5MT99C";"-";"USD/JPY";"25 000 Jednost.";"152,092";"-";"-";"-";"-";"4,041156";"101 028,90";"0,00";"-";"-";"-";"-";"-";"-";"-";"-";"-";"-";"-";"-";"-";"-";"-";"-";"-";"-";"-";"-";"-";"-";"-";"-";"-"
"24 Paź 2024 16:07:27";"Odrzucono Zlecenie: brak wystarczających środków";"O2-D9-9B8KY3";"-";"-";"USD/JPY";"30 000 Jednost.";"-";"-";"-";"-";"-";"-";"-";"-";"-";"-";"-";"-";"-";"-";"-";"-";"-";"-";"-";"-";"-";"-";"-";"-";"-";"-";"-";"-";"-";"-";"-";"-";"-"
"24 Paź 2024 12:37:04";"Transakcja Sprzedaży";"O2-D9-9B8602";"T2-D9-5MSY8D";"-";"USD/JPY";"34 500 Jednost.";"151,856";"-";"-";"-";"-";"4,038531";"139 329,31";"0,00";"-";"-";"-";"-";"-";"-";"-";"-";"-";"-";"-";"-";"-";"-";"-";"-";"-";"-";"-";"-";"-";"-";"-";"-";"-"
"24 Paź 2024 12:13:48";" Zamknięcie Transakcji";"O2-D9-9B859E";"T2-D9-5MSXPR";"O2-D9-9B853K";"USD/JPY";"34 500 Jednost.";"151,916";"-";"-";"-";"-";"0,026318";"139 322,38";"20,88";"2 730,87";"-";"-";"-";"-";"-";"-";"-";"-";"-";"-";"-";"-";"-";"-";"-";"-";"-";"-";"-";"-";"-";"-";"-";"-"
"24 Paź 2024 12:09:24";"Transakcja Sprzedaży";"O2-D9-9B853K";"T2-D9-5MSXKL";"-";"USD/JPY";"34 500 Jednost.";"151,939";"-";"-";"-";"-";"4,039122";"139 349,70";"0,00";"-";"-";"-";"-";"-";"-";"-";"-";"-";"-";"-";"-";"-";"-";"-";"-";"-";"-";"-";"-";"-";"-";"-";"-";"-"
"24 Paź 2024 11:55:17";"Stop Loss";"O2-D9-9B82EB";"T2-D9-5MSX5C";"-";"USD/JPY";"34 500 Jednost.";"151,940";"-";"-";"-";"-";"0,026338";"139 430,92";"29,99";"2 709,99";"-";"-";"-";"-";"-";"-";"-";"-";"-";"-";"-";"-";"-";"-";"-";"-";"-";"-";"-";"-";"-";"-";"-";"-"
"24 Paź 2024 11:47:10";"Zmodyfikowano Transakcję Sprzedaży";"O2-D9-9B82EB";"T2-D9-5MSVF6";"-";"USD/JPY";"34 500 Jednost.";"151,973";"-";"151,940";"-";"-";"-";"-";"0,00";"-";"-";"-";"-";"-";"-";"-";"-";"-";"-";"-";"-";"-";"-";"-";"-";"-";"-";"-";"-";"-";"-";"-";"-";"-"
"24 Paź 2024 10:54:22";"Transakcja Sprzedaży";"O2-D9-9B82EB";"T2-D9-5MSVF6";"-";"USD/JPY";"34 500 Jednost.";"151,973";"-";"-";"-";"-";"4,036036";"139 243,24";"0,00";"-";"-";"-";"-";"-";"-";"-";"-";"-";"-";"-";"-";"-";"-";"-";"-";"-";"-";"-";"-";"-";"-";"-";"-";"-"
"23 Paź 2024 23:02:19";"Koszty Utrzymania Pozycji";"1382605172";"-";"-";"Rachunek";"-";"-";"-";"-";"-";"-";"-";"-";"24,03";"2 680,00";"-";"-";"-";"-";"-";"24,03";"-";"-";"-";"-";"-";"-";"-";"-";"-";"-";"-";"-";"-";"-";"-";"-";"-";"-"
"23 Paź 2024 23:02:19";"Koszty Utrzymania Pozycji";"O2-D9-9B6B2E";"-";"-";"USD/JPY";"-";"-";"-";"-";"-";"-";"-";"-";"-";"-";"-";"-";"19 600,00";"3,72007%";"24,03";"0,00";"-";"-";"-";"-";"-";"-";"-";"-";"-";"-";"-";"-";"-";"-";"-";"-";"-";"-"
"23 Paź 2024 14:39:37";" Transakcja Kupna";"O2-D9-9B6B2E";"T2-D9-5MR9PF";"-";"USD/JPY";"19 600 Jednost.";"153,118";"-";"-";"-";"-";"4,055254";"79 482,97";"0,00";"-";"-";"-";"-";"-";"-";"-";"-";"-";"-";"-";"-";"-";"-";"-";"-";"-";"-";"-";"-";"-";"-";"-";"-";"-"
"21 Paź 2024 02:07:21";" Likwidacja";"O2-D9-9B22CY";"T2-D9-5MMQRQ";"O2-D8-9B01G6";"Solana (USD)";"29,57 Jednost.";"169,020";"-";"-";"-";"-";"3,981026";"19 896,85";"-2 387,93";"2 655,97";"-";"-";"-";"-";"-";"-";"-";"-";"-";"-";"-";"-";"-";"-";"-";"-";"-";"-";"-";"-";"-";"-";"-";"-"
"21 Paź 2024 02:07:21";" Likwidacja";"O2-D9-9B22CY";"T2-D9-5MMQRP";"O2-D8-99N2CT";"Solana (USD)";"50 Jednost.";"169,020";"-";"-";"-";"-";"3,981026";"33 643,65";"-6 097,34";"5 043,90";"-";"-";"-";"-";"-";"-";"-";"-";"-";"-";"-";"-";"-";"-";"-";"-";"-";"-";"-";"-";"-";"-";"-";"-"
"21 Paź 2024 02:07:21";" Likwidacja";"O2-D9-9B22CY";"T2-D9-5MMQRN";"O2-D6-97Z6BV";"Solana (USD)";"34,95 Jednost.";"169,020";"-";"-";"-";"-";"3,981026";"23 516,91";"-4 636,04";"11 141,24";"-";"-";"-";"-";"-";"-";"-";"-";"-";"-";"-";"-";"-";"-";"-";"-";"-";"-";"-";"-";"-";"-";"-";"-"
"21 Paź 2024 02:07:21";" Likwidacja";"O2-D9-9B22CY";"T2-D9-5MMQRM";"O2-D6-97W2F5";"Solana (USD)";"25 Jednost.";"169,020";"-";"-";"-";"-";"3,981026";"16 821,82";"-3 357,50";"15 777,28";"-";"-";"-";"-";"-";"-";"-";"-";"-";"-";"-";"-";"-";"-";"-";"-";"-";"-";"-";"-";"-";"-";"-";"-"
"21 Paź 2024 02:07:21";" Likwidacja";"O2-D9-9B22CY";"T2-D9-5MMQRL";"O2-D6-97Q7VH";"Solana (USD)";"67 Jednost.";"169,020";"-";"-";"-";"-";"3,981026";"45 082,49";"-9 983,92";"19 134,78";"-";"-";"-";"-";"-";"-";"-";"-";"-";"-";"-";"-";"-";"-";"-";"-";"-";"-";"-";"-";"-";"-";"-";"-"
"21 Paź 2024 02:07:21";" Likwidacja";"O2-D9-9B22CY";"T2-D9-5MMQRK";"O2-D5-97BZ7D";"Solana (USD)";"30 Jednost.";"169,020";"-";"-";"-";"-";"3,981026";"20 186,19";"-4 611,94";"29 118,70";"-";"-";"-";"-";"-";"-";"-";"-";"-";"-";"-";"-";"-";"-";"-";"-";"-";"-";"-";"-";"-";"-";"-";"-"
"21 Paź 2024 02:07:21";" Likwidacja";"O2-D9-9B22CX";"T2-D9-5MMQRJ";"O2-D8-99R15K";"Solana (USD)";"30 Jednost.";"168,820";"-";"-";"-";"-";"3,94142";"20 162,30";"2 681,15";"33 730,64";"-";"-";"-";"-";"-";"-";"-";"-";"-";"-";"-";"-";"-";"-";"-";"-";"-";"-";"-";"-";"-";"-";"-";"-"
"21 Paź 2024 02:07:21";" Likwidacja";"O2-D9-9B22CX";"T2-D9-5MMQRH";"O2-D8-99Q3ED";"Solana (USD)";"49 Jednost.";"168,820";"-";"-";"-";"-";"3,94142";"32 931,76";"5 067,33";"31 049,49";"-";"-";"-";"-";"-";"-";"-";"-";"-";"-";"-";"-";"-";"-";"-";"-";"-";"-";"-";"-";"-";"-";"-";"-"
"21 Paź 2024 02:07:21";" Likwidacja";"O2-D9-9B22CX";"T2-D9-5MMQRG";"O2-D8-99KTHY";"Solana (USD)";"60 Jednost.";"168,820";"-";"-";"-";"-";"3,94142";"40 324,60";"5 897,94";"25 982,16";"-";"-";"-";"-";"-";"-";"-";"-";"-";"-";"-";"-";"-";"-";"-";"-";"-";"-";"-";"-";"-";"-";"-";"-"
"21 Paź 2024 02:07:21";" Likwidacja";"O2-D9-9B22CX";"T2-D9-5MMQRF";"O2-D8-99JWX0";"Solana (USD)";"30 Jednost.";"168,820";"-";"-";"-";"-";"3,94142";"20 162,30";"2 953,70";"20 084,22";"-";"-";"-";"-";"-";"-";"-";"-";"-";"-";"-";"-";"-";"-";"-";"-";"-";"-";"-";"-";"-";"-";"-";"-"
"21 Paź 2024 02:07:21";" Likwidacja";"O2-D9-9B22CX";"T2-D9-5MMQRE";"O2-D8-99JVDD";"Solana (USD)";"39 Jednost.";"168,820";"-";"-";"-";"-";"3,94142";"26 210,99";"3 800,61";"17 130,52";"-";"-";"-";"-";"-";"-";"-";"-";"-";"-";"-";"-";"-";"-";"-";"-";"-";"-";"-";"-";"-";"-";"-";"-"
"21 Paź 2024 02:07:21";" Likwidacja";"O2-D9-9B22CX";"T2-D9-5MMQRD";"O2-D5-96WE65";"Solana (USD)";"10 Jednost.";"168,820";"-";"-";"-";"-";"3,94142";"6 720,76";"807,75";"13 329,91";"-";"-";"-";"-";"-";"-";"-";"-";"-";"-";"-";"-";"-";"-";"-";"-";"-";"-";"-";"-";"-";"-";"-";"-"
"18 Paź 2024 23:02:02";"Koszty Utrzymania Pozycji";"1381542929";"-";"-";"Rachunek";"-";"-";"-";"-";"-";"-";"-";"-";"-185,03";"12 522,16";"-";"-";"-";"-";"-";"-185,03";"-";"-";"-";"-";"-";"-";"-";"-";"-";"-";"-";"-";"-";"-";"-";"-";"-";"-"
"18 Paź 2024 23:02:02";"Koszty Utrzymania Pozycji";"O2-D8-9B01G6";"-";"-";"Solana (USD)";"-";"-";"-";"-";"-";"-";"-";"-";"-";"-";"-";"-";"4 576,72";"-10,00000%";"14,83";"0,00";"-";"-";"-";"-";"-";"-";"-";"-";"-";"-";"-";"-";"-";"-";"-";"-";"-";"-"
"18 Paź 2024 23:02:02";"Koszty Utrzymania Pozycji";"O2-D8-99JVDD";"-";"-";"Solana (USD)";"-";"-";"-";"-";"-";"-";"-";"-";"-";"-";"-";"-";"6 036,26";"-27,50000%";"-54,32";"0,00";"-";"-";"-";"-";"-";"-";"-";"-";"-";"-";"-";"-";"-";"-";"-";"-";"-";"-"
"18 Paź 2024 23:02:02";"Koszty Utrzymania Pozycji";"O2-D8-99Q3ED";"-";"-";"Solana (USD)";"-";"-";"-";"-";"-";"-";"-";"-";"-";"-";"-";"-";"7 584,02";"-27,50000%";"-68,25";"0,00";"-";"-";"-";"-";"-";"-";"-";"-";"-";"-";"-";"-";"-";"-";"-";"-";"-";"-"
"18 Paź 2024 23:02:02";"Koszty Utrzymania Pozycji";"O2-D8-99N2CT";"-";"-";"Solana (USD)";"-";"-";"-";"-";"-";"-";"-";"-";"-";"-";"-";"-";"7 738,80";"-10,00000%";"25,07";"0,00";"-";"-";"-";"-";"-";"-";"-";"-";"-";"-";"-";"-";"-";"-";"-";"-";"-";"-"
"18 Paź 2024 23:02:02";"Koszty Utrzymania Pozycji";"O2-D6-97Q7VH";"-";"-";"Solana (USD)";"-";"-";"-";"-";"-";"-";"-";"-";"-";"-";"-";"-";"10 369,99";"-10,00000%";"33,60";"0,00";"-";"-";"-";"-";"-";"-";"-";"-";"-";"-";"-";"-";"-";"-";"-";"-";"-";"-"
"18 Paź 2024 23:02:02";"Koszty Utrzymania Pozycji";"O2-D5-97BZ7D";"-";"-";"Solana (USD)";"-";"-";"-";"-";"-";"-";"-";"-";"-";"-";"-";"-";"4 643,28";"-10,00000%";"15,04";"0,00";"-";"-";"-";"-";"-";"-";"-";"-";"-";"-";"-";"-";"-";"-";"-";"-";"-";"-"
"18 Paź 2024 23:02:02";"Koszty Utrzymania Pozycji";"O2-D5-96WE65";"-";"-";"Solana (USD)";"-";"-";"-";"-";"-";"-";"-";"-";"-";"-";"-";"-";"1 547,76";"-27,50000%";"-13,93";"0,00";"-";"-";"-";"-";"-";"-";"-";"-";"-";"-";"-";"-";"-";"-";"-";"-";"-";"-"
"18 Paź 2024 23:02:02";"Koszty Utrzymania Pozycji";"O2-D8-99JWX0";"-";"-";"Solana (USD)";"-";"-";"-";"-";"-";"-";"-";"-";"-";"-";"-";"-";"4 643,28";"-27,50000%";"-41,78";"0,00";"-";"-";"-";"-";"-";"-";"-";"-";"-";"-";"-";"-";"-";"-";"-";"-";"-";"-"
"18 Paź 2024 23:02:02";"Koszty Utrzymania Pozycji";"O2-D6-97Z6BV";"-";"-";"Solana (USD)";"-";"-";"-";"-";"-";"-";"-";"-";"-";"-";"-";"-";"5 409,42";"-10,00000%";"17,52";"0,00";"-";"-";"-";"-";"-";"-";"-";"-";"-";"-";"-";"-";"-";"-";"-";"-";"-";"-"
"18 Paź 2024 23:02:02";"Koszty Utrzymania Pozycji";"O2-D8-99KTHY";"-";"-";"Solana (USD)";"-";"-";"-";"-";"-";"-";"-";"-";"-";"-";"-";"-";"9 286,56";"-27,50000%";"-83,57";"0,00";"-";"-";"-";"-";"-";"-";"-";"-";"-";"-";"-";"-";"-";"-";"-";"-";"-";"-"
"18 Paź 2024 23:02:02";"Koszty Utrzymania Pozycji";"O2-D6-97W2F5";"-";"-";"Solana (USD)";"-";"-";"-";"-";"-";"-";"-";"-";"-";"-";"-";"-";"3 869,40";"-10,00000%";"12,54";"0,00";"-";"-";"-";"-";"-";"-";"-";"-";"-";"-";"-";"-";"-";"-";"-";"-";"-";"-"
"18 Paź 2024 23:02:02";"Koszty Utrzymania Pozycji";"O2-D8-99R15K";"-";"-";"Solana (USD)";"-";"-";"-";"-";"-";"-";"-";"-";"-";"-";"-";"-";"4 643,28";"-27,50000%";"-41,78";"0,00";"-";"-";"-";"-";"-";"-";"-";"-";"-";"-";"-";"-";"-";"-";"-";"-";"-";"-"
"18 Paź 2024 19:27:02";" Zamknięcie Transakcji";"O2-D8-9B1R6G";"T2-D8-5MMG6R";"O2-D5-96WE65";"Solana (USD)";"7 Jednost.";"155,360";"-";"-";"-";"-";"3,94257";"4 330,71";"194,12";"12 707,19";"-";"-";"-";"-";"-";"-";"-";"-";"-";"-";"-";"-";"-";"-";"-";"-";"-";"-";"-";"-";"-";"-";"-";"-"
"18 Paź 2024 19:26:19";" Zamknięcie Transakcji";"O2-D8-9B1R5Q";"T2-D8-5MMG67";"O2-D8-99YT0E";"Solana (USD)";"10 Jednost.";"155,390";"-";"-";"-";"-";"3,94257";"6 187,93";"83,58";"12 513,07";"-";"-";"-";"-";"-";"-";"-";"-";"-";"-";"-";"-";"-";"-";"-";"-";"-";"-";"-";"-";"-";"-";"-";"-"
"18 Paź 2024 19:26:04";" Zamknięcie Transakcji";"O2-D8-9B1R5F";"T2-D8-5MMG61";"O2-D6-97PWJQ";"Solana (USD)";"10 Jednost.";"155,570";"-";"-";"-";"-";"3,982248";"6 195,18";"-1 047,01";"12 429,49";"-";"-";"-";"-";"-";"-";"-";"-";"-";"-";"-";"-";"-";"-";"-";"-";"-";"-";"-";"-";"-";"-";"-";"-"
"18 Paź 2024 19:25:07";" Zamknięcie Transakcji";"O2-D8-9B1R44";"T2-D8-5MMG4M";"O2-D8-99YT0E";"Solana (USD)";"25 Jednost.";"155,357";"-";"-";"-";"-";"3,94251";"15 466,32";"205,70";"13 476,50";"-";"-";"-";"-";"-";"-";"-";"-";"-";"-";"-";"-";"-";"-";"-";"-";"-";"-";"-";"-";"-";"-";"-";"-"
"18 Paź 2024 19:24:20";" Zamknięcie Transakcji";"O2-D8-9B1R30";"T2-D8-5MMG3J";"O2-D6-97PWJQ";"Solana (USD)";"15 Jednost.";"155,615";"-";"-";"-";"-";"3,981477";"9 293,66";"-1 572,90";"13 270,80";"-";"-";"-";"-";"-";"-";"-";"-";"-";"-";"-";"-";"-";"-";"-";"-";"-";"-";"-";"-";"-";"-";"-";"-"
"18 Paź 2024 19:23:58";" Zamknięcie Transakcji";"O2-D8-9B1R2N";"T2-D8-5MMG38";"O2-D8-99TNCN";"Solana (USD)";"7 Jednost.";"155,398";"-";"-";"-";"-";"3,981326";"4 330,83";"-5,49";"14 843,70";"-";"-";"-";"-";"-";"-";"-";"-";"-";"-";"-";"-";"-";"-";"-";"-";"-";"-";"-";"-";"-";"-";"-";"-"
"18 Paź 2024 19:23:16";" Zamknięcie Transakcji";"O2-D8-9B1R1Y";"T2-D8-5MMG2J";"O2-D6-97PWJQ";"Solana (USD)";"14,5 Jednost.";"155,675";"-";"-";"-";"-";"3,981427";"8 987,22";"-1 523,92";"14 849,19";"-";"-";"-";"-";"-";"-";"-";"-";"-";"-";"-";"-";"-";"-";"-";"-";"-";"-";"-";"-";"-";"-";"-";"-"
"18 Paź 2024 19:22:21";" Zamknięcie Transakcji";"O2-D8-9B1R0T";"T2-D8-5MMG1M";"O2-D5-977RC9";"Solana (USD)";"10 Jednost.";"155,825";"-";"-";"-";"-";"3,981326";"6 203,90";"-1 097,45";"16 373,11";"-";"-";"-";"-";"-";"-";"-";"-";"-";"-";"-";"-";"-";"-";"-";"-";"-";"-";"-";"-";"-";"-";"-";"-"
"18 Paź 2024 18:13:41";" Zamknięcie Transakcji";"O2-D8-9B1MS1";"T2-D8-5MMD33";"O2-D8-99VL9X";"Solana (USD)";"4 Jednost.";"153,857";"-";"-";"-";"-";"3,983992";"2 451,86";"-50,64";"17 470,56";"-";"-";"-";"-";"-";"-";"-";"-";"-";"-";"-";"-";"-";"-";"-";"-";"-";"-";"-";"-";"-";"-";"-";"-"
"18 Paź 2024 18:10:51";" Zamknięcie Transakcji";"O2-D8-9B1MMM";"T2-D8-5MMCYS";"O2-D4-95EL0T";"Solana (USD)";"30 Jednost.";"153,985";"-";"-";"-";"-";"3,984242";"18 405,40";"-372,93";"17 521,20";"-";"-";"-";"-";"-";"-";"-";"-";"-";"-";"-";"-";"-";"-";"-";"-";"-";"-";"-";"-";"-";"-";"-";"-"
"18 Paź 2024 18:09:58";" Zamknięcie Transakcji";"O2-D8-9B1ML0";"T2-D8-5MMCXL";"O2-D5-977RC9";"Solana (USD)";"15 Jednost.";"154,275";"-";"-";"-";"-";"3,984092";"9 219,68";"-1 554,69";"17 894,13";"-";"-";"-";"-";"-";"-";"-";"-";"-";"-";"-";"-";"-";"-";"-";"-";"-";"-";"-";"-";"-";"-";"-";"-"
"18 Paź 2024 18:08:25";" Zamknięcie Transakcji";"O2-D8-9B1MJ8";"T2-D8-5MMCW9";"O2-D5-96SWM1";"Solana (USD)";"15 Jednost.";"154,090";"-";"-";"-";"-";"3,984302";"9 209,11";"-233,68";"19 448,82";"-";"-";"-";"-";"-";"-";"-";"-";"-";"-";"-";"-";"-";"-";"-";"-";"-";"-";"-";"-";"-";"-";"-";"-"
"18 Paź 2024 18:07:40";" Zamknięcie Transakcji";"O2-D8-9B1MHG";"T2-D8-5MMCVM";"O2-D5-977RC9";"Solana (USD)";"25 Jednost.";"154,340";"-";"-";"-";"-";"3,984242";"15 373,19";"-2 597,73";"19 682,50";"-";"-";"-";"-";"-";"-";"-";"-";"-";"-";"-";"-";"-";"-";"-";"-";"-";"-";"-";"-";"-";"-";"-";"-"
"18 Paź 2024 18:06:23";" Zamknięcie Transakcji";"O2-D8-9B1MGC";"T2-D8-5MMCTW";"O2-D5-96SWM1";"Solana (USD)";"25 Jednost.";"154,331";"-";"-";"-";"-";"3,984192";"15 372,10";"-365,45";"22 280,23";"-";"-";"-";"-";"-";"-";"-";"-";"-";"-";"-";"-";"-";"-";"-";"-";"-";"-";"-";"-";"-";"-";"-";"-"
"18 Paź 2024 18:05:10";" Zamknięcie Transakcji";"O2-D8-9B1MF0";"T2-D8-5MMCSQ";"O2-D5-97FD8D";"Solana (USD)";"25 Jednost.";"154,735";"-";"-";"-";"-";"3,984793";"15 414,67";"-2 909,40";"22 645,68";"-";"-";"-";"-";"-";"-";"-";"-";"-";"-";"-";"-";"-";"-";"-";"-";"-";"-";"-";"-";"-";"-";"-";"-"
"18 Paź 2024 18:04:38";" Zamknięcie Transakcji";"O2-D8-9B1MEG";"T2-D8-5MMCRX";"O2-D5-96SWM1";"Solana (USD)";"25 Jednost.";"154,500";"-";"-";"-";"-";"3,984793";"15 391,26";"-348,67";"25 555,08";"-";"-";"-";"-";"-";"-";"-";"-";"-";"-";"-";"-";"-";"-";"-";"-";"-";"-";"-";"-";"-";"-";"-";"-"
"18 Paź 2024 18:03:39";" Zamknięcie Transakcji";"O2-D8-9B1MCJ";"T2-D8-5MMCQK";"O2-D5-97FD8D";"Solana (USD)";"25 Jednost.";"154,654";"-";"-";"-";"-";"3,985304";"15 408,58";"-2 901,70";"25 903,75";"-";"-";"-";"-";"-";"-";"-";"-";"-";"-";"-";"-";"-";"-";"-";"-";"-";"-";"-";"-";"-";"-";"-";"-"
"18 Paź 2024 18:02:39";" Zamknięcie Transakcji";"O2-D8-9B1MBF";"T2-D8-5MMCPS";"O2-D5-96SWM1";"Solana (USD)";"19 Jednost.";"154,580";"-";"-";"-";"-";"3,985354";"11 705,06";"-258,97";"28 805,45";"-";"-";"-";"-";"-";"-";"-";"-";"-";"-";"-";"-";"-";"-";"-";"-";"-";"-";"-";"-";"-";"-";"-";"-"
"18 Paź 2024 18:01:14";" Zamknięcie Transakcji";"O2-D8-9B1M8H";"T2-D8-5MMCN0";"O2-D5-977RC9";"Solana (USD)";"15 Jednost.";"154,785";"-";"-";"-";"-";"3,985154";"9 252,63";"-1 585,59";"29 064,42";"-";"-";"-";"-";"-";"-";"-";"-";"-";"-";"-";"-";"-";"-";"-";"-";"-";"-";"-";"-";"-";"-";"-";"-"
"18 Paź 2024 17:59:13";" Zamknięcie Transakcji";"O2-D8-9B1M5R";"T2-D8-5MMCKZ";"O2-D8-99VJKH";"Solana (USD)";"16,34 Jednost.";"154,735";"-";"-";"-";"-";"3,985905";"10 077,84";"-278,43";"30 650,01";"-";"-";"-";"-";"-";"-";"-";"-";"-";"-";"-";"-";"-";"-";"-";"-";"-";"-";"-";"-";"-";"-";"-";"-"
"18 Paź 2024 17:57:42";" Zamknięcie Transakcji";"O2-D8-9B1M3V";"T2-D8-5MMCJ7";"O2-D5-97FGFP";"Solana (USD)";"25 Jednost.";"154,975";"-";"-";"-";"-";"3,985615";"15 441,76";"-2 977,65";"30 928,44";"-";"-";"-";"-";"-";"-";"-";"-";"-";"-";"-";"-";"-";"-";"-";"-";"-";"-";"-";"-";"-";"-";"-";"-"
"18 Paź 2024 17:56:26";" Zamknięcie Transakcji";"O2-D8-9B1M1V";"T2-D8-5MMCG7";"O2-D8-99VJKH";"Solana (USD)";"25 Jednost.";"154,960";"-";"-";"-";"-";"3,985354";"15 439,26";"-403,52";"33 906,09";"-";"-";"-";"-";"-";"-";"-";"-";"-";"-";"-";"-";"-";"-";"-";"-";"-";"-";"-";"-";"-";"-";"-";"-"
"18 Paź 2024 17:55:02";" Zamknięcie Transakcji";"O2-D8-9B1LYW";"T2-D8-5MMCDP";"O2-D5-97FGFP";"Solana (USD)";"25 Jednost.";"155,055";"-";"-";"-";"-";"3,984853";"15 446,78";"-2 985,05";"34 309,61";"-";"-";"-";"-";"-";"-";"-";"-";"-";"-";"-";"-";"-";"-";"-";"-";"-";"-";"-";"-";"-";"-";"-";"-"
"18 Paź 2024 17:53:00";" Zamknięcie Transakcji";"O2-D8-9B1LR2";"T2-D8-5MMC6R";"O2-D3-94JY88";"Solana (USD)";"25 Jednost.";"154,780";"-";"-";"-";"-";"3,984453";"15 417,84";"-2 742,80";"37 294,66";"-";"-";"-";"-";"-";"-";"-";"-";"-";"-";"-";"-";"-";"-";"-";"-";"-";"-";"-";"-";"-";"-";"-";"-"
"18 Paź 2024 17:50:18";" Zamknięcie Transakcji";"O2-D8-9B1LLH";"T2-D8-5MMC2S";"O2-D4-95K8MW";"Solana (USD)";"25 Jednost.";"155,080";"-";"-";"-";"-";"3,984924";"15 449,55";"-3 765,75";"40 037,46";"-";"-";"-";"-";"-";"-";"-";"-";"-";"-";"-";"-";"-";"-";"-";"-";"-";"-";"-";"-";"-";"-";"-";"-"
"18 Paź 2024 17:49:29";" Zamknięcie Transakcji";"O2-D8-9B1LJW";"T2-D8-5MMC1P";"O2-D8-99TNCN";"Solana (USD)";"25 Jednost.";"154,915";"-";"-";"-";"-";"3,984573";"15 431,75";"-67,74";"43 803,21";"-";"-";"-";"-";"-";"-";"-";"-";"-";"-";"-";"-";"-";"-";"-";"-";"-";"-";"-";"-";"-";"-";"-";"-"
"18 Paź 2024 17:48:53";" Zamknięcie Transakcji";"O2-D8-9B1LHL";"T2-D8-5MMC0P";"O2-D4-95K8MW";"Solana (USD)";"25 Jednost.";"155,032";"-";"-";"-";"-";"3,984623";"15 443,60";"-3 760,69";"43 870,95";"-";"-";"-";"-";"-";"-";"-";"-";"-";"-";"-";"-";"-";"-";"-";"-";"-";"-";"-";"-";"-";"-";"-";"-"
"17 Paź 2024 23:02:03";"Koszty Utrzymania Pozycji";"1381235732";"-";"-";"Rachunek";"-";"-";"-";"-";"-";"-";"-";"-";"-135,04";"47 631,64";"-";"-";"-";"-";"-";"-135,04";"-";"-";"-";"-";"-";"-";"-";"-";"-";"-";"-";"-";"-";"-";"-";"-";"-";"-"
"17 Paź 2024 23:02:03";"Koszty Utrzymania Pozycji";"O2-D8-9B01G6";"-";"-";"Solana (USD)";"-";"-";"-";"-";"-";"-";"-";"-";"-";"-";"-";"-";"4 425,20";"-10,00000%";"4,80";"0,00";"-";"-";"-";"-";"-";"-";"-";"-";"-";"-";"-";"-";"-";"-";"-";"-";"-";"-"
"17 Paź 2024 23:02:03";"Koszty Utrzymania Pozycji";"O2-D5-96WE65";"-";"-";"Solana (USD)";"-";"-";"-";"-";"-";"-";"-";"-";"-";"-";"-";"-";"2 544,08";"-27,50000%";"-7,66";"0,00";"-";"-";"-";"-";"-";"-";"-";"-";"-";"-";"-";"-";"-";"-";"-";"-";"-";"-"
"17 Paź 2024 23:02:03";"Koszty Utrzymania Pozycji";"O2-D8-99VJKH";"-";"-";"Solana (USD)";"-";"-";"-";"-";"-";"-";"-";"-";"-";"-";"-";"-";"6 186,61";"-27,50000%";"-18,64";"0,00";"-";"-";"-";"-";"-";"-";"-";"-";"-";"-";"-";"-";"-";"-";"-";"-";"-";"-"
"17 Paź 2024 23:02:03";"Koszty Utrzymania Pozycji";"O2-D8-99JVDD";"-";"-";"Solana (USD)";"-";"-";"-";"-";"-";"-";"-";"-";"-";"-";"-";"-";"5 836,42";"-27,50000%";"-17,58";"0,00";"-";"-";"-";"-";"-";"-";"-";"-";"-";"-";"-";"-";"-";"-";"-";"-";"-";"-"
"17 Paź 2024 23:02:03";"Koszty Utrzymania Pozycji";"O2-D8-99VL9X";"-";"-";"Solana (USD)";"-";"-";"-";"-";"-";"-";"-";"-";"-";"-";"-";"-";"598,60";"-27,50000%";"-1,80";"0,00";"-";"-";"-";"-";"-";"-";"-";"-";"-";"-";"-";"-";"-";"-";"-";"-";"-";"-"
"17 Paź 2024 23:02:03";"Koszty Utrzymania Pozycji";"O2-D8-99Q3ED";"-";"-";"Solana (USD)";"-";"-";"-";"-";"-";"-";"-";"-";"-";"-";"-";"-";"7 332,94";"-27,50000%";"-22,09";"0,00";"-";"-";"-";"-";"-";"-";"-";"-";"-";"-";"-";"-";"-";"-";"-";"-";"-";"-"
"17 Paź 2024 23:02:03";"Koszty Utrzymania Pozycji";"O2-D8-99N2CT";"-";"-";"Solana (USD)";"-";"-";"-";"-";"-";"-";"-";"-";"-";"-";"-";"-";"7 482,60";"-10,00000%";"8,12";"0,00";"-";"-";"-";"-";"-";"-";"-";"-";"-";"-";"-";"-";"-";"-";"-";"-";"-";"-"
"17 Paź 2024 23:02:03";"Koszty Utrzymania Pozycji";"O2-D8-99TNCN";"-";"-";"Solana (USD)";"-";"-";"-";"-";"-";"-";"-";"-";"-";"-";"-";"-";"4 788,86";"-27,50000%";"-14,43";"0,00";"-";"-";"-";"-";"-";"-";"-";"-";"-";"-";"-";"-";"-";"-";"-";"-";"-";"-"
"17 Paź 2024 23:02:03";"Koszty Utrzymania Pozycji";"O2-D6-97Q7VH";"-";"-";"Solana (USD)";"-";"-";"-";"-";"-";"-";"-";"-";"-";"-";"-";"-";"10 026,68";"-10,00000%";"10,88";"0,00";"-";"-";"-";"-";"-";"-";"-";"-";"-";"-";"-";"-";"-";"-";"-";"-";"-";"-"
"17 Paź 2024 23:02:03";"Koszty Utrzymania Pozycji";"O2-D5-97BZ7D";"-";"-";"Solana (USD)";"-";"-";"-";"-";"-";"-";"-";"-";"-";"-";"-";"-";"4 489,56";"-10,00000%";"4,87";"0,00";"-";"-";"-";"-";"-";"-";"-";"-";"-";"-";"-";"-";"-";"-";"-";"-";"-";"-"
"17 Paź 2024 23:02:03";"Koszty Utrzymania Pozycji";"O2-D5-97FGFP";"-";"-";"Solana (USD)";"-";"-";"-";"-";"-";"-";"-";"-";"-";"-";"-";"-";"7 482,60";"-10,00000%";"8,12";"0,00";"-";"-";"-";"-";"-";"-";"-";"-";"-";"-";"-";"-";"-";"-";"-";"-";"-";"-"
"17 Paź 2024 23:02:03";"Koszty Utrzymania Pozycji";"O2-D5-96SWM1";"-";"-";"Solana (USD)";"-";"-";"-";"-";"-";"-";"-";"-";"-";"-";"-";"-";"12 570,76";"-27,50000%";"-37,87";"0,00";"-";"-";"-";"-";"-";"-";"-";"-";"-";"-";"-";"-";"-";"-";"-";"-";"-";"-"
"17 Paź 2024 23:02:03";"Koszty Utrzymania Pozycji";"O2-D4-95EL0T";"-";"-";"Solana (USD)";"-";"-";"-";"-";"-";"-";"-";"-";"-";"-";"-";"-";"4 489,56";"-27,50000%";"-13,53";"0,00";"-";"-";"-";"-";"-";"-";"-";"-";"-";"-";"-";"-";"-";"-";"-";"-";"-";"-"
"17 Paź 2024 23:02:03";"Koszty Utrzymania Pozycji";"O2-D5-97FD8D";"-";"-";"Solana (USD)";"-";"-";"-";"-";"-";"-";"-";"-";"-";"-";"-";"-";"7 482,60";"-10,00000%";"8,12";"0,00";"-";"-";"-";"-";"-";"-";"-";"-";"-";"-";"-";"-";"-";"-";"-";"-";"-";"-"
"17 Paź 2024 23:02:03";"Koszty Utrzymania Pozycji";"O2-D4-95K8MW";"-";"-";"Solana (USD)";"-";"-";"-";"-";"-";"-";"-";"-";"-";"-";"-";"-";"7 482,60";"-10,00000%";"8,12";"0,00";"-";"-";"-";"-";"-";"-";"-";"-";"-";"-";"-";"-";"-";"-";"-";"-";"-";"-"
"17 Paź 2024 23:02:03";"Koszty Utrzymania Pozycji";"O2-D3-94JY88";"-";"-";"Solana (USD)";"-";"-";"-";"-";"-";"-";"-";"-";"-";"-";"-";"-";"3 741,30";"-27,50000%";"-11,27";"0,00";"-";"-";"-";"-";"-";"-";"-";"-";"-";"-";"-";"-";"-";"-";"-";"-";"-";"-"
"17 Paź 2024 23:02:03";"Koszty Utrzymania Pozycji";"O2-D8-99JWX0";"-";"-";"Solana (USD)";"-";"-";"-";"-";"-";"-";"-";"-";"-";"-";"-";"-";"4 489,56";"-27,50000%";"-13,53";"0,00";"-";"-";"-";"-";"-";"-";"-";"-";"-";"-";"-";"-";"-";"-";"-";"-";"-";"-"
"17 Paź 2024 23:02:03";"Koszty Utrzymania Pozycji";"O2-D6-97Z6BV";"-";"-";"Solana (USD)";"-";"-";"-";"-";"-";"-";"-";"-";"-";"-";"-";"-";"5 230,33";"-10,00000%";"5,67";"0,00";"-";"-";"-";"-";"-";"-";"-";"-";"-";"-";"-";"-";"-";"-";"-";"-";"-";"-"
"17 Paź 2024 23:02:03";"Koszty Utrzymania Pozycji";"O2-D8-99KTHY";"-";"-";"Solana (USD)";"-";"-";"-";"-";"-";"-";"-";"-";"-";"-";"-";"-";"8 979,12";"-27,50000%";"-27,05";"0,00";"-";"-";"-";"-";"-";"-";"-";"-";"-";"-";"-";"-";"-";"-";"-";"-";"-";"-"
"17 Paź 2024 23:02:03";"Koszty Utrzymania Pozycji";"O2-D6-97W2F5";"-";"-";"Solana (USD)";"-";"-";"-";"-";"-";"-";"-";"-";"-";"-";"-";"-";"3 741,30";"-10,00000%";"4,06";"0,00";"-";"-";"-";"-";"-";"-";"-";"-";"-";"-";"-";"-";"-";"-";"-";"-";"-";"-"
"17 Paź 2024 23:02:03";"Koszty Utrzymania Pozycji";"O2-D8-99R15K";"-";"-";"Solana (USD)";"-";"-";"-";"-";"-";"-";"-";"-";"-";"-";"-";"-";"4 489,56";"-27,50000%";"-13,53";"0,00";"-";"-";"-";"-";"-";"-";"-";"-";"-";"-";"-";"-";"-";"-";"-";"-";"-";"-"
"17 Paź 2024 23:02:03";"Koszty Utrzymania Pozycji";"O2-D8-99YT0E";"-";"-";"Solana (USD)";"-";"-";"-";"-";"-";"-";"-";"-";"-";"-";"-";"-";"5 237,82";"-27,50000%";"-15,78";"0,00";"-";"-";"-";"-";"-";"-";"-";"-";"-";"-";"-";"-";"-";"-";"-";"-";"-";"-"
"17 Paź 2024 23:02:03";"Koszty Utrzymania Pozycji";"O2-D6-97PWJQ";"-";"-";"Solana (USD)";"-";"-";"-";"-";"-";"-";"-";"-";"-";"-";"-";"-";"5 911,25";"-10,00000%";"6,41";"0,00";"-";"-";"-";"-";"-";"-";"-";"-";"-";"-";"-";"-";"-";"-";"-";"-";"-";"-"
"17 Paź 2024 23:02:03";"Koszty Utrzymania Pozycji";"O2-D5-977RC9";"-";"-";"Solana (USD)";"-";"-";"-";"-";"-";"-";"-";"-";"-";"-";"-";"-";"9 727,38";"-10,00000%";"10,55";"0,00";"-";"-";"-";"-";"-";"-";"-";"-";"-";"-";"-";"-";"-";"-";"-";"-";"-";"-"
"17 Paź 2024 20:04:27";"Transakcja Sprzedaży";"O2-D8-9B01G6";"T2-D8-5ML0CN";"-";"Solana (USD)";"29,57 Jednost.";"148,735";"-";"-";"-";"-";"4,001637";"17 599,57";"0,00";"-";"-";"-";"-";"-";"-";"-";"-";"-";"-";"-";"-";"-";"-";"-";"-";"-";"-";"-";"-";"-";"-";"-";"-";"-"
"17 Paź 2024 11:11:41";" Transakcja Kupna";"O2-D8-99YT0E";"T2-D8-5MJYCY";"-";"Solana (USD)";"35 Jednost.";"153,270";"-";"-";"-";"-";"3,997909";"21 446,58";"0,00";"-";"-";"-";"-";"-";"-";"-";"-";"-";"-";"-";"-";"-";"-";"-";"-";"-";"-";"-";"-";"-";"-";"-";"-";"-"
"17 Paź 2024 09:30:44";" Zamknięcie Transakcji";"O2-D8-99YNH9";"T2-D8-5MJTFZ";"O2-D5-96WE65";"Solana (USD)";"13 Jednost.";"151,760";"-";"-";"-";"-";"3,94996";"7 871,10";"176,33";"47 766,68";"-";"-";"-";"-";"-";"-";"-";"-";"-";"-";"-";"-";"-";"-";"-";"-";"-";"-";"-";"-";"-";"-";"-";"-"
"17 Paź 2024 07:04:30";" Zamknięcie Transakcji";"O2-D8-99YGGT";"T2-D8-5MJNDT";"O2-D8-99W4DP";"Solana (USD)";"12,89 Jednost.";"153,535";"-";"-";"-";"-";"3,9435";"7 882,85";"23,69";"47 590,35";"-";"-";"-";"-";"-";"-";"-";"-";"-";"-";"-";"-";"-";"-";"-";"-";"-";"-";"-";"-";"-";"-";"-";"-"
"16 Paź 2024 23:02:08";"Koszty Utrzymania Pozycji";"1380923848";"-";"-";"Rachunek";"-";"-";"-";"-";"-";"-";"-";"-";"-131,18";"47 566,66";"-";"-";"-";"-";"-";"-131,18";"-";"-";"-";"-";"-";"-";"-";"-";"-";"-";"-";"-";"-";"-";"-";"-";"-";"-"
"16 Paź 2024 23:02:08";"Koszty Utrzymania Pozycji";"O2-D8-99VJKH";"-";"-";"Solana (USD)";"-";"-";"-";"-";"-";"-";"-";"-";"-";"-";"-";"-";"6 382,89";"-27,50000%";"-19,13";"0,00";"-";"-";"-";"-";"-";"-";"-";"-";"-";"-";"-";"-";"-";"-";"-";"-";"-";"-"
"16 Paź 2024 23:02:08";"Koszty Utrzymania Pozycji";"O2-D8-99JVDD";"-";"-";"Solana (USD)";"-";"-";"-";"-";"-";"-";"-";"-";"-";"-";"-";"-";"6 021,60";"-27,50000%";"-18,04";"0,00";"-";"-";"-";"-";"-";"-";"-";"-";"-";"-";"-";"-";"-";"-";"-";"-";"-";"-"
"16 Paź 2024 23:02:08";"Koszty Utrzymania Pozycji";"O2-D8-99VL9X";"-";"-";"Solana (USD)";"-";"-";"-";"-";"-";"-";"-";"-";"-";"-";"-";"-";"617,60";"-27,50000%";"-1,85";"0,00";"-";"-";"-";"-";"-";"-";"-";"-";"-";"-";"-";"-";"-";"-";"-";"-";"-";"-"
"16 Paź 2024 23:02:08";"Koszty Utrzymania Pozycji";"O2-D8-99Q3ED";"-";"-";"Solana (USD)";"-";"-";"-";"-";"-";"-";"-";"-";"-";"-";"-";"-";"7 565,60";"-27,50000%";"-22,67";"0,00";"-";"-";"-";"-";"-";"-";"-";"-";"-";"-";"-";"-";"-";"-";"-";"-";"-";"-"
"16 Paź 2024 23:02:08";"Koszty Utrzymania Pozycji";"O2-D8-99N2CT";"-";"-";"Solana (USD)";"-";"-";"-";"-";"-";"-";"-";"-";"-";"-";"-";"-";"7 720,00";"-10,00000%";"8,33";"0,00";"-";"-";"-";"-";"-";"-";"-";"-";"-";"-";"-";"-";"-";"-";"-";"-";"-";"-"
"16 Paź 2024 23:02:08";"Koszty Utrzymania Pozycji";"O2-D8-99TNCN";"-";"-";"Solana (USD)";"-";"-";"-";"-";"-";"-";"-";"-";"-";"-";"-";"-";"4 940,80";"-27,50000%";"-14,80";"0,00";"-";"-";"-";"-";"-";"-";"-";"-";"-";"-";"-";"-";"-";"-";"-";"-";"-";"-"
"16 Paź 2024 23:02:08";"Koszty Utrzymania Pozycji";"O2-D6-97Q7VH";"-";"-";"Solana (USD)";"-";"-";"-";"-";"-";"-";"-";"-";"-";"-";"-";"-";"10 344,80";"-10,00000%";"11,16";"0,00";"-";"-";"-";"-";"-";"-";"-";"-";"-";"-";"-";"-";"-";"-";"-";"-";"-";"-"
"16 Paź 2024 23:02:08";"Koszty Utrzymania Pozycji";"O2-D5-97BZ7D";"-";"-";"Solana (USD)";"-";"-";"-";"-";"-";"-";"-";"-";"-";"-";"-";"-";"4 632,00";"-10,00000%";"5,00";"0,00";"-";"-";"-";"-";"-";"-";"-";"-";"-";"-";"-";"-";"-";"-";"-";"-";"-";"-"
"16 Paź 2024 23:02:08";"Koszty Utrzymania Pozycji";"O2-D8-99W4DP";"-";"-";"Solana (USD)";"-";"-";"-";"-";"-";"-";"-";"-";"-";"-";"-";"-";"1 990,21";"-10,00000%";"2,15";"0,00";"-";"-";"-";"-";"-";"-";"-";"-";"-";"-";"-";"-";"-";"-";"-";"-";"-";"-"
"16 Paź 2024 23:02:08";"Koszty Utrzymania Pozycji";"O2-D5-97FGFP";"-";"-";"Solana (USD)";"-";"-";"-";"-";"-";"-";"-";"-";"-";"-";"-";"-";"7 720,00";"-10,00000%";"8,33";"0,00";"-";"-";"-";"-";"-";"-";"-";"-";"-";"-";"-";"-";"-";"-";"-";"-";"-";"-"
"16 Paź 2024 23:02:08";"Koszty Utrzymania Pozycji";"O2-D5-96SWM1";"-";"-";"Solana (USD)";"-";"-";"-";"-";"-";"-";"-";"-";"-";"-";"-";"-";"12 969,60";"-27,50000%";"-38,86";"0,00";"-";"-";"-";"-";"-";"-";"-";"-";"-";"-";"-";"-";"-";"-";"-";"-";"-";"-"
"16 Paź 2024 23:02:08";"Koszty Utrzymania Pozycji";"O2-D4-95EL0T";"-";"-";"Solana (USD)";"-";"-";"-";"-";"-";"-";"-";"-";"-";"-";"-";"-";"4 632,00";"-27,50000%";"-13,88";"0,00";"-";"-";"-";"-";"-";"-";"-";"-";"-";"-";"-";"-";"-";"-";"-";"-";"-";"-"
"16 Paź 2024 23:02:08";"Koszty Utrzymania Pozycji";"O2-D5-97FD8D";"-";"-";"Solana (USD)";"-";"-";"-";"-";"-";"-";"-";"-";"-";"-";"-";"-";"7 720,00";"-10,00000%";"8,33";"0,00";"-";"-";"-";"-";"-";"-";"-";"-";"-";"-";"-";"-";"-";"-";"-";"-";"-";"-"
"16 Paź 2024 23:02:08";"Koszty Utrzymania Pozycji";"O2-D4-95K8MW";"-";"-";"Solana (USD)";"-";"-";"-";"-";"-";"-";"-";"-";"-";"-";"-";"-";"7 720,00";"-10,00000%";"8,33";"0,00";"-";"-";"-";"-";"-";"-";"-";"-";"-";"-";"-";"-";"-";"-";"-";"-";"-";"-"
"16 Paź 2024 23:02:08";"Koszty Utrzymania Pozycji";"O2-D3-94JY88";"-";"-";"Solana (USD)";"-";"-";"-";"-";"-";"-";"-";"-";"-";"-";"-";"-";"3 860,00";"-27,50000%";"-11,57";"0,00";"-";"-";"-";"-";"-";"-";"-";"-";"-";"-";"-";"-";"-";"-";"-";"-";"-";"-"
"16 Paź 2024 23:02:08";"Koszty Utrzymania Pozycji";"O2-D8-99JWX0";"-";"-";"Solana (USD)";"-";"-";"-";"-";"-";"-";"-";"-";"-";"-";"-";"-";"4 632,00";"-27,50000%";"-13,88";"0,00";"-";"-";"-";"-";"-";"-";"-";"-";"-";"-";"-";"-";"-";"-";"-";"-";"-";"-"
"16 Paź 2024 23:02:08";"Koszty Utrzymania Pozycji";"O2-D5-96WE65";"-";"-";"Solana (USD)";"-";"-";"-";"-";"-";"-";"-";"-";"-";"-";"-";"-";"4 632,00";"-27,50000%";"-13,88";"0,00";"-";"-";"-";"-";"-";"-";"-";"-";"-";"-";"-";"-";"-";"-";"-";"-";"-";"-"
"16 Paź 2024 23:02:08";"Koszty Utrzymania Pozycji";"O2-D6-97Z6BV";"-";"-";"Solana (USD)";"-";"-";"-";"-";"-";"-";"-";"-";"-";"-";"-";"-";"5 396,28";"-10,00000%";"5,82";"0,00";"-";"-";"-";"-";"-";"-";"-";"-";"-";"-";"-";"-";"-";"-";"-";"-";"-";"-"
"16 Paź 2024 23:02:08";"Koszty Utrzymania Pozycji";"O2-D8-99KTHY";"-";"-";"Solana (USD)";"-";"-";"-";"-";"-";"-";"-";"-";"-";"-";"-";"-";"9 264,00";"-27,50000%";"-27,76";"0,00";"-";"-";"-";"-";"-";"-";"-";"-";"-";"-";"-";"-";"-";"-";"-";"-";"-";"-"
"16 Paź 2024 23:02:08";"Koszty Utrzymania Pozycji";"O2-D6-97W2F5";"-";"-";"Solana (USD)";"-";"-";"-";"-";"-";"-";"-";"-";"-";"-";"-";"-";"3 860,00";"-10,00000%";"4,16";"0,00";"-";"-";"-";"-";"-";"-";"-";"-";"-";"-";"-";"-";"-";"-";"-";"-";"-";"-"
"16 Paź 2024 23:02:08";"Koszty Utrzymania Pozycji";"O2-D8-99R15K";"-";"-";"Solana (USD)";"-";"-";"-";"-";"-";"-";"-";"-";"-";"-";"-";"-";"4 632,00";"-27,50000%";"-13,88";"0,00";"-";"-";"-";"-";"-";"-";"-";"-";"-";"-";"-";"-";"-";"-";"-";"-";"-";"-"
"16 Paź 2024 23:02:08";"Koszty Utrzymania Pozycji";"O2-D6-97PWJQ";"-";"-";"Solana (USD)";"-";"-";"-";"-";"-";"-";"-";"-";"-";"-";"-";"-";"6 098,80";"-10,00000%";"6,58";"0,00";"-";"-";"-";"-";"-";"-";"-";"-";"-";"-";"-";"-";"-";"-";"-";"-";"-";"-"
"16 Paź 2024 23:02:08";"Koszty Utrzymania Pozycji";"O2-D5-977RC9";"-";"-";"Solana (USD)";"-";"-";"-";"-";"-";"-";"-";"-";"-";"-";"-";"-";"10 036,00";"-10,00000%";"10,83";"0,00";"-";"-";"-";"-";"-";"-";"-";"-";"-";"-";"-";"-";"-";"-";"-";"-";"-";"-"
"16 Paź 2024 19:13:34";" Zamknięcie Transakcji";"O2-D8-99XZ6P";"T2-D8-5MJ7PV";"O2-D8-99TT52";"Solana (USD)";"4 Jednost.";"154,775";"-";"-";"-";"-";"3,93574";"2 461,11";"0,47";"47 697,84";"-";"-";"-";"-";"-";"-";"-";"-";"-";"-";"-";"-";"-";"-";"-";"-";"-";"-";"-";"-";"-";"-";"-";"-"
"16 Paź 2024 19:12:59";"Zmodyfikowano Transakcję Sprzedaży";"O2-D8-99W4DP";"T2-D8-5MGQ2G";"-";"Solana (USD)";"12,89 Jednost.";"154,001";"-";"-";"152,000";"-";"-";"-";"0,00";"-";"-";"-";"-";"-";"-";"-";"-";"-";"-";"-";"-";"-";"-";"-";"-";"-";"-";"-";"-";"-";"-";"-";"-";"-"
"16 Paź 2024 18:58:22";" Zamknięcie Transakcji";"O2-D8-99XYLN";"T2-D8-5MJ774";"O2-D8-99TT52";"Solana (USD)";"2 Jednost.";"155,235";"-";"-";"-";"-";"3,93495";"1 233,96";"3,86";"47 697,37";"-";"-";"-";"-";"-";"-";"-";"-";"-";"-";"-";"-";"-";"-";"-";"-";"-";"-";"-";"-";"-";"-";"-";"-"
"16 Paź 2024 18:56:53";"Stop Loss";"O2-D8-99XX0Y";"T2-D8-5MJ754";"-";"Solana (USD)";"31,37 Jednost.";"155,200";"-";"-";"-";"-";"3,93495";"19 350,31";"41,35";"47 693,51";"-";"-";"-";"-";"-";"-";"-";"-";"-";"-";"-";"-";"-";"-";"-";"-";"-";"-";"-";"-";"-";"-";"-";"-"
"16 Paź 2024 18:56:29";" Zmodyfikowano Transakcję Kupna";"O2-D8-99XX0Y";"T2-D8-5MJ61W";"-";"Solana (USD)";"31,37 Jednost.";"154,865";"-";"155,200";"155,700";"-";"-";"-";"0,00";"-";"-";"-";"-";"-";"-";"-";"-";"-";"-";"-";"-";"-";"-";"-";"-";"-";"-";"-";"-";"-";"-";"-";"-";"-"
"16 Paź 2024 18:19:44";" Zmodyfikowano Transakcję Kupna";"O2-D8-99XX0Y";"T2-D8-5MJ61W";"-";"Solana (USD)";"31,37 Jednost.";"154,865";"-";"-";"155,700";"-";"-";"-";"0,00";"-";"-";"-";"-";"-";"-";"-";"-";"-";"-";"-";"-";"-";"-";"-";"-";"-";"-";"-";"-";"-";"-";"-";"-";"-"
"16 Paź 2024 18:19:06";"Zmodyfikowano Transakcję Sprzedaży";"O2-D8-99W4DP";"T2-D8-5MGQ2G";"-";"Solana (USD)";"12,89 Jednost.";"154,001";"-";"-";"-";"-";"-";"-";"0,00";"-";"-";"-";"-";"-";"-";"-";"-";"-";"-";"-";"-";"-";"-";"-";"-";"-";"-";"-";"-";"-";"-";"-";"-";"-"
"16 Paź 2024 18:18:37";" Transakcja Kupna";"O2-D8-99XX0Y";"T2-D8-5MJ61W";"-";"Solana (USD)";"31,37 Jednost.";"154,865";"-";"-";"-";"-";"3,972368";"19 298,22";"0,00";"-";"-";"-";"-";"-";"-";"-";"-";"-";"-";"-";"-";"-";"-";"-";"-";"-";"-";"-";"-";"-";"-";"-";"-";"-"
"16 Paź 2024 16:51:04";" Zamknięcie Transakcji";"O2-D8-99XQ9L";"T2-D8-5MJ18J";"O2-D8-99TT52";"Solana (USD)";"4 Jednost.";"155,110";"-";"-";"-";"-";"3,93264";"2 464,49";"5,74";"47 652,16";"-";"-";"-";"-";"-";"-";"-";"-";"-";"-";"-";"-";"-";"-";"-";"-";"-";"-";"-";"-";"-";"-";"-";"-"
"16 Paź 2024 16:49:07";"Zmodyfikowano Transakcję Sprzedaży";"O2-D8-99W4DP";"T2-D8-5MGQ2G";"-";"Solana (USD)";"12,89 Jednost.";"154,001";"-";"-";"153,500";"-";"-";"-";"0,00";"-";"-";"-";"-";"-";"-";"-";"-";"-";"-";"-";"-";"-";"-";"-";"-";"-";"-";"-";"-";"-";"-";"-";"-";"-"
"16 Paź 2024 16:21:51";" Zamknięcie Transakcji";"O2-D8-99XM14";"T2-D8-5MHYGC";"O2-D8-99VSCX";"Solana (USD)";"10 Jednost.";"155,935";"-";"-";"-";"-";"3,93182";"6 192,68";"104,59";"47 646,42";"-";"-";"-";"-";"-";"-";"-";"-";"-";"-";"-";"-";"-";"-";"-";"-";"-";"-";"-";"-";"-";"-";"-";"-"
"16 Paź 2024 16:19:55";"Stop Loss";"O2-D8-99XEX2";"T2-D8-5MHY9Y";"-";"Solana (USD)";"16 Jednost.";"156,195";"-";"-";"-";"-";"3,93093";"9 922,61";"93,08";"47 541,83";"-";"-";"-";"-";"-";"-";"-";"-";"-";"-";"-";"-";"-";"-";"-";"-";"-";"-";"-";"-";"-";"-";"-";"-"
"16 Paź 2024 16:18:18";"Zmodyfikowano Take Profit";"O2-D8-99XEX2";"-";"O2-D8-99XF28";"Solana (USD)";"16 Jednost.";"154,715";"-";"-";"157,500";"-";"-";"-";"-";"-";"-";"-";"-";"-";"-";"-";"-";"-";"-";"-";"-";"-";"-";"-";"-";"-";"-";"-";"-";"-";"-";"-";"-";"-"
"16 Paź 2024 16:18:18";"Zmodyfikowano Stop Loss";"O2-D8-99XEX2";"-";"O2-D8-99XLJQ";"Solana (USD)";"16 Jednost.";"154,715";"-";"156,200";"-";"-";"-";"-";"-";"-";"-";"-";"-";"-";"-";"-";"-";"-";"-";"-";"-";"-";"-";"-";"-";"-";"-";"-";"-";"-";"-";"-";"-";"-"
"16 Paź 2024 16:17:34";" Zmodyfikowano Transakcję Kupna";"O2-D8-99XEX2";"T2-D8-5MHSDP";"-";"Solana (USD)";"16 Jednost.";"154,715";"-";"156,000";"157,000";"-";"-";"-";"0,00";"-";"-";"-";"-";"-";"-";"-";"-";"-";"-";"-";"-";"-";"-";"-";"-";"-";"-";"-";"-";"-";"-";"-";"-";"-"
"16 Paź 2024 16:11:11";"Zmodyfikowano Take Profit";"O2-D8-99XEX2";"-";"O2-D8-99XF28";"Solana (USD)";"16 Jednost.";"154,715";"-";"-";"157,000";"-";"-";"-";"-";"-";"-";"-";"-";"-";"-";"-";"-";"-";"-";"-";"-";"-";"-";"-";"-";"-";"-";"-";"-";"-";"-";"-";"-";"-"
"16 Paź 2024 15:42:31";" Zmodyfikowano Transakcję Kupna";"O2-D8-99XEX2";"T2-D8-5MHSDP";"-";"Solana (USD)";"16 Jednost.";"154,715";"-";"-";"156,000";"-";"-";"-";"0,00";"-";"-";"-";"-";"-";"-";"-";"-";"-";"-";"-";"-";"-";"-";"-";"-";"-";"-";"-";"-";"-";"-";"-";"-";"-"
"16 Paź 2024 15:41:08";" Transakcja Kupna";"O2-D8-99XEX2";"T2-D8-5MHSDP";"-";"Solana (USD)";"16 Jednost.";"154,715";"-";"-";"-";"-";"3,968992";"9 825,00";"0,00";"-";"-";"-";"-";"-";"-";"-";"-";"-";"-";"-";"-";"-";"-";"-";"-";"-";"-";"-";"-";"-";"-";"-";"-";"-"
"16 Paź 2024 03:04:10";" Zamknięcie Transakcji";"O2-D8-99WK23";"T2-D8-5MH2KQ";"O2-D8-99W4DP";"Solana (USD)";"20,51 Jednost.";"153,894";"-";"-";"-";"-";"3,92435";"12 511,17";"8,61";"47 448,75";"-";"-";"-";"-";"-";"-";"-";"-";"-";"-";"-";"-";"-";"-";"-";"-";"-";"-";"-";"-";"-";"-";"-";"-"
"15 Paź 2024 23:02:00";"Koszty Utrzymania Pozycji";"1380589734";"-";"-";"Rachunek";"-";"-";"-";"-";"-";"-";"-";"-";"-135,07";"47 440,14";"-";"-";"-";"-";"-";"-135,07";"-";"-";"-";"-";"-";"-";"-";"-";"-";"-";"-";"-";"-";"-";"-";"-";"-";"-"
"15 Paź 2024 23:02:00";"Koszty Utrzymania Pozycji";"O2-D8-99VSCX";"-";"-";"Solana (USD)";"-";"-";"-";"-";"-";"-";"-";"-";"-";"-";"-";"-";"1 528,00";"-27,50000%";"-4,56";"0,00";"-";"-";"-";"-";"-";"-";"-";"-";"-";"-";"-";"-";"-";"-";"-";"-";"-";"-"
"15 Paź 2024 23:02:00";"Koszty Utrzymania Pozycji";"O2-D8-99W4DP";"-";"-";"Solana (USD)";"-";"-";"-";"-";"-";"-";"-";"-";"-";"-";"-";"-";"5 103,52";"-10,00000%";"5,48";"0,00";"-";"-";"-";"-";"-";"-";"-";"-";"-";"-";"-";"-";"-";"-";"-";"-";"-";"-"
"15 Paź 2024 23:02:00";"Koszty Utrzymania Pozycji";"O2-D8-99TT52";"-";"-";"Solana (USD)";"-";"-";"-";"-";"-";"-";"-";"-";"-";"-";"-";"-";"1 528,00";"-27,50000%";"-4,56";"0,00";"-";"-";"-";"-";"-";"-";"-";"-";"-";"-";"-";"-";"-";"-";"-";"-";"-";"-"
"15 Paź 2024 23:02:00";"Koszty Utrzymania Pozycji";"O2-D8-99VJKH";"-";"-";"Solana (USD)";"-";"-";"-";"-";"-";"-";"-";"-";"-";"-";"-";"-";"6 316,75";"-27,50000%";"-18,85";"0,00";"-";"-";"-";"-";"-";"-";"-";"-";"-";"-";"-";"-";"-";"-";"-";"-";"-";"-"
"15 Paź 2024 23:02:00";"Koszty Utrzymania Pozycji";"O2-D8-99JVDD";"-";"-";"Solana (USD)";"-";"-";"-";"-";"-";"-";"-";"-";"-";"-";"-";"-";"5 959,20";"-27,50000%";"-17,79";"0,00";"-";"-";"-";"-";"-";"-";"-";"-";"-";"-";"-";"-";"-";"-";"-";"-";"-";"-"
"15 Paź 2024 23:02:00";"Koszty Utrzymania Pozycji";"O2-D8-99VL9X";"-";"-";"Solana (USD)";"-";"-";"-";"-";"-";"-";"-";"-";"-";"-";"-";"-";"611,20";"-27,50000%";"-1,82";"0,00";"-";"-";"-";"-";"-";"-";"-";"-";"-";"-";"-";"-";"-";"-";"-";"-";"-";"-"
"15 Paź 2024 23:02:00";"Koszty Utrzymania Pozycji";"O2-D8-99Q3ED";"-";"-";"Solana (USD)";"-";"-";"-";"-";"-";"-";"-";"-";"-";"-";"-";"-";"7 487,20";"-27,50000%";"-22,35";"0,00";"-";"-";"-";"-";"-";"-";"-";"-";"-";"-";"-";"-";"-";"-";"-";"-";"-";"-"
"15 Paź 2024 23:02:00";"Koszty Utrzymania Pozycji";"O2-D8-99N2CT";"-";"-";"Solana (USD)";"-";"-";"-";"-";"-";"-";"-";"-";"-";"-";"-";"-";"7 640,00";"-10,00000%";"8,21";"0,00";"-";"-";"-";"-";"-";"-";"-";"-";"-";"-";"-";"-";"-";"-";"-";"-";"-";"-"
"15 Paź 2024 23:02:00";"Koszty Utrzymania Pozycji";"O2-D8-99TNCN";"-";"-";"Solana (USD)";"-";"-";"-";"-";"-";"-";"-";"-";"-";"-";"-";"-";"4 889,60";"-27,50000%";"-14,59";"0,00";"-";"-";"-";"-";"-";"-";"-";"-";"-";"-";"-";"-";"-";"-";"-";"-";"-";"-"
"15 Paź 2024 23:02:00";"Koszty Utrzymania Pozycji";"O2-D6-97Q7VH";"-";"-";"Solana (USD)";"-";"-";"-";"-";"-";"-";"-";"-";"-";"-";"-";"-";"10 237,60";"-10,00000%";"11,00";"0,00";"-";"-";"-";"-";"-";"-";"-";"-";"-";"-";"-";"-";"-";"-";"-";"-";"-";"-"
"15 Paź 2024 23:02:00";"Koszty Utrzymania Pozycji";"O2-D5-97BZ7D";"-";"-";"Solana (USD)";"-";"-";"-";"-";"-";"-";"-";"-";"-";"-";"-";"-";"4 584,00";"-10,00000%";"4,93";"0,00";"-";"-";"-";"-";"-";"-";"-";"-";"-";"-";"-";"-";"-";"-";"-";"-";"-";"-"
"15 Paź 2024 23:02:00";"Koszty Utrzymania Pozycji";"O2-D5-97FGFP";"-";"-";"Solana (USD)";"-";"-";"-";"-";"-";"-";"-";"-";"-";"-";"-";"-";"7 640,00";"-10,00000%";"8,21";"0,00";"-";"-";"-";"-";"-";"-";"-";"-";"-";"-";"-";"-";"-";"-";"-";"-";"-";"-"
"15 Paź 2024 23:02:00";"Koszty Utrzymania Pozycji";"O2-D5-96SWM1";"-";"-";"Solana (USD)";"-";"-";"-";"-";"-";"-";"-";"-";"-";"-";"-";"-";"12 835,20";"-27,50000%";"-38,31";"0,00";"-";"-";"-";"-";"-";"-";"-";"-";"-";"-";"-";"-";"-";"-";"-";"-";"-";"-"
"15 Paź 2024 23:02:00";"Koszty Utrzymania Pozycji";"O2-D4-95EL0T";"-";"-";"Solana (USD)";"-";"-";"-";"-";"-";"-";"-";"-";"-";"-";"-";"-";"4 584,00";"-27,50000%";"-13,68";"0,00";"-";"-";"-";"-";"-";"-";"-";"-";"-";"-";"-";"-";"-";"-";"-";"-";"-";"-"
"15 Paź 2024 23:02:00";"Koszty Utrzymania Pozycji";"O2-D5-97FD8D";"-";"-";"Solana (USD)";"-";"-";"-";"-";"-";"-";"-";"-";"-";"-";"-";"-";"7 640,00";"-10,00000%";"8,21";"0,00";"-";"-";"-";"-";"-";"-";"-";"-";"-";"-";"-";"-";"-";"-";"-";"-";"-";"-"
"15 Paź 2024 23:02:00";"Koszty Utrzymania Pozycji";"O2-D4-95K8MW";"-";"-";"Solana (USD)";"-";"-";"-";"-";"-";"-";"-";"-";"-";"-";"-";"-";"7 640,00";"-10,00000%";"8,21";"0,00";"-";"-";"-";"-";"-";"-";"-";"-";"-";"-";"-";"-";"-";"-";"-";"-";"-";"-"
"15 Paź 2024 23:02:00";"Koszty Utrzymania Pozycji";"O2-D3-94JY88";"-";"-";"Solana (USD)";"-";"-";"-";"-";"-";"-";"-";"-";"-";"-";"-";"-";"3 820,00";"-27,50000%";"-11,40";"0,00";"-";"-";"-";"-";"-";"-";"-";"-";"-";"-";"-";"-";"-";"-";"-";"-";"-";"-"
"15 Paź 2024 23:02:00";"Koszty Utrzymania Pozycji";"O2-D8-99JWX0";"-";"-";"Solana (USD)";"-";"-";"-";"-";"-";"-";"-";"-";"-";"-";"-";"-";"4 584,00";"-27,50000%";"-13,68";"0,00";"-";"-";"-";"-";"-";"-";"-";"-";"-";"-";"-";"-";"-";"-";"-";"-";"-";"-"
"15 Paź 2024 23:02:00";"Koszty Utrzymania Pozycji";"O2-D5-96WE65";"-";"-";"Solana (USD)";"-";"-";"-";"-";"-";"-";"-";"-";"-";"-";"-";"-";"4 584,00";"-27,50000%";"-13,68";"0,00";"-";"-";"-";"-";"-";"-";"-";"-";"-";"-";"-";"-";"-";"-";"-";"-";"-";"-"
"15 Paź 2024 23:02:00";"Koszty Utrzymania Pozycji";"O2-D6-97Z6BV";"-";"-";"Solana (USD)";"-";"-";"-";"-";"-";"-";"-";"-";"-";"-";"-";"-";"5 340,36";"-10,00000%";"5,74";"0,00";"-";"-";"-";"-";"-";"-";"-";"-";"-";"-";"-";"-";"-";"-";"-";"-";"-";"-"
"15 Paź 2024 23:02:00";"Koszty Utrzymania Pozycji";"O2-D8-99KTHY";"-";"-";"Solana (USD)";"-";"-";"-";"-";"-";"-";"-";"-";"-";"-";"-";"-";"9 168,00";"-27,50000%";"-27,37";"0,00";"-";"-";"-";"-";"-";"-";"-";"-";"-";"-";"-";"-";"-";"-";"-";"-";"-";"-"
"15 Paź 2024 23:02:00";"Koszty Utrzymania Pozycji";"O2-D6-97W2F5";"-";"-";"Solana (USD)";"-";"-";"-";"-";"-";"-";"-";"-";"-";"-";"-";"-";"3 820,00";"-10,00000%";"4,10";"0,00";"-";"-";"-";"-";"-";"-";"-";"-";"-";"-";"-";"-";"-";"-";"-";"-";"-";"-"
"15 Paź 2024 23:02:00";"Koszty Utrzymania Pozycji";"O2-D8-99R15K";"-";"-";"Solana (USD)";"-";"-";"-";"-";"-";"-";"-";"-";"-";"-";"-";"-";"4 584,00";"-27,50000%";"-13,68";"0,00";"-";"-";"-";"-";"-";"-";"-";"-";"-";"-";"-";"-";"-";"-";"-";"-";"-";"-"
"15 Paź 2024 23:02:00";"Koszty Utrzymania Pozycji";"O2-D6-97PWJQ";"-";"-";"Solana (USD)";"-";"-";"-";"-";"-";"-";"-";"-";"-";"-";"-";"-";"6 035,60";"-10,00000%";"6,49";"0,00";"-";"-";"-";"-";"-";"-";"-";"-";"-";"-";"-";"-";"-";"-";"-";"-";"-";"-"
"15 Paź 2024 23:02:00";"Koszty Utrzymania Pozycji";"O2-D5-977RC9";"-";"-";"Solana (USD)";"-";"-";"-";"-";"-";"-";"-";"-";"-";"-";"-";"-";"9 932,00";"-10,00000%";"10,67";"0,00";"-";"-";"-";"-";"-";"-";"-";"-";"-";"-";"-";"-";"-";"-";"-";"-";"-";"-"
"15 Paź 2024 20:27:16";" Zamknięcie Transakcji";"O2-D8-99W7BN";"T2-D8-5MGSHF";"O2-D8-99VSCX";"Solana (USD)";"4,02 Jednost.";"155,535";"-";"-";"-";"-";"3,92381";"2 478,01";"35,65";"47 575,21";"-";"-";"-";"-";"-";"-";"-";"-";"-";"-";"-";"-";"-";"-";"-";"-";"-";"-";"-";"-";"-";"-";"-";"-"
"15 Paź 2024 19:17:54";"Transakcja Sprzedaży";"O2-D8-99W4DP";"T2-D8-5MGQ2G";"-";"Solana (USD)";"33,4 Jednost.";"154,001";"-";"-";"-";"-";"3,96304";"20 384,42";"0,00";"-";"-";"-";"-";"-";"-";"-";"-";"-";"-";"-";"-";"-";"-";"-";"-";"-";"-";"-";"-";"-";"-";"-";"-";"-"
"15 Paź 2024 16:55:39";" Transakcja Kupna";"O2-D8-99VSCX";"T2-D8-5MGEP7";"-";"Solana (USD)";"14,02 Jednost.";"153,275";"-";"-";"-";"-";"3,955515";"8 500,06";"0,00";"-";"-";"-";"-";"-";"-";"-";"-";"-";"-";"-";"-";"-";"-";"-";"-";"-";"-";"-";"-";"-";"-";"-";"-";"-"
"15 Paź 2024 16:43:08";" Zamknięcie Transakcji";"O2-D8-99VQL0";"T2-D8-5MGD7N";"O2-D8-99V8TM";"Solana (USD)";"15,9 Jednost.";"152,470";"-";"-";"-";"-";"3,92033";"9 599,49";"10,28";"47 539,56";"-";"-";"-";"-";"-";"-";"-";"-";"-";"-";"-";"-";"-";"-";"-";"-";"-";"-";"-";"-";"-";"-";"-";"-"
"15 Paź 2024 16:28:31";" Zamknięcie Transakcji";"O2-D8-99VMH1";"T2-D8-5MG951";"O2-D8-99JVDD";"Solana (USD)";"0,25 Jednost.";"156,110";"-";"-";"-";"-";"3,91674";"154,39";"11,76";"47 529,28";"-";"-";"-";"-";"-";"-";"-";"-";"-";"-";"-";"-";"-";"-";"-";"-";"-";"-";"-";"-";"-";"-";"-";"-"
"15 Paź 2024 16:27:58";" Zamknięcie Transakcji";"O2-D8-99VMF7";"T2-D8-5MG93V";"O2-D8-99JWX0";"Solana (USD)";"0,29 Jednost.";"155,735";"-";"-";"-";"-";"3,91705";"178,68";"13,51";"47 517,52";"-";"-";"-";"-";"-";"-";"-";"-";"-";"-";"-";"-";"-";"-";"-";"-";"-";"-";"-";"-";"-";"-";"-";"-"
"15 Paź 2024 16:27:11";" Zamknięcie Transakcji";"O2-D8-99VMCJ";"T2-D8-5MG91G";"O2-D8-99Q3ED";"Solana (USD)";"0,78 Jednost.";"155,190";"-";"-";"-";"-";"3,91722";"478,93";"38,52";"47 504,01";"-";"-";"-";"-";"-";"-";"-";"-";"-";"-";"-";"-";"-";"-";"-";"-";"-";"-";"-";"-";"-";"-";"-";"-"
"15 Paź 2024 16:26:46";" Zamknięcie Transakcji";"O2-D8-99VMBH";"T2-D8-5MG90T";"O2-D8-99TT52";"Solana (USD)";"3,3 Jednost.";"155,250";"-";"-";"-";"-";"3,91748";"2 027,19";"6,53";"47 465,49";"-";"-";"-";"-";"-";"-";"-";"-";"-";"-";"-";"-";"-";"-";"-";"-";"-";"-";"-";"-";"-";"-";"-";"-"
"15 Paź 2024 16:25:14";" Zamknięcie Transakcji";"O2-D8-99VM6E";"T2-D8-5MG8XB";"O2-D4-96156D";"Solana (USD)";"24,5 Jednost.";"155,460";"-";"-";"-";"-";"3,91704";"15 069,04";"151,15";"47 458,96";"-";"-";"-";"-";"-";"-";"-";"-";"-";"-";"-";"-";"-";"-";"-";"-";"-";"-";"-";"-";"-";"-";"-";"-"
"15 Paź 2024 16:18:07";" Transakcja Kupna";"O2-D8-99VL9X";"T2-D8-5MG83F";"-";"Solana (USD)";"4 Jednost.";"157,035";"-";"-";"-";"-";"3,956707";"2 485,36";"0,00";"-";"-";"-";"-";"-";"-";"-";"-";"-";"-";"-";"-";"-";"-";"-";"-";"-";"-";"-";"-";"-";"-";"-";"-";"-"
"15 Paź 2024 16:08:11";" Zamknięcie Transakcji";"O2-D8-99VK6R";"T2-D8-5MG73X";"O2-D8-99K6Z8";"Solana (USD)";"3 Jednost.";"156,555";"-";"-";"-";"-";"3,9154";"1 857,41";"154,98";"47 307,81";"-";"-";"-";"-";"-";"-";"-";"-";"-";"-";"-";"-";"-";"-";"-";"-";"-";"-";"-";"-";"-";"-";"-";"-"
"15 Paź 2024 16:00:30";" Transakcja Kupna";"O2-D8-99VJKH";"T2-D8-5MG6LF";"-";"Solana (USD)";"41,34 Jednost.";"159,010";"-";"-";"-";"-";"3,955104";"25 998,77";"0,00";"-";"-";"-";"-";"-";"-";"-";"-";"-";"-";"-";"-";"-";"-";"-";"-";"-";"-";"-";"-";"-";"-";"-";"-";"-"
"15 Paź 2024 15:52:48";" Zamknięcie Transakcji";"O2-D8-99VHQG";"T2-D8-5MG5SF";"O2-D8-99VHGS";"Solana (USD)";"43,22 Jednost.";"157,050";"-";"-";"-";"-";"3,91411";"26 834,77";"32,82";"47 152,83";"-";"-";"-";"-";"-";"-";"-";"-";"-";"-";"-";"-";"-";"-";"-";"-";"-";"-";"-";"-";"-";"-";"-";"-"
"15 Paź 2024 15:50:16";" Transakcja Kupna";"O2-D8-99VHGS";"T2-D8-5MG5KF";"-";"Solana (USD)";"43,22 Jednost.";"156,856";"-";"-";"-";"-";"3,952739";"26 796,86";"0,00";"-";"-";"-";"-";"-";"-";"-";"-";"-";"-";"-";"-";"-";"-";"-";"-";"-";"-";"-";"-";"-";"-";"-";"-";"-"
"15 Paź 2024 15:40:31";" Zamknięcie Transakcji";"O2-D8-99VGE8";"T2-D8-5MG4KW";"O2-D8-99K6Z8";"Solana (USD)";"2 Jednost.";"154,365";"-";"-";"-";"-";"3,91604";"1 221,15";"86,18";"47 120,01";"-";"-";"-";"-";"-";"-";"-";"-";"-";"-";"-";"-";"-";"-";"-";"-";"-";"-";"-";"-";"-";"-";"-";"-"
"15 Paź 2024 13:52:28";" Zamknięcie Transakcji";"O2-D8-99V8W8";"T2-D8-5MFYV2";"O2-D8-99K6Z8";"Solana (USD)";"5 Jednost.";"152,440";"-";"-";"-";"-";"3,91704";"3 015,58";"177,81";"47 033,83";"-";"-";"-";"-";"-";"-";"-";"-";"-";"-";"-";"-";"-";"-";"-";"-";"-";"-";"-";"-";"-";"-";"-";"-"
"15 Paź 2024 13:51:12";"Transakcja Sprzedaży";"O2-D8-99V8TM";"T2-D8-5MFYSP";"-";"Solana (USD)";"15,9 Jednost.";"152,635";"-";"-";"-";"-";"3,955154";"9 598,74";"0,00";"-";"-";"-";"-";"-";"-";"-";"-";"-";"-";"-";"-";"-";"-";"-";"-";"-";"-";"-";"-";"-";"-";"-";"-";"-"
"15 Paź 2024 13:47:07";" Zamknięcie Transakcji";"O2-D8-99V8NT";"T2-D8-5MFYP0";"O2-D4-95TL4Z";"Solana (USD)";"22,5 Jednost.";"152,948";"-";"-";"-";"-";"3,91559";"13 610,30";"40,35";"46 856,02";"-";"-";"-";"-";"-";"-";"-";"-";"-";"-";"-";"-";"-";"-";"-";"-";"-";"-";"-";"-";"-";"-";"-";"-"
"15 Paź 2024 08:54:36";" Transakcja Kupna";"O2-D8-99TT52";"T2-D8-5MFK39";"-";"Solana (USD)";"13,3 Jednost.";"154,745";"-";"-";"-";"-";"3,962228";"8 154,69";"0,00";"-";"-";"-";"-";"-";"-";"-";"-";"-";"-";"-";"-";"-";"-";"-";"-";"-";"-";"-";"-";"-";"-";"-";"-";"-"
"15 Paź 2024 06:12:04";" Transakcja Kupna";"O2-D8-99TNCN";"T2-D8-5MFEWL";"-";"Solana (USD)";"32 Jednost.";"155,595";"-";"-";"-";"-";"3,961046";"19 722,20";"0,00";"-";"-";"-";"-";"-";"-";"-";"-";"-";"-";"-";"-";"-";"-";"-";"-";"-";"-";"-";"-";"-";"-";"-";"-";"-"
"14 Paź 2024 23:02:03";"Koszty Utrzymania Pozycji";"1380282599";"-";"-";"Rachunek";"-";"-";"-";"-";"-";"-";"-";"-";"-125,19";"46 815,67";"-";"-";"-";"-";"-";"-125,19";"-";"-";"-";"-";"-";"-";"-";"-";"-";"-";"-";"-";"-";"-";"-";"-";"-";"-"
"14 Paź 2024 23:02:03";"Koszty Utrzymania Pozycji";"O2-D8-99N2CT";"-";"-";"Solana (USD)";"-";"-";"-";"-";"-";"-";"-";"-";"-";"-";"-";"-";"7 801,25";"-10,00000%";"8,37";"0,00";"-";"-";"-";"-";"-";"-";"-";"-";"-";"-";"-";"-";"-";"-";"-";"-";"-";"-"
"14 Paź 2024 23:02:03";"Koszty Utrzymania Pozycji";"O2-D6-97Q7VH";"-";"-";"Solana (USD)";"-";"-";"-";"-";"-";"-";"-";"-";"-";"-";"-";"-";"10 453,67";"-10,00000%";"11,22";"0,00";"-";"-";"-";"-";"-";"-";"-";"-";"-";"-";"-";"-";"-";"-";"-";"-";"-";"-"
"14 Paź 2024 23:02:03";"Koszty Utrzymania Pozycji";"O2-D5-97BZ7D";"-";"-";"Solana (USD)";"-";"-";"-";"-";"-";"-";"-";"-";"-";"-";"-";"-";"4 680,75";"-10,00000%";"5,02";"0,00";"-";"-";"-";"-";"-";"-";"-";"-";"-";"-";"-";"-";"-";"-";"-";"-";"-";"-"
"14 Paź 2024 23:02:03";"Koszty Utrzymania Pozycji";"O2-D4-95TL4Z";"-";"-";"Solana (USD)";"-";"-";"-";"-";"-";"-";"-";"-";"-";"-";"-";"-";"3 510,56";"-27,50000%";"-10,46";"0,00";"-";"-";"-";"-";"-";"-";"-";"-";"-";"-";"-";"-";"-";"-";"-";"-";"-";"-"
"14 Paź 2024 23:02:03";"Koszty Utrzymania Pozycji";"O2-D5-97FGFP";"-";"-";"Solana (USD)";"-";"-";"-";"-";"-";"-";"-";"-";"-";"-";"-";"-";"7 801,25";"-10,00000%";"8,37";"0,00";"-";"-";"-";"-";"-";"-";"-";"-";"-";"-";"-";"-";"-";"-";"-";"-";"-";"-"
"14 Paź 2024 23:02:03";"Koszty Utrzymania Pozycji";"O2-D5-96SWM1";"-";"-";"Solana (USD)";"-";"-";"-";"-";"-";"-";"-";"-";"-";"-";"-";"-";"13 106,10";"-27,50000%";"-39,07";"0,00";"-";"-";"-";"-";"-";"-";"-";"-";"-";"-";"-";"-";"-";"-";"-";"-";"-";"-"
"14 Paź 2024 23:02:03";"Koszty Utrzymania Pozycji";"O2-D4-95EL0T";"-";"-";"Solana (USD)";"-";"-";"-";"-";"-";"-";"-";"-";"-";"-";"-";"-";"4 680,75";"-27,50000%";"-13,95";"0,00";"-";"-";"-";"-";"-";"-";"-";"-";"-";"-";"-";"-";"-";"-";"-";"-";"-";"-"
"14 Paź 2024 23:02:03";"Koszty Utrzymania Pozycji";"O2-D8-99JWX0";"-";"-";"Solana (USD)";"-";"-";"-";"-";"-";"-";"-";"-";"-";"-";"-";"-";"4 725,99";"-27,50000%";"-14,09";"0,00";"-";"-";"-";"-";"-";"-";"-";"-";"-";"-";"-";"-";"-";"-";"-";"-";"-";"-"
"14 Paź 2024 23:02:03";"Koszty Utrzymania Pozycji";"O2-D4-96156D";"-";"-";"Solana (USD)";"-";"-";"-";"-";"-";"-";"-";"-";"-";"-";"-";"-";"3 822,61";"-27,50000%";"-11,39";"0,00";"-";"-";"-";"-";"-";"-";"-";"-";"-";"-";"-";"-";"-";"-";"-";"-";"-";"-"
"14 Paź 2024 23:02:03";"Koszty Utrzymania Pozycji";"O2-D5-97FD8D";"-";"-";"Solana (USD)";"-";"-";"-";"-";"-";"-";"-";"-";"-";"-";"-";"-";"7 801,25";"-10,00000%";"8,37";"0,00";"-";"-";"-";"-";"-";"-";"-";"-";"-";"-";"-";"-";"-";"-";"-";"-";"-";"-"
"14 Paź 2024 23:02:03";"Koszty Utrzymania Pozycji";"O2-D4-95K8MW";"-";"-";"Solana (USD)";"-";"-";"-";"-";"-";"-";"-";"-";"-";"-";"-";"-";"7 801,25";"-10,00000%";"8,37";"0,00";"-";"-";"-";"-";"-";"-";"-";"-";"-";"-";"-";"-";"-";"-";"-";"-";"-";"-"
"14 Paź 2024 23:02:03";"Koszty Utrzymania Pozycji";"O2-D3-94JY88";"-";"-";"Solana (USD)";"-";"-";"-";"-";"-";"-";"-";"-";"-";"-";"-";"-";"3 900,62";"-27,50000%";"-11,63";"0,00";"-";"-";"-";"-";"-";"-";"-";"-";"-";"-";"-";"-";"-";"-";"-";"-";"-";"-"
"14 Paź 2024 23:02:03";"Koszty Utrzymania Pozycji";"O2-D8-99K6Z8";"-";"-";"Solana (USD)";"-";"-";"-";"-";"-";"-";"-";"-";"-";"-";"-";"-";"1 560,25";"-27,50000%";"-4,65";"0,00";"-";"-";"-";"-";"-";"-";"-";"-";"-";"-";"-";"-";"-";"-";"-";"-";"-";"-"
"14 Paź 2024 23:02:03";"Koszty Utrzymania Pozycji";"O2-D5-96WE65";"-";"-";"Solana (USD)";"-";"-";"-";"-";"-";"-";"-";"-";"-";"-";"-";"-";"4 680,75";"-27,50000%";"-13,95";"0,00";"-";"-";"-";"-";"-";"-";"-";"-";"-";"-";"-";"-";"-";"-";"-";"-";"-";"-"
"14 Paź 2024 23:02:03";"Koszty Utrzymania Pozycji";"O2-D6-97Z6BV";"-";"-";"Solana (USD)";"-";"-";"-";"-";"-";"-";"-";"-";"-";"-";"-";"-";"5 453,07";"-10,00000%";"5,85";"0,00";"-";"-";"-";"-";"-";"-";"-";"-";"-";"-";"-";"-";"-";"-";"-";"-";"-";"-"
"14 Paź 2024 23:02:03";"Koszty Utrzymania Pozycji";"O2-D8-99KTHY";"-";"-";"Solana (USD)";"-";"-";"-";"-";"-";"-";"-";"-";"-";"-";"-";"-";"9 361,50";"-27,50000%";"-27,90";"0,00";"-";"-";"-";"-";"-";"-";"-";"-";"-";"-";"-";"-";"-";"-";"-";"-";"-";"-"
"14 Paź 2024 23:02:03";"Koszty Utrzymania Pozycji";"O2-D6-97W2F5";"-";"-";"Solana (USD)";"-";"-";"-";"-";"-";"-";"-";"-";"-";"-";"-";"-";"3 900,62";"-10,00000%";"4,19";"0,00";"-";"-";"-";"-";"-";"-";"-";"-";"-";"-";"-";"-";"-";"-";"-";"-";"-";"-"
"14 Paź 2024 23:02:03";"Koszty Utrzymania Pozycji";"O2-D8-99JVDD";"-";"-";"Solana (USD)";"-";"-";"-";"-";"-";"-";"-";"-";"-";"-";"-";"-";"6 123,98";"-27,50000%";"-18,25";"0,00";"-";"-";"-";"-";"-";"-";"-";"-";"-";"-";"-";"-";"-";"-";"-";"-";"-";"-"
"14 Paź 2024 23:02:03";"Koszty Utrzymania Pozycji";"O2-D8-99R15K";"-";"-";"Solana (USD)";"-";"-";"-";"-";"-";"-";"-";"-";"-";"-";"-";"-";"4 680,75";"-27,50000%";"-13,95";"0,00";"-";"-";"-";"-";"-";"-";"-";"-";"-";"-";"-";"-";"-";"-";"-";"-";"-";"-"
"14 Paź 2024 23:02:03";"Koszty Utrzymania Pozycji";"O2-D8-99Q3ED";"-";"-";"Solana (USD)";"-";"-";"-";"-";"-";"-";"-";"-";"-";"-";"-";"-";"7 766,92";"-27,50000%";"-23,15";"0,00";"-";"-";"-";"-";"-";"-";"-";"-";"-";"-";"-";"-";"-";"-";"-";"-";"-";"-"
"14 Paź 2024 23:02:03";"Koszty Utrzymania Pozycji";"O2-D6-97PWJQ";"-";"-";"Solana (USD)";"-";"-";"-";"-";"-";"-";"-";"-";"-";"-";"-";"-";"6 162,98";"-10,00000%";"6,61";"0,00";"-";"-";"-";"-";"-";"-";"-";"-";"-";"-";"-";"-";"-";"-";"-";"-";"-";"-"
"14 Paź 2024 23:02:03";"Koszty Utrzymania Pozycji";"O2-D5-977RC9";"-";"-";"Solana (USD)";"-";"-";"-";"-";"-";"-";"-";"-";"-";"-";"-";"-";"10 141,62";"-10,00000%";"10,88";"0,00";"-";"-";"-";"-";"-";"-";"-";"-";"-";"-";"-";"-";"-";"-";"-";"-";"-";"-"
"14 Paź 2024 20:35:42";" Zamknięcie Transakcji";"O2-D8-99T8WS";"T2-D8-5MF34Z";"O2-D8-99T75F";"Solana (USD)";"45,4 Jednost.";"155,940";"-";"-";"-";"-";"3,91923";"28 025,75";"0,00";"46 940,86";"-";"-";"-";"-";"-";"-";"-";"-";"-";"-";"-";"-";"-";"-";"-";"-";"-";"-";"-";"-";"-";"-";"-";"-"
"14 Paź 2024 19:34:06";" Transakcja Kupna";"O2-D8-99T75F";"T2-D8-5MF1T3";"-";"Solana (USD)";"45,4 Jednost.";"155,940";"-";"-";"-";"-";"3,959072";"28 028,94";"0,00";"-";"-";"-";"-";"-";"-";"-";"-";"-";"-";"-";"-";"-";"-";"-";"-";"-";"-";"-";"-";"-";"-";"-";"-";"-"
"14 Paź 2024 17:35:31";" Zamknięcie Transakcji";"O2-D8-99T0ET";"T2-D8-5MEX29";"O2-D8-99SVE7";"Solana (USD)";"45 Jednost.";"157,400";"-";"-";"-";"-";"3,91386";"28 000,44";"280,92";"46 940,86";"-";"-";"-";"-";"-";"-";"-";"-";"-";"-";"-";"-";"-";"-";"-";"-";"-";"-";"-";"-";"-";"-";"-";"-"
"14 Paź 2024 16:48:45";" Transakcja Kupna";"O2-D8-99SVE7";"T2-D8-5MESQ0";"-";"Solana (USD)";"45 Jednost.";"155,805";"-";"-";"-";"-";"3,952439";"27 711,43";"0,00";"-";"-";"-";"-";"-";"-";"-";"-";"-";"-";"-";"-";"-";"-";"-";"-";"-";"-";"-";"-";"-";"-";"-";"-";"-"
"14 Paź 2024 16:31:08";"Stop Loss";"O2-D8-99SMV7";"T2-D8-5MERGX";"-";"Solana (USD)";"45,37 Jednost.";"154,575";"-";"-";"-";"-";"3,91401";"27 725,04";"99,44";"46 659,94";"-";"-";"-";"-";"-";"-";"-";"-";"-";"-";"-";"-";"-";"-";"-";"-";"-";"-";"-";"-";"-";"-";"-";"-"
"14 Paź 2024 16:27:26";"Zmodyfikowano Stop Loss";"O2-D8-99SMV7";"-";"O2-D8-99SR6Q";"Solana (USD)";"45,37 Jednost.";"154,015";"-";"154,600";"-";"-";"-";"-";"-";"-";"-";"-";"-";"-";"-";"-";"-";"-";"-";"-";"-";"-";"-";"-";"-";"-";"-";"-";"-";"-";"-";"-";"-";"-"
"14 Paź 2024 16:23:22";" Zmodyfikowano Transakcję Kupna";"O2-D8-99SMV7";"T2-D8-5MENDD";"-";"Solana (USD)";"45,37 Jednost.";"154,015";"-";"154,400";"-";"-";"-";"-";"0,00";"-";"-";"-";"-";"-";"-";"-";"-";"-";"-";"-";"-";"-";"-";"-";"-";"-";"-";"-";"-";"-";"-";"-";"-";"-"
"14 Paź 2024 16:00:57";" Transakcja Kupna";"O2-D8-99SMV7";"T2-D8-5MENDD";"-";"Solana (USD)";"45,37 Jednost.";"154,015";"-";"-";"-";"-";"3,951036";"27 608,49";"0,00";"-";"-";"-";"-";"-";"-";"-";"-";"-";"-";"-";"-";"-";"-";"-";"-";"-";"-";"-";"-";"-";"-";"-";"-";"-"
"14 Paź 2024 07:34:46";" Zamknięcie Transakcji";"O2-D8-99RLCN";"T2-D8-5ME08S";"O2-D5-96WE65";"Solana (USD)";"5 Jednost.";"150,995";"-";"-";"-";"-";"3,91092";"2 982,32";"52,19";"46 560,50";"-";"-";"-";"-";"-";"-";"-";"-";"-";"-";"-";"-";"-";"-";"-";"-";"-";"-";"-";"-";"-";"-";"-";"-"
"14 Paź 2024 07:29:43";" Zamknięcie Transakcji";"O2-D8-99RL7G";"T2-D8-5ME05T";"O2-D5-96WE65";"Solana (USD)";"3 Jednost.";"151,075";"-";"-";"-";"-";"3,91092";"1 790,34";"32,25";"46 508,31";"-";"-";"-";"-";"-";"-";"-";"-";"-";"-";"-";"-";"-";"-";"-";"-";"-";"-";"-";"-";"-";"-";"-";"-"
"14 Paź 2024 07:29:09";" Zamknięcie Transakcji";"O2-D8-99RL75";"T2-D8-5ME05K";"O2-D5-96WE65";"Solana (USD)";"10 Jednost.";"151,015";"-";"-";"-";"-";"3,91087";"5 965,35";"105,16";"46 476,06";"-";"-";"-";"-";"-";"-";"-";"-";"-";"-";"-";"-";"-";"-";"-";"-";"-";"-";"-";"-";"-";"-";"-";"-"
"14 Paź 2024 07:28:27";" Zamknięcie Transakcji";"O2-D8-99RL6X";"T2-D8-5ME05D";"O2-D8-99FH3B";"Solana (USD)";"12,2 Jednost.";"151,115";"-";"-";"-";"-";"3,91079";"7 282,40";"93,47";"46 370,90";"-";"-";"-";"-";"-";"-";"-";"-";"-";"-";"-";"-";"-";"-";"-";"-";"-";"-";"-";"-";"-";"-";"-";"-"
"11 Paź 2024 23:02:02";"Koszty Utrzymania Pozycji";"1379981851";"-";"-";"Rachunek";"-";"-";"-";"-";"-";"-";"-";"-";"-388,18";"46 277,43";"-";"-";"-";"-";"-";"-388,18";"-";"-";"-";"-";"-";"-";"-";"-";"-";"-";"-";"-";"-";"-";"-";"-";"-";"-"
"11 Paź 2024 23:02:02";"Koszty Utrzymania Pozycji";"O2-D8-99N2CT";"-";"-";"Solana (USD)";"-";"-";"-";"-";"-";"-";"-";"-";"-";"-";"-";"-";"7 271,50";"-10,00000%";"23,34";"0,00";"-";"-";"-";"-";"-";"-";"-";"-";"-";"-";"-";"-";"-";"-";"-";"-";"-";"-"
"11 Paź 2024 23:02:02";"Koszty Utrzymania Pozycji";"O2-D6-97Q7VH";"-";"-";"Solana (USD)";"-";"-";"-";"-";"-";"-";"-";"-";"-";"-";"-";"-";"9 743,81";"-10,00000%";"31,28";"0,00";"-";"-";"-";"-";"-";"-";"-";"-";"-";"-";"-";"-";"-";"-";"-";"-";"-";"-"
"11 Paź 2024 23:02:02";"Koszty Utrzymania Pozycji";"O2-D5-97BZ7D";"-";"-";"Solana (USD)";"-";"-";"-";"-";"-";"-";"-";"-";"-";"-";"-";"-";"4 362,90";"-10,00000%";"14,00";"0,00";"-";"-";"-";"-";"-";"-";"-";"-";"-";"-";"-";"-";"-";"-";"-";"-";"-";"-"
"11 Paź 2024 23:02:02";"Koszty Utrzymania Pozycji";"O2-D4-95TL4Z";"-";"-";"Solana (USD)";"-";"-";"-";"-";"-";"-";"-";"-";"-";"-";"-";"-";"3 272,17";"-27,50000%";"-29,17";"0,00";"-";"-";"-";"-";"-";"-";"-";"-";"-";"-";"-";"-";"-";"-";"-";"-";"-";"-"
"11 Paź 2024 23:02:02";"Koszty Utrzymania Pozycji";"O2-D8-99FH3B";"-";"-";"Solana (USD)";"-";"-";"-";"-";"-";"-";"-";"-";"-";"-";"-";"-";"1 774,24";"-27,50000%";"-15,82";"0,00";"-";"-";"-";"-";"-";"-";"-";"-";"-";"-";"-";"-";"-";"-";"-";"-";"-";"-"
"11 Paź 2024 23:02:02";"Koszty Utrzymania Pozycji";"O2-D5-97FGFP";"-";"-";"Solana (USD)";"-";"-";"-";"-";"-";"-";"-";"-";"-";"-";"-";"-";"7 271,50";"-10,00000%";"23,34";"0,00";"-";"-";"-";"-";"-";"-";"-";"-";"-";"-";"-";"-";"-";"-";"-";"-";"-";"-"
"11 Paź 2024 23:02:02";"Koszty Utrzymania Pozycji";"O2-D5-96SWM1";"-";"-";"Solana (USD)";"-";"-";"-";"-";"-";"-";"-";"-";"-";"-";"-";"-";"12 216,12";"-27,50000%";"-108,91";"0,00";"-";"-";"-";"-";"-";"-";"-";"-";"-";"-";"-";"-";"-";"-";"-";"-";"-";"-"
"11 Paź 2024 23:02:02";"Koszty Utrzymania Pozycji";"O2-D4-95EL0T";"-";"-";"Solana (USD)";"-";"-";"-";"-";"-";"-";"-";"-";"-";"-";"-";"-";"4 362,90";"-27,50000%";"-38,90";"0,00";"-";"-";"-";"-";"-";"-";"-";"-";"-";"-";"-";"-";"-";"-";"-";"-";"-";"-"
"11 Paź 2024 23:02:02";"Koszty Utrzymania Pozycji";"O2-D8-99JWX0";"-";"-";"Solana (USD)";"-";"-";"-";"-";"-";"-";"-";"-";"-";"-";"-";"-";"4 405,07";"-27,50000%";"-39,27";"0,00";"-";"-";"-";"-";"-";"-";"-";"-";"-";"-";"-";"-";"-";"-";"-";"-";"-";"-"
"11 Paź 2024 23:02:02";"Koszty Utrzymania Pozycji";"O2-D4-96156D";"-";"-";"Solana (USD)";"-";"-";"-";"-";"-";"-";"-";"-";"-";"-";"-";"-";"3 563,03";"-27,50000%";"-31,77";"0,00";"-";"-";"-";"-";"-";"-";"-";"-";"-";"-";"-";"-";"-";"-";"-";"-";"-";"-"
"11 Paź 2024 23:02:02";"Koszty Utrzymania Pozycji";"O2-D5-97FD8D";"-";"-";"Solana (USD)";"-";"-";"-";"-";"-";"-";"-";"-";"-";"-";"-";"-";"7 271,50";"-10,00000%";"23,34";"0,00";"-";"-";"-";"-";"-";"-";"-";"-";"-";"-";"-";"-";"-";"-";"-";"-";"-";"-"
"11 Paź 2024 23:02:02";"Koszty Utrzymania Pozycji";"O2-D4-95K8MW";"-";"-";"Solana (USD)";"-";"-";"-";"-";"-";"-";"-";"-";"-";"-";"-";"-";"7 271,50";"-10,00000%";"23,34";"0,00";"-";"-";"-";"-";"-";"-";"-";"-";"-";"-";"-";"-";"-";"-";"-";"-";"-";"-"
"11 Paź 2024 23:02:02";"Koszty Utrzymania Pozycji";"O2-D5-96WE65";"-";"-";"Solana (USD)";"-";"-";"-";"-";"-";"-";"-";"-";"-";"-";"-";"-";"6 980,64";"-27,50000%";"-62,24";"0,00";"-";"-";"-";"-";"-";"-";"-";"-";"-";"-";"-";"-";"-";"-";"-";"-";"-";"-"
"11 Paź 2024 23:02:02";"Koszty Utrzymania Pozycji";"O2-D3-94JY88";"-";"-";"Solana (USD)";"-";"-";"-";"-";"-";"-";"-";"-";"-";"-";"-";"-";"3 635,75";"-27,50000%";"-32,41";"0,00";"-";"-";"-";"-";"-";"-";"-";"-";"-";"-";"-";"-";"-";"-";"-";"-";"-";"-"
"11 Paź 2024 23:02:02";"Koszty Utrzymania Pozycji";"O2-D8-99K6Z8";"-";"-";"Solana (USD)";"-";"-";"-";"-";"-";"-";"-";"-";"-";"-";"-";"-";"1 454,30";"-27,50000%";"-12,97";"0,00";"-";"-";"-";"-";"-";"-";"-";"-";"-";"-";"-";"-";"-";"-";"-";"-";"-";"-"
"11 Paź 2024 23:02:02";"Koszty Utrzymania Pozycji";"O2-D6-97Z6BV";"-";"-";"Solana (USD)";"-";"-";"-";"-";"-";"-";"-";"-";"-";"-";"-";"-";"5 082,77";"-10,00000%";"16,31";"0,00";"-";"-";"-";"-";"-";"-";"-";"-";"-";"-";"-";"-";"-";"-";"-";"-";"-";"-"
"11 Paź 2024 23:02:02";"Koszty Utrzymania Pozycji";"O2-D8-99KTHY";"-";"-";"Solana (USD)";"-";"-";"-";"-";"-";"-";"-";"-";"-";"-";"-";"-";"8 725,80";"-27,50000%";"-77,79";"0,00";"-";"-";"-";"-";"-";"-";"-";"-";"-";"-";"-";"-";"-";"-";"-";"-";"-";"-"
"11 Paź 2024 23:02:02";"Koszty Utrzymania Pozycji";"O2-D6-97W2F5";"-";"-";"Solana (USD)";"-";"-";"-";"-";"-";"-";"-";"-";"-";"-";"-";"-";"3 635,75";"-10,00000%";"11,67";"0,00";"-";"-";"-";"-";"-";"-";"-";"-";"-";"-";"-";"-";"-";"-";"-";"-";"-";"-"
"11 Paź 2024 23:02:02";"Koszty Utrzymania Pozycji";"O2-D8-99JVDD";"-";"-";"Solana (USD)";"-";"-";"-";"-";"-";"-";"-";"-";"-";"-";"-";"-";"5 708,12";"-27,50000%";"-50,89";"0,00";"-";"-";"-";"-";"-";"-";"-";"-";"-";"-";"-";"-";"-";"-";"-";"-";"-";"-"
"11 Paź 2024 23:02:02";"Koszty Utrzymania Pozycji";"O2-D8-99R15K";"-";"-";"Solana (USD)";"-";"-";"-";"-";"-";"-";"-";"-";"-";"-";"-";"-";"4 362,90";"-27,50000%";"-38,90";"0,00";"-";"-";"-";"-";"-";"-";"-";"-";"-";"-";"-";"-";"-";"-";"-";"-";"-";"-"
"11 Paź 2024 23:02:02";"Koszty Utrzymania Pozycji";"O2-D8-99Q3ED";"-";"-";"Solana (USD)";"-";"-";"-";"-";"-";"-";"-";"-";"-";"-";"-";"-";"7 239,50";"-27,50000%";"-64,54";"0,00";"-";"-";"-";"-";"-";"-";"-";"-";"-";"-";"-";"-";"-";"-";"-";"-";"-";"-"
"11 Paź 2024 23:02:02";"Koszty Utrzymania Pozycji";"O2-D6-97PWJQ";"-";"-";"Solana (USD)";"-";"-";"-";"-";"-";"-";"-";"-";"-";"-";"-";"-";"5 744,48";"-10,00000%";"18,44";"0,00";"-";"-";"-";"-";"-";"-";"-";"-";"-";"-";"-";"-";"-";"-";"-";"-";"-";"-"
"11 Paź 2024 23:02:02";"Koszty Utrzymania Pozycji";"O2-D5-977RC9";"-";"-";"Solana (USD)";"-";"-";"-";"-";"-";"-";"-";"-";"-";"-";"-";"-";"9 452,95";"-10,00000%";"30,34";"0,00";"-";"-";"-";"-";"-";"-";"-";"-";"-";"-";"-";"-";"-";"-";"-";"-";"-";"-"
"11 Paź 2024 19:36:53";" Transakcja Kupna";"O2-D8-99R15K";"T2-D8-5MDJE0";"-";"Solana (USD)";"30 Jednost.";"146,145";"-";"-";"-";"-";"3,938972";"17 269,83";"0,00";"-";"-";"-";"-";"-";"-";"-";"-";"-";"-";"-";"-";"-";"-";"-";"-";"-";"-";"-";"-";"-";"-";"-";"-";"-"
"11 Paź 2024 16:20:56";" Zamknięcie Transakcji";"O2-D8-99QMDF";"T2-D8-5MD70Z";"O2-D8-99K6Z8";"Solana (USD)";"10 Jednost.";"143,530";"-";"-";"-";"-";"3,89889";"5 652,31";"6,59";"46 665,61";"-";"-";"-";"-";"-";"-";"-";"-";"-";"-";"-";"-";"-";"-";"-";"-";"-";"-";"-";"-";"-";"-";"-";"-"
"11 Paź 2024 15:58:01";" Zamknięcie Transakcji";"O2-D8-99QHGH";"T2-D8-5MD3BN";"O2-D8-99K6Z8";"Solana (USD)";"40 Jednost.";"143,494";"-";"-";"-";"-";"3,9048";"22 637,85";"20,77";"46 659,02";"-";"-";"-";"-";"-";"-";"-";"-";"-";"-";"-";"-";"-";"-";"-";"-";"-";"-";"-";"-";"-";"-";"-";"-"
"11 Paź 2024 12:19:32";" Transakcja Kupna";"O2-D8-99Q3ED";"T2-D8-5MCR3J";"-";"Solana (USD)";"49,78 Jednost.";"142,582";"-";"-";"-";"-";"3,944543";"27 997,30";"0,00";"-";"-";"-";"-";"-";"-";"-";"-";"-";"-";"-";"-";"-";"-";"-";"-";"-";"-";"-";"-";"-";"-";"-";"-";"-"
"11 Paź 2024 12:18:24";"Zmodyfikowano Transakcję Sprzedaży";"O2-D6-97Z6BV";"T2-D6-5L88QC";"-";"Solana (USD)";"34,95 Jednost.";"135,700";"-";"-";"-";"-";"-";"-";"0,00";"-";"-";"-";"-";"-";"-";"-";"-";"-";"-";"-";"-";"-";"-";"-";"-";"-";"-";"-";"-";"-";"-";"-";"-";"-"
"10 Paź 2024 23:01:54";"Koszty Utrzymania Pozycji";"1379696913";"-";"-";"Rachunek";"-";"-";"-";"-";"-";"-";"-";"-";"-110,37";"46 638,25";"-";"-";"-";"-";"-";"-110,37";"-";"-";"-";"-";"-";"-";"-";"-";"-";"-";"-";"-";"-";"-";"-";"-";"-";"-"
"10 Paź 2024 23:01:54";"Koszty Utrzymania Pozycji";"O2-D8-99N2CT";"-";"-";"Solana (USD)";"-";"-";"-";"-";"-";"-";"-";"-";"-";"-";"-";"-";"6 873,75";"-10,00000%";"7,37";"0,00";"-";"-";"-";"-";"-";"-";"-";"-";"-";"-";"-";"-";"-";"-";"-";"-";"-";"-"
"10 Paź 2024 23:01:54";"Koszty Utrzymania Pozycji";"O2-D6-97Q7VH";"-";"-";"Solana (USD)";"-";"-";"-";"-";"-";"-";"-";"-";"-";"-";"-";"-";"9 210,82";"-10,00000%";"9,87";"0,00";"-";"-";"-";"-";"-";"-";"-";"-";"-";"-";"-";"-";"-";"-";"-";"-";"-";"-"
"10 Paź 2024 23:01:54";"Koszty Utrzymania Pozycji";"O2-D5-97BZ7D";"-";"-";"Solana (USD)";"-";"-";"-";"-";"-";"-";"-";"-";"-";"-";"-";"-";"4 124,25";"-10,00000%";"4,42";"0,00";"-";"-";"-";"-";"-";"-";"-";"-";"-";"-";"-";"-";"-";"-";"-";"-";"-";"-"
"10 Paź 2024 23:01:54";"Koszty Utrzymania Pozycji";"O2-D4-95TL4Z";"-";"-";"Solana (USD)";"-";"-";"-";"-";"-";"-";"-";"-";"-";"-";"-";"-";"3 093,18";"-27,50000%";"-9,21";"0,00";"-";"-";"-";"-";"-";"-";"-";"-";"-";"-";"-";"-";"-";"-";"-";"-";"-";"-"
"10 Paź 2024 23:01:54";"Koszty Utrzymania Pozycji";"O2-D8-99FH3B";"-";"-";"Solana (USD)";"-";"-";"-";"-";"-";"-";"-";"-";"-";"-";"-";"-";"1 677,19";"-27,50000%";"-4,99";"0,00";"-";"-";"-";"-";"-";"-";"-";"-";"-";"-";"-";"-";"-";"-";"-";"-";"-";"-"
"10 Paź 2024 23:01:54";"Koszty Utrzymania Pozycji";"O2-D5-97FGFP";"-";"-";"Solana (USD)";"-";"-";"-";"-";"-";"-";"-";"-";"-";"-";"-";"-";"6 873,75";"-10,00000%";"7,37";"0,00";"-";"-";"-";"-";"-";"-";"-";"-";"-";"-";"-";"-";"-";"-";"-";"-";"-";"-"
"10 Paź 2024 23:01:54";"Koszty Utrzymania Pozycji";"O2-D5-96SWM1";"-";"-";"Solana (USD)";"-";"-";"-";"-";"-";"-";"-";"-";"-";"-";"-";"-";"11 547,90";"-27,50000%";"-34,39";"0,00";"-";"-";"-";"-";"-";"-";"-";"-";"-";"-";"-";"-";"-";"-";"-";"-";"-";"-"
"10 Paź 2024 23:01:54";"Koszty Utrzymania Pozycji";"O2-D4-95EL0T";"-";"-";"Solana (USD)";"-";"-";"-";"-";"-";"-";"-";"-";"-";"-";"-";"-";"4 124,25";"-27,50000%";"-12,28";"0,00";"-";"-";"-";"-";"-";"-";"-";"-";"-";"-";"-";"-";"-";"-";"-";"-";"-";"-"
"10 Paź 2024 23:01:54";"Koszty Utrzymania Pozycji";"O2-D8-99JWX0";"-";"-";"Solana (USD)";"-";"-";"-";"-";"-";"-";"-";"-";"-";"-";"-";"-";"4 164,11";"-27,50000%";"-12,40";"0,00";"-";"-";"-";"-";"-";"-";"-";"-";"-";"-";"-";"-";"-";"-";"-";"-";"-";"-"
"10 Paź 2024 23:01:54";"Koszty Utrzymania Pozycji";"O2-D4-96156D";"-";"-";"Solana (USD)";"-";"-";"-";"-";"-";"-";"-";"-";"-";"-";"-";"-";"3 368,13";"-27,50000%";"-10,03";"0,00";"-";"-";"-";"-";"-";"-";"-";"-";"-";"-";"-";"-";"-";"-";"-";"-";"-";"-"
"10 Paź 2024 23:01:54";"Koszty Utrzymania Pozycji";"O2-D5-97FD8D";"-";"-";"Solana (USD)";"-";"-";"-";"-";"-";"-";"-";"-";"-";"-";"-";"-";"6 873,75";"-10,00000%";"7,37";"0,00";"-";"-";"-";"-";"-";"-";"-";"-";"-";"-";"-";"-";"-";"-";"-";"-";"-";"-"
"10 Paź 2024 23:01:54";"Koszty Utrzymania Pozycji";"O2-D4-95K8MW";"-";"-";"Solana (USD)";"-";"-";"-";"-";"-";"-";"-";"-";"-";"-";"-";"-";"6 873,75";"-10,00000%";"7,37";"0,00";"-";"-";"-";"-";"-";"-";"-";"-";"-";"-";"-";"-";"-";"-";"-";"-";"-";"-"
"10 Paź 2024 23:01:54";"Koszty Utrzymania Pozycji";"O2-D5-96WE65";"-";"-";"Solana (USD)";"-";"-";"-";"-";"-";"-";"-";"-";"-";"-";"-";"-";"6 598,80";"-27,50000%";"-19,65";"0,00";"-";"-";"-";"-";"-";"-";"-";"-";"-";"-";"-";"-";"-";"-";"-";"-";"-";"-"
"10 Paź 2024 23:01:54";"Koszty Utrzymania Pozycji";"O2-D3-94JY88";"-";"-";"Solana (USD)";"-";"-";"-";"-";"-";"-";"-";"-";"-";"-";"-";"-";"3 436,87";"-27,50000%";"-10,23";"0,00";"-";"-";"-";"-";"-";"-";"-";"-";"-";"-";"-";"-";"-";"-";"-";"-";"-";"-"
"10 Paź 2024 23:01:54";"Koszty Utrzymania Pozycji";"O2-D8-99K6Z8";"-";"-";"Solana (USD)";"-";"-";"-";"-";"-";"-";"-";"-";"-";"-";"-";"-";"8 248,50";"-27,50000%";"-24,56";"0,00";"-";"-";"-";"-";"-";"-";"-";"-";"-";"-";"-";"-";"-";"-";"-";"-";"-";"-"
"10 Paź 2024 23:01:54";"Koszty Utrzymania Pozycji";"O2-D6-97Z6BV";"-";"-";"Solana (USD)";"-";"-";"-";"-";"-";"-";"-";"-";"-";"-";"-";"-";"4 804,75";"-10,00000%";"5,15";"0,00";"-";"-";"-";"-";"-";"-";"-";"-";"-";"-";"-";"-";"-";"-";"-";"-";"-";"-"
"10 Paź 2024 23:01:54";"Koszty Utrzymania Pozycji";"O2-D8-99KTHY";"-";"-";"Solana (USD)";"-";"-";"-";"-";"-";"-";"-";"-";"-";"-";"-";"-";"8 248,50";"-27,50000%";"-24,56";"0,00";"-";"-";"-";"-";"-";"-";"-";"-";"-";"-";"-";"-";"-";"-";"-";"-";"-";"-"
"10 Paź 2024 23:01:54";"Koszty Utrzymania Pozycji";"O2-D6-97W2F5";"-";"-";"Solana (USD)";"-";"-";"-";"-";"-";"-";"-";"-";"-";"-";"-";"-";"3 436,87";"-10,00000%";"3,68";"0,00";"-";"-";"-";"-";"-";"-";"-";"-";"-";"-";"-";"-";"-";"-";"-";"-";"-";"-"
"10 Paź 2024 23:01:54";"Koszty Utrzymania Pozycji";"O2-D8-99JVDD";"-";"-";"Solana (USD)";"-";"-";"-";"-";"-";"-";"-";"-";"-";"-";"-";"-";"5 395,89";"-27,50000%";"-16,07";"0,00";"-";"-";"-";"-";"-";"-";"-";"-";"-";"-";"-";"-";"-";"-";"-";"-";"-";"-"
"10 Paź 2024 23:01:54";"Koszty Utrzymania Pozycji";"O2-D6-97PWJQ";"-";"-";"Solana (USD)";"-";"-";"-";"-";"-";"-";"-";"-";"-";"-";"-";"-";"5 430,26";"-10,00000%";"5,82";"0,00";"-";"-";"-";"-";"-";"-";"-";"-";"-";"-";"-";"-";"-";"-";"-";"-";"-";"-"
"10 Paź 2024 23:01:54";"Koszty Utrzymania Pozycji";"O2-D5-977RC9";"-";"-";"Solana (USD)";"-";"-";"-";"-";"-";"-";"-";"-";"-";"-";"-";"-";"8 935,87";"-10,00000%";"9,58";"0,00";"-";"-";"-";"-";"-";"-";"-";"-";"-";"-";"-";"-";"-";"-";"-";"-";"-";"-"
"10 Paź 2024 20:59:07";"Zmodyfikowano Take Profit";"O2-D6-97Z6BV";"-";"O2-D8-99PE8Z";"Solana (USD)";"34,95 Jednost.";"135,700";"-";"-";"132,000";"-";"-";"-";"-";"-";"-";"-";"-";"-";"-";"-";"-";"-";"-";"-";"-";"-";"-";"-";"-";"-";"-";"-";"-";"-";"-";"-";"-";"-"
"10 Paź 2024 20:58:08";"Zmodyfikowano Take Profit";"O2-D6-97Z6BV";"-";"O2-D8-99PE8Z";"Solana (USD)";"34,95 Jednost.";"135,700";"-";"-";"133,000";"-";"-";"-";"-";"-";"-";"-";"-";"-";"-";"-";"-";"-";"-";"-";"-";"-";"-";"-";"-";"-";"-";"-";"-";"-";"-";"-";"-";"-"
"10 Paź 2024 20:55:24";"Zmodyfikowano Transakcję Sprzedaży";"O2-D6-97Z6BV";"T2-D6-5L88QC";"-";"Solana (USD)";"34,95 Jednost.";"135,700";"-";"-";"134,000";"-";"-";"-";"0,00";"-";"-";"-";"-";"-";"-";"-";"-";"-";"-";"-";"-";"-";"-";"-";"-";"-";"-";"-";"-";"-";"-";"-";"-";"-"
"10 Paź 2024 10:59:33";"Transakcja Sprzedaży";"O2-D8-99N2CT";"T2-D8-5MB0RN";"-";"Solana (USD)";"50 Jednost.";"138,388";"-";"-";"-";"-";"3,956056";"27 373,53";"0,00";"-";"-";"-";"-";"-";"-";"-";"-";"-";"-";"-";"-";"-";"-";"-";"-";"-";"-";"-";"-";"-";"-";"-";"-";"-"
"10 Paź 2024 10:52:21";"Stop Loss";"O2-D8-99N22X";"T2-D8-5MB0MQ";"-";"Solana (USD)";"50,9 Jednost.";"139,007";"-";"-";"-";"-";"3,91594";"27 985,58";"24,72";"46 748,62";"-";"-";"-";"-";"-";"-";"-";"-";"-";"-";"-";"-";"-";"-";"-";"-";"-";"-";"-";"-";"-";"-";"-";"-"
"10 Paź 2024 10:50:37";"Zmodyfikowano Transakcję Sprzedaży";"O2-D8-99N22X";"T2-D8-5MB0JK";"-";"Solana (USD)";"50,9 Jednost.";"139,131";"-";"139,000";"-";"-";"-";"-";"0,00";"-";"-";"-";"-";"-";"-";"-";"-";"-";"-";"-";"-";"-";"-";"-";"-";"-";"-";"-";"-";"-";"-";"-";"-";"-"
"10 Paź 2024 10:48:02";"Transakcja Sprzedaży";"O2-D8-99N22X";"T2-D8-5MB0JK";"-";"Solana (USD)";"50,9 Jednost.";"139,131";"-";"-";"-";"-";"3,954002";"28 001,32";"0,00";"-";"-";"-";"-";"-";"-";"-";"-";"-";"-";"-";"-";"-";"-";"-";"-";"-";"-";"-";"-";"-";"-";"-";"-";"-"
"10 Paź 2024 06:19:00";" Zamknięcie Transakcji";"O2-D8-99MR4B";"T2-D8-5M9RPE";"O2-D8-99M9EX";"Solana (USD)";"24,29 Jednost.";"139,890";"-";"-";"-";"-";"3,90642";"13 407,11";"111,49";"46 723,90";"-";"-";"-";"-";"-";"-";"-";"-";"-";"-";"-";"-";"-";"-";"-";"-";"-";"-";"-";"-";"-";"-";"-";"-"
"09 Paź 2024 23:02:05";"Koszty Utrzymania Pozycji";"1379358263";"-";"-";"Rachunek";"-";"-";"-";"-";"-";"-";"-";"-";"-115,02";"46 612,41";"-";"-";"-";"-";"-";"-115,02";"-";"-";"-";"-";"-";"-";"-";"-";"-";"-";"-";"-";"-";"-";"-";"-";"-";"-"
"09 Paź 2024 23:02:05";"Koszty Utrzymania Pozycji";"O2-D6-97Q7VH";"-";"-";"Solana (USD)";"-";"-";"-";"-";"-";"-";"-";"-";"-";"-";"-";"-";"9 293,57";"-10,00000%";"9,95";"0,00";"-";"-";"-";"-";"-";"-";"-";"-";"-";"-";"-";"-";"-";"-";"-";"-";"-";"-"
"09 Paź 2024 23:02:05";"Koszty Utrzymania Pozycji";"O2-D5-97BZ7D";"-";"-";"Solana (USD)";"-";"-";"-";"-";"-";"-";"-";"-";"-";"-";"-";"-";"4 161,30";"-10,00000%";"4,46";"0,00";"-";"-";"-";"-";"-";"-";"-";"-";"-";"-";"-";"-";"-";"-";"-";"-";"-";"-"
"09 Paź 2024 23:02:05";"Koszty Utrzymania Pozycji";"O2-D4-95TL4Z";"-";"-";"Solana (USD)";"-";"-";"-";"-";"-";"-";"-";"-";"-";"-";"-";"-";"3 120,97";"-27,50000%";"-9,28";"0,00";"-";"-";"-";"-";"-";"-";"-";"-";"-";"-";"-";"-";"-";"-";"-";"-";"-";"-"
"09 Paź 2024 23:02:05";"Koszty Utrzymania Pozycji";"O2-D8-99FH3B";"-";"-";"Solana (USD)";"-";"-";"-";"-";"-";"-";"-";"-";"-";"-";"-";"-";"1 692,26";"-27,50000%";"-5,03";"0,00";"-";"-";"-";"-";"-";"-";"-";"-";"-";"-";"-";"-";"-";"-";"-";"-";"-";"-"
"09 Paź 2024 23:02:05";"Koszty Utrzymania Pozycji";"O2-D5-97FGFP";"-";"-";"Solana (USD)";"-";"-";"-";"-";"-";"-";"-";"-";"-";"-";"-";"-";"6 935,50";"-10,00000%";"7,43";"0,00";"-";"-";"-";"-";"-";"-";"-";"-";"-";"-";"-";"-";"-";"-";"-";"-";"-";"-"
"09 Paź 2024 23:02:05";"Koszty Utrzymania Pozycji";"O2-D5-96SWM1";"-";"-";"Solana (USD)";"-";"-";"-";"-";"-";"-";"-";"-";"-";"-";"-";"-";"11 651,64";"-27,50000%";"-34,65";"0,00";"-";"-";"-";"-";"-";"-";"-";"-";"-";"-";"-";"-";"-";"-";"-";"-";"-";"-"
"09 Paź 2024 23:02:05";"Koszty Utrzymania Pozycji";"O2-D4-95EL0T";"-";"-";"Solana (USD)";"-";"-";"-";"-";"-";"-";"-";"-";"-";"-";"-";"-";"4 161,30";"-27,50000%";"-12,38";"0,00";"-";"-";"-";"-";"-";"-";"-";"-";"-";"-";"-";"-";"-";"-";"-";"-";"-";"-"
"09 Paź 2024 23:02:05";"Koszty Utrzymania Pozycji";"O2-D8-99JWX0";"-";"-";"Solana (USD)";"-";"-";"-";"-";"-";"-";"-";"-";"-";"-";"-";"-";"4 201,52";"-27,50000%";"-12,50";"0,00";"-";"-";"-";"-";"-";"-";"-";"-";"-";"-";"-";"-";"-";"-";"-";"-";"-";"-"
"09 Paź 2024 23:02:05";"Koszty Utrzymania Pozycji";"O2-D4-96156D";"-";"-";"Solana (USD)";"-";"-";"-";"-";"-";"-";"-";"-";"-";"-";"-";"-";"3 398,39";"-27,50000%";"-10,11";"0,00";"-";"-";"-";"-";"-";"-";"-";"-";"-";"-";"-";"-";"-";"-";"-";"-";"-";"-"
"09 Paź 2024 23:02:05";"Koszty Utrzymania Pozycji";"O2-D5-97FD8D";"-";"-";"Solana (USD)";"-";"-";"-";"-";"-";"-";"-";"-";"-";"-";"-";"-";"6 935,50";"-10,00000%";"7,43";"0,00";"-";"-";"-";"-";"-";"-";"-";"-";"-";"-";"-";"-";"-";"-";"-";"-";"-";"-"
"09 Paź 2024 23:02:05";"Koszty Utrzymania Pozycji";"O2-D4-95K8MW";"-";"-";"Solana (USD)";"-";"-";"-";"-";"-";"-";"-";"-";"-";"-";"-";"-";"6 935,50";"-10,00000%";"7,43";"0,00";"-";"-";"-";"-";"-";"-";"-";"-";"-";"-";"-";"-";"-";"-";"-";"-";"-";"-"
"09 Paź 2024 23:02:05";"Koszty Utrzymania Pozycji";"O2-D5-96WE65";"-";"-";"Solana (USD)";"-";"-";"-";"-";"-";"-";"-";"-";"-";"-";"-";"-";"6 658,08";"-27,50000%";"-19,80";"0,00";"-";"-";"-";"-";"-";"-";"-";"-";"-";"-";"-";"-";"-";"-";"-";"-";"-";"-"
"09 Paź 2024 23:02:05";"Koszty Utrzymania Pozycji";"O2-D3-94JY88";"-";"-";"Solana (USD)";"-";"-";"-";"-";"-";"-";"-";"-";"-";"-";"-";"-";"3 467,75";"-27,50000%";"-10,31";"0,00";"-";"-";"-";"-";"-";"-";"-";"-";"-";"-";"-";"-";"-";"-";"-";"-";"-";"-"
"09 Paź 2024 23:02:05";"Koszty Utrzymania Pozycji";"O2-D8-99K6Z8";"-";"-";"Solana (USD)";"-";"-";"-";"-";"-";"-";"-";"-";"-";"-";"-";"-";"8 322,60";"-27,50000%";"-24,75";"0,00";"-";"-";"-";"-";"-";"-";"-";"-";"-";"-";"-";"-";"-";"-";"-";"-";"-";"-"
"09 Paź 2024 23:02:05";"Koszty Utrzymania Pozycji";"O2-D8-99M9EX";"-";"-";"Solana (USD)";"-";"-";"-";"-";"-";"-";"-";"-";"-";"-";"-";"-";"3 369,26";"-10,00000%";"3,61";"0,00";"-";"-";"-";"-";"-";"-";"-";"-";"-";"-";"-";"-";"-";"-";"-";"-";"-";"-"
"09 Paź 2024 23:02:05";"Koszty Utrzymania Pozycji";"O2-D6-97Z6BV";"-";"-";"Solana (USD)";"-";"-";"-";"-";"-";"-";"-";"-";"-";"-";"-";"-";"4 847,91";"-10,00000%";"5,19";"0,00";"-";"-";"-";"-";"-";"-";"-";"-";"-";"-";"-";"-";"-";"-";"-";"-";"-";"-"
"09 Paź 2024 23:02:05";"Koszty Utrzymania Pozycji";"O2-D8-99KTHY";"-";"-";"Solana (USD)";"-";"-";"-";"-";"-";"-";"-";"-";"-";"-";"-";"-";"8 322,60";"-27,50000%";"-24,75";"0,00";"-";"-";"-";"-";"-";"-";"-";"-";"-";"-";"-";"-";"-";"-";"-";"-";"-";"-"
"09 Paź 2024 23:02:05";"Koszty Utrzymania Pozycji";"O2-D6-97W2F5";"-";"-";"Solana (USD)";"-";"-";"-";"-";"-";"-";"-";"-";"-";"-";"-";"-";"3 467,75";"-10,00000%";"3,71";"0,00";"-";"-";"-";"-";"-";"-";"-";"-";"-";"-";"-";"-";"-";"-";"-";"-";"-";"-"
"09 Paź 2024 23:02:05";"Koszty Utrzymania Pozycji";"O2-D8-99JVDD";"-";"-";"Solana (USD)";"-";"-";"-";"-";"-";"-";"-";"-";"-";"-";"-";"-";"5 444,36";"-27,50000%";"-16,19";"0,00";"-";"-";"-";"-";"-";"-";"-";"-";"-";"-";"-";"-";"-";"-";"-";"-";"-";"-"
"09 Paź 2024 23:02:05";"Koszty Utrzymania Pozycji";"O2-D6-97PWJQ";"-";"-";"Solana (USD)";"-";"-";"-";"-";"-";"-";"-";"-";"-";"-";"-";"-";"5 479,04";"-10,00000%";"5,87";"0,00";"-";"-";"-";"-";"-";"-";"-";"-";"-";"-";"-";"-";"-";"-";"-";"-";"-";"-"
"09 Paź 2024 23:02:05";"Koszty Utrzymania Pozycji";"O2-D5-977RC9";"-";"-";"Solana (USD)";"-";"-";"-";"-";"-";"-";"-";"-";"-";"-";"-";"-";"9 016,15";"-10,00000%";"9,65";"0,00";"-";"-";"-";"-";"-";"-";"-";"-";"-";"-";"-";"-";"-";"-";"-";"-";"-";"-"
"09 Paź 2024 19:47:46";"Transakcja Sprzedaży";"O2-D8-99M9EX";"T2-D8-5M9DK8";"-";"Solana (USD)";"24,29 Jednost.";"141,065";"-";"-";"-";"-";"3,946607";"13 522,92";"0,00";"-";"-";"-";"-";"-";"-";"-";"-";"-";"-";"-";"-";"-";"-";"-";"-";"-";"-";"-";"-";"-";"-";"-";"-";"-"
"09 Paź 2024 19:46:17";" Zamknięcie Transakcji";"O2-D8-99M9CQ";"T2-D8-5M9DHP";"O2-D8-99M6E4";"Solana (USD)";"3,3 Jednost.";"141,082";"-";"-";"-";"-";"3,90689";"1 837,21";"0,67";"46 727,43";"-";"-";"-";"-";"-";"-";"-";"-";"-";"-";"-";"-";"-";"-";"-";"-";"-";"-";"-";"-";"-";"-";"-";"-"
"09 Paź 2024 18:35:43";" Transakcja Kupna";"O2-D8-99M6E4";"T2-D8-5M9B1V";"-";"Solana (USD)";"3,3 Jednost.";"141,030";"-";"-";"-";"-";"3,943441";"1 835,27";"0,00";"-";"-";"-";"-";"-";"-";"-";"-";"-";"-";"-";"-";"-";"-";"-";"-";"-";"-";"-";"-";"-";"-";"-";"-";"-"
"09 Paź 2024 18:26:52";"Stop Loss";"O2-D8-99LZ18";"T2-D8-5M99KG";"-";"Solana (USD)";"51 Jednost.";"141,205";"-";"-";"-";"-";"3,90327";"28 391,65";"83,01";"46 726,76";"-";"-";"-";"-";"-";"-";"-";"-";"-";"-";"-";"-";"-";"-";"-";"-";"-";"-";"-";"-";"-";"-";"-";"-"
"09 Paź 2024 18:25:49";"Zmodyfikowano Stop Loss";"O2-D8-99LZ18";"-";"O2-D8-99M5M2";"Solana (USD)";"51 Jednost.";"141,622";"-";"141,200";"-";"-";"-";"-";"-";"-";"-";"-";"-";"-";"-";"-";"-";"-";"-";"-";"-";"-";"-";"-";"-";"-";"-";"-";"-";"-";"-";"-";"-";"-"
"09 Paź 2024 18:24:07";"Zmodyfikowano Transakcję Sprzedaży";"O2-D8-99LZ18";"T2-D8-5M93RH";"-";"Solana (USD)";"51 Jednost.";"141,622";"-";"141,400";"-";"-";"-";"-";"0,00";"-";"-";"-";"-";"-";"-";"-";"-";"-";"-";"-";"-";"-";"-";"-";"-";"-";"-";"-";"-";"-";"-";"-";"-";"-"
"09 Paź 2024 17:07:27";"Transakcja Sprzedaży";"O2-D8-99LZ18";"T2-D8-5M93RH";"-";"Solana (USD)";"51 Jednost.";"141,622";"-";"-";"-";"-";"3,94295";"28 478,83";"0,00";"-";"-";"-";"-";"-";"-";"-";"-";"-";"-";"-";"-";"-";"-";"-";"-";"-";"-";"-";"-";"-";"-";"-";"-";"-"
"09 Paź 2024 16:34:59";" Zamknięcie Transakcji";"O2-D8-99LVR2";"T2-D8-5M910R";"O2-D8-99LFYY";"Solana (USD)";"46,6 Jednost.";"141,185";"-";"-";"-";"-";"3,90276";"25 935,21";"59,11";"46 643,75";"-";"-";"-";"-";"-";"-";"-";"-";"-";"-";"-";"-";"-";"-";"-";"-";"-";"-";"-";"-";"-";"-";"-";"-"
"09 Paź 2024 14:41:33";"Transakcja Sprzedaży";"O2-D8-99LFYY";"T2-D8-5M8NYJ";"-";"Solana (USD)";"46,6 Jednost.";"141,510";"-";"-";"-";"-";"3,94294";"26 001,18";"0,00";"-";"-";"-";"-";"-";"-";"-";"-";"-";"-";"-";"-";"-";"-";"-";"-";"-";"-";"-";"-";"-";"-";"-";"-";"-"
"09 Paź 2024 07:38:44";" Zmodyfikowano Transakcję Kupna";"O2-D8-99KTHY";"T2-D8-5M85KY";"-";"Solana (USD)";"60 Jednost.";"143,880";"-";"-";"-";"-";"-";"-";"0,00";"-";"-";"-";"-";"-";"-";"-";"-";"-";"-";"-";"-";"-";"-";"-";"-";"-";"-";"-";"-";"-";"-";"-";"-";"-"
"09 Paź 2024 07:38:35";" Transakcja Kupna";"O2-D8-99KTHY";"T2-D8-5M85KY";"-";"Solana (USD)";"60 Jednost.";"143,880";"-";"141,003";"-";"-";"3,93796";"33 995,62";"0,00";"-";"-";"-";"-";"-";"-";"-";"-";"-";"-";"-";"-";"-";"-";"-";"-";"-";"-";"-";"-";"-";"-";"-";"-";"-"
"09 Paź 2024 06:52:22";" Zamknięcie Transakcji";"O2-D8-99KQYT";"T2-D8-5M839K";"O2-D6-97M6H8";"Solana (USD)";"54 Jednost.";"143,150";"-";"-";"-";"-";"3,90409";"30 482,25";"1 147,92";"46 584,64";"-";"-";"-";"-";"-";"-";"-";"-";"-";"-";"-";"-";"-";"-";"-";"-";"-";"-";"-";"-";"-";"-";"-";"-"
"08 Paź 2024 23:02:05";"Koszty Utrzymania Pozycji";"1379022516";"-";"-";"Rachunek";"-";"-";"-";"-";"-";"-";"-";"-";"-120,57";"45 436,72";"-";"-";"-";"-";"-";"-120,57";"-";"-";"-";"-";"-";"-";"-";"-";"-";"-";"-";"-";"-";"-";"-";"-";"-";"-"
"08 Paź 2024 23:02:05";"Koszty Utrzymania Pozycji";"O2-D6-97M6H8";"-";"-";"Solana (USD)";"-";"-";"-";"-";"-";"-";"-";"-";"-";"-";"-";"-";"7 792,74";"-27,50000%";"-23,12";"0,00";"-";"-";"-";"-";"-";"-";"-";"-";"-";"-";"-";"-";"-";"-";"-";"-";"-";"-"
"08 Paź 2024 23:02:05";"Koszty Utrzymania Pozycji";"O2-D6-97Q7VH";"-";"-";"Solana (USD)";"-";"-";"-";"-";"-";"-";"-";"-";"-";"-";"-";"-";"9 668,77";"-10,00000%";"10,33";"0,00";"-";"-";"-";"-";"-";"-";"-";"-";"-";"-";"-";"-";"-";"-";"-";"-";"-";"-"
"08 Paź 2024 23:02:05";"Koszty Utrzymania Pozycji";"O2-D5-97BZ7D";"-";"-";"Solana (USD)";"-";"-";"-";"-";"-";"-";"-";"-";"-";"-";"-";"-";"4 329,30";"-10,00000%";"4,62";"0,00";"-";"-";"-";"-";"-";"-";"-";"-";"-";"-";"-";"-";"-";"-";"-";"-";"-";"-"
"08 Paź 2024 23:02:05";"Koszty Utrzymania Pozycji";"O2-D4-95TL4Z";"-";"-";"Solana (USD)";"-";"-";"-";"-";"-";"-";"-";"-";"-";"-";"-";"-";"3 246,97";"-27,50000%";"-9,63";"0,00";"-";"-";"-";"-";"-";"-";"-";"-";"-";"-";"-";"-";"-";"-";"-";"-";"-";"-"
"08 Paź 2024 23:02:05";"Koszty Utrzymania Pozycji";"O2-D8-99FH3B";"-";"-";"Solana (USD)";"-";"-";"-";"-";"-";"-";"-";"-";"-";"-";"-";"-";"1 760,58";"-27,50000%";"-5,22";"0,00";"-";"-";"-";"-";"-";"-";"-";"-";"-";"-";"-";"-";"-";"-";"-";"-";"-";"-"
"08 Paź 2024 23:02:05";"Koszty Utrzymania Pozycji";"O2-D5-97FGFP";"-";"-";"Solana (USD)";"-";"-";"-";"-";"-";"-";"-";"-";"-";"-";"-";"-";"7 215,50";"-10,00000%";"7,71";"0,00";"-";"-";"-";"-";"-";"-";"-";"-";"-";"-";"-";"-";"-";"-";"-";"-";"-";"-"
"08 Paź 2024 23:02:05";"Koszty Utrzymania Pozycji";"O2-D5-96SWM1";"-";"-";"Solana (USD)";"-";"-";"-";"-";"-";"-";"-";"-";"-";"-";"-";"-";"12 122,04";"-27,50000%";"-35,97";"0,00";"-";"-";"-";"-";"-";"-";"-";"-";"-";"-";"-";"-";"-";"-";"-";"-";"-";"-"
"08 Paź 2024 23:02:05";"Koszty Utrzymania Pozycji";"O2-D4-95EL0T";"-";"-";"Solana (USD)";"-";"-";"-";"-";"-";"-";"-";"-";"-";"-";"-";"-";"4 329,30";"-27,50000%";"-12,85";"0,00";"-";"-";"-";"-";"-";"-";"-";"-";"-";"-";"-";"-";"-";"-";"-";"-";"-";"-"
"08 Paź 2024 23:02:05";"Koszty Utrzymania Pozycji";"O2-D8-99JWX0";"-";"-";"Solana (USD)";"-";"-";"-";"-";"-";"-";"-";"-";"-";"-";"-";"-";"4 371,14";"-27,50000%";"-12,97";"0,00";"-";"-";"-";"-";"-";"-";"-";"-";"-";"-";"-";"-";"-";"-";"-";"-";"-";"-"
"08 Paź 2024 23:02:05";"Koszty Utrzymania Pozycji";"O2-D4-96156D";"-";"-";"Solana (USD)";"-";"-";"-";"-";"-";"-";"-";"-";"-";"-";"-";"-";"3 535,59";"-27,50000%";"-10,49";"0,00";"-";"-";"-";"-";"-";"-";"-";"-";"-";"-";"-";"-";"-";"-";"-";"-";"-";"-"
"08 Paź 2024 23:02:05";"Koszty Utrzymania Pozycji";"O2-D5-97FD8D";"-";"-";"Solana (USD)";"-";"-";"-";"-";"-";"-";"-";"-";"-";"-";"-";"-";"7 215,50";"-10,00000%";"7,71";"0,00";"-";"-";"-";"-";"-";"-";"-";"-";"-";"-";"-";"-";"-";"-";"-";"-";"-";"-"
"08 Paź 2024 23:02:05";"Koszty Utrzymania Pozycji";"O2-D4-95K8MW";"-";"-";"Solana (USD)";"-";"-";"-";"-";"-";"-";"-";"-";"-";"-";"-";"-";"7 215,50";"-10,00000%";"7,71";"0,00";"-";"-";"-";"-";"-";"-";"-";"-";"-";"-";"-";"-";"-";"-";"-";"-";"-";"-"
"08 Paź 2024 23:02:05";"Koszty Utrzymania Pozycji";"O2-D5-96WE65";"-";"-";"Solana (USD)";"-";"-";"-";"-";"-";"-";"-";"-";"-";"-";"-";"-";"6 926,88";"-27,50000%";"-20,55";"0,00";"-";"-";"-";"-";"-";"-";"-";"-";"-";"-";"-";"-";"-";"-";"-";"-";"-";"-"
"08 Paź 2024 23:02:05";"Koszty Utrzymania Pozycji";"O2-D3-94JY88";"-";"-";"Solana (USD)";"-";"-";"-";"-";"-";"-";"-";"-";"-";"-";"-";"-";"3 607,75";"-27,50000%";"-10,70";"0,00";"-";"-";"-";"-";"-";"-";"-";"-";"-";"-";"-";"-";"-";"-";"-";"-";"-";"-"
"08 Paź 2024 23:02:05";"Koszty Utrzymania Pozycji";"O2-D8-99K6Z8";"-";"-";"Solana (USD)";"-";"-";"-";"-";"-";"-";"-";"-";"-";"-";"-";"-";"8 658,60";"-27,50000%";"-25,69";"0,00";"-";"-";"-";"-";"-";"-";"-";"-";"-";"-";"-";"-";"-";"-";"-";"-";"-";"-"
"08 Paź 2024 23:02:05";"Koszty Utrzymania Pozycji";"O2-D6-97Z6BV";"-";"-";"Solana (USD)";"-";"-";"-";"-";"-";"-";"-";"-";"-";"-";"-";"-";"5 043,63";"-10,00000%";"5,39";"0,00";"-";"-";"-";"-";"-";"-";"-";"-";"-";"-";"-";"-";"-";"-";"-";"-";"-";"-"
"08 Paź 2024 23:02:05";"Koszty Utrzymania Pozycji";"O2-D6-97W2F5";"-";"-";"Solana (USD)";"-";"-";"-";"-";"-";"-";"-";"-";"-";"-";"-";"-";"3 607,75";"-10,00000%";"3,85";"0,00";"-";"-";"-";"-";"-";"-";"-";"-";"-";"-";"-";"-";"-";"-";"-";"-";"-";"-"
"08 Paź 2024 23:02:05";"Koszty Utrzymania Pozycji";"O2-D8-99JVDD";"-";"-";"Solana (USD)";"-";"-";"-";"-";"-";"-";"-";"-";"-";"-";"-";"-";"5 664,16";"-27,50000%";"-16,81";"0,00";"-";"-";"-";"-";"-";"-";"-";"-";"-";"-";"-";"-";"-";"-";"-";"-";"-";"-"
"08 Paź 2024 23:02:05";"Koszty Utrzymania Pozycji";"O2-D6-97PWJQ";"-";"-";"Solana (USD)";"-";"-";"-";"-";"-";"-";"-";"-";"-";"-";"-";"-";"5 700,24";"-10,00000%";"6,09";"0,00";"-";"-";"-";"-";"-";"-";"-";"-";"-";"-";"-";"-";"-";"-";"-";"-";"-";"-"
"08 Paź 2024 23:02:05";"Koszty Utrzymania Pozycji";"O2-D5-977RC9";"-";"-";"Solana (USD)";"-";"-";"-";"-";"-";"-";"-";"-";"-";"-";"-";"-";"9 380,15";"-10,00000%";"10,02";"0,00";"-";"-";"-";"-";"-";"-";"-";"-";"-";"-";"-";"-";"-";"-";"-";"-";"-";"-"
"08 Paź 2024 19:59:05";" Zmodyfikowano Transakcję Kupna";"O2-D8-99K6Z8";"T2-D8-5M7NJ2";"-";"Solana (USD)";"60 Jednost.";"143,361";"-";"-";"-";"-";"-";"-";"0,00";"-";"-";"-";"-";"-";"-";"-";"-";"-";"-";"-";"-";"-";"-";"-";"-";"-";"-";"-";"-";"-";"-";"-";"-";"-"
"08 Paź 2024 19:58:56";" Transakcja Kupna";"O2-D8-99K6Z8";"T2-D8-5M7NJ2";"-";"Solana (USD)";"60 Jednost.";"143,361";"-";"140,494";"-";"-";"3,941888";"33 906,78";"0,00";"-";"-";"-";"-";"-";"-";"-";"-";"-";"-";"-";"-";"-";"-";"-";"-";"-";"-";"-";"-";"-";"-";"-";"-";"-"
"08 Paź 2024 18:00:14";" Zamknięcie Transakcji";"O2-D8-99K101";"T2-D8-5M7HK4";"O2-D6-98C2XK";"Solana (USD)";"12 Jednost.";"142,550";"-";"-";"-";"-";"3,90732";"6 751,04";"161,29";"45 557,29";"-";"-";"-";"-";"-";"-";"-";"-";"-";"-";"-";"-";"-";"-";"-";"-";"-";"-";"-";"-";"-";"-";"-";"-"
"08 Paź 2024 17:57:54";" Zamknięcie Transakcji";"O2-D8-99K0VY";"T2-D8-5M7HFR";"O2-D8-99JZPC";"Solana (USD)";"58,31 Jednost.";"142,580";"-";"-";"-";"-";"3,90704";"32 808,95";"34,17";"45 396,00";"-";"-";"-";"-";"-";"-";"-";"-";"-";"-";"-";"-";"-";"-";"-";"-";"-";"-";"-";"-";"-";"-";"-";"-"
"08 Paź 2024 17:40:13";" Zmodyfikowano Transakcję Kupna";"O2-D8-99JZPC";"T2-D8-5M7GG7";"-";"Solana (USD)";"58,31 Jednost.";"142,430";"-";"-";"-";"-";"-";"-";"0,00";"-";"-";"-";"-";"-";"-";"-";"-";"-";"-";"-";"-";"-";"-";"-";"-";"-";"-";"-";"-";"-";"-";"-";"-";"-"
"08 Paź 2024 17:40:05";" Transakcja Kupna";"O2-D8-99JZPC";"T2-D8-5M7GG7";"-";"Solana (USD)";"58,31 Jednost.";"142,430";"-";"139,617";"-";"-";"3,94822";"32 790,33";"0,00";"-";"-";"-";"-";"-";"-";"-";"-";"-";"-";"-";"-";"-";"-";"-";"-";"-";"-";"-";"-";"-";"-";"-";"-";"-"
"08 Paź 2024 17:35:50";" Zamknięcie Transakcji";"O2-D8-99JZDW";"T2-D8-5M7G7X";"O2-D6-97M8KS";"Solana (USD)";"60 Jednost.";"141,086";"-";"-";"-";"-";"3,91047";"33 435,46";"1 067,32";"45 361,83";"-";"-";"-";"-";"-";"-";"-";"-";"-";"-";"-";"-";"-";"-";"-";"-";"-";"-";"-";"-";"-";"-";"-";"-"
"08 Paź 2024 17:05:11";" Zmodyfikowano Transakcję Kupna";"O2-D8-99JWX0";"T2-D8-5M7E3T";"-";"Solana (USD)";"30,29 Jednost.";"143,840";"-";"-";"-";"-";"-";"-";"0,00";"-";"-";"-";"-";"-";"-";"-";"-";"-";"-";"-";"-";"-";"-";"-";"-";"-";"-";"-";"-";"-";"-";"-";"-";"-"
"08 Paź 2024 17:05:02";" Transakcja Kupna";"O2-D8-99JWX0";"T2-D8-5M7E3T";"-";"Solana (USD)";"30,29 Jednost.";"143,840";"-";"140,964";"-";"-";"3,94791";"17 200,70";"0,00";"-";"-";"-";"-";"-";"-";"-";"-";"-";"-";"-";"-";"-";"-";"-";"-";"-";"-";"-";"-";"-";"-";"-";"-";"-"
"08 Paź 2024 16:50:11";" Transakcja Kupna";"O2-D8-99JVDD";"T2-D8-5M7CYG";"-";"Solana (USD)";"39,25 Jednost.";"144,095";"-";"-";"-";"-";"3,94807";"22 329,21";"0,00";"-";"-";"-";"-";"-";"-";"-";"-";"-";"-";"-";"-";"-";"-";"-";"-";"-";"-";"-";"-";"-";"-";"-";"-";"-"
"08 Paź 2024 16:06:18";" Zamknięcie Transakcji";"O2-D8-99JNVC";"T2-D8-5M76XT";"O2-D6-98C2XK";"Solana (USD)";"3 Jednost.";"144,505";"-";"-";"-";"-";"3,90609";"1 710,37";"63,22";"44 294,51";"-";"-";"-";"-";"-";"-";"-";"-";"-";"-";"-";"-";"-";"-";"-";"-";"-";"-";"-";"-";"-";"-";"-";"-"
"08 Paź 2024 16:05:18";"Stop Loss";"O2-D8-99J83W";"T2-D8-5M76T6";"-";"Solana (USD)";"33,03 Jednost.";"144,795";"-";"-";"-";"-";"3,9053";"18 865,08";"62,95";"44 231,29";"-";"-";"-";"-";"-";"-";"-";"-";"-";"-";"-";"-";"-";"-";"-";"-";"-";"-";"-";"-";"-";"-";"-";"-"
"08 Paź 2024 16:03:18";" Zmodyfikowano Transakcję Kupna";"O2-D8-99J83W";"T2-D8-5M6VCV";"-";"Solana (USD)";"33,03 Jednost.";"144,307";"-";"144,800";"-";"-";"-";"-";"0,00";"-";"-";"-";"-";"-";"-";"-";"-";"-";"-";"-";"-";"-";"-";"-";"-";"-";"-";"-";"-";"-";"-";"-";"-";"-"
"08 Paź 2024 12:52:35";" Zmodyfikowano Transakcję Kupna";"O2-D8-99J83W";"T2-D8-5M6VCV";"-";"Solana (USD)";"33,03 Jednost.";"144,307";"-";"-";"-";"-";"-";"-";"0,00";"-";"-";"-";"-";"-";"-";"-";"-";"-";"-";"-";"-";"-";"-";"-";"-";"-";"-";"-";"-";"-";"-";"-";"-";"-"
"08 Paź 2024 12:52:24";" Transakcja Kupna";"O2-D8-99J83W";"T2-D8-5M6VCV";"-";"Solana (USD)";"33,03 Jednost.";"144,307";"-";"141,430";"-";"-";"3,944282";"18 800,26";"0,00";"-";"-";"-";"-";"-";"-";"-";"-";"-";"-";"-";"-";"-";"-";"-";"-";"-";"-";"-";"-";"-";"-";"-";"-";"-"
"08 Paź 2024 09:20:24";" Zamknięcie Transakcji";"O2-D8-99HVM3";"T2-D8-5M6J3J";"O2-D6-98C2XK";"Solana (USD)";"5 Jednost.";"142,120";"-";"-";"-";"-";"3,9172";"2 811,53";"58,95";"44 168,34";"-";"-";"-";"-";"-";"-";"-";"-";"-";"-";"-";"-";"-";"-";"-";"-";"-";"-";"-";"-";"-";"-";"-";"-"
"08 Paź 2024 09:20:02";" Zamknięcie Transakcji";"O2-D8-99HVJT";"T2-D8-5M6J1N";"O2-D6-98C2XK";"Solana (USD)";"14,45 Jednost.";"142,185";"-";"-";"-";"-";"3,91689";"8 128,41";"174,04";"44 109,39";"-";"-";"-";"-";"-";"-";"-";"-";"-";"-";"-";"-";"-";"-";"-";"-";"-";"-";"-";"-";"-";"-";"-";"-"
"08 Paź 2024 08:58:58";" Wpłata";"1378818044";"BD.27706679";"-";"Rachunek";"-";"-";"-";"-";"-";"-";"-";"-";"5 000,00";"43 935,35";"5 000,00";"0,00";"-";"-";"-";"-";"-";"-";"-";"-";"-";"-";"-";"-";"-";"-";"-";"-";"-";"-";"-";"-";"-";"-"
"07 Paź 2024 23:02:01";"Koszty Utrzymania Pozycji";"1378667622";"-";"-";"Rachunek";"-";"-";"-";"-";"-";"-";"-";"-";"-107,17";"38 935,35";"-";"-";"-";"-";"-";"-107,17";"-";"-";"-";"-";"-";"-";"-";"-";"-";"-";"-";"-";"-";"-";"-";"-";"-";"-"
"07 Paź 2024 23:02:01";"Koszty Utrzymania Pozycji";"O2-D6-97M6H8";"-";"-";"Solana (USD)";"-";"-";"-";"-";"-";"-";"-";"-";"-";"-";"-";"-";"7 867,80";"-27,50000%";"-23,47";"0,00";"-";"-";"-";"-";"-";"-";"-";"-";"-";"-";"-";"-";"-";"-";"-";"-";"-";"-"
"07 Paź 2024 23:02:01";"Koszty Utrzymania Pozycji";"O2-D6-97Q7VH";"-";"-";"Solana (USD)";"-";"-";"-";"-";"-";"-";"-";"-";"-";"-";"-";"-";"9 761,90";"-10,00000%";"10,48";"0,00";"-";"-";"-";"-";"-";"-";"-";"-";"-";"-";"-";"-";"-";"-";"-";"-";"-";"-"
"07 Paź 2024 23:02:01";"Koszty Utrzymania Pozycji";"O2-D5-97BZ7D";"-";"-";"Solana (USD)";"-";"-";"-";"-";"-";"-";"-";"-";"-";"-";"-";"-";"4 371,00";"-10,00000%";"4,69";"0,00";"-";"-";"-";"-";"-";"-";"-";"-";"-";"-";"-";"-";"-";"-";"-";"-";"-";"-"
"07 Paź 2024 23:02:01";"Koszty Utrzymania Pozycji";"O2-D4-95TL4Z";"-";"-";"Solana (USD)";"-";"-";"-";"-";"-";"-";"-";"-";"-";"-";"-";"-";"3 278,25";"-27,50000%";"-9,78";"0,00";"-";"-";"-";"-";"-";"-";"-";"-";"-";"-";"-";"-";"-";"-";"-";"-";"-";"-"
"07 Paź 2024 23:02:01";"Koszty Utrzymania Pozycji";"O2-D8-99FH3B";"-";"-";"Solana (USD)";"-";"-";"-";"-";"-";"-";"-";"-";"-";"-";"-";"-";"1 777,54";"-27,50000%";"-5,30";"0,00";"-";"-";"-";"-";"-";"-";"-";"-";"-";"-";"-";"-";"-";"-";"-";"-";"-";"-"
"07 Paź 2024 23:02:01";"Koszty Utrzymania Pozycji";"O2-D5-97FGFP";"-";"-";"Solana (USD)";"-";"-";"-";"-";"-";"-";"-";"-";"-";"-";"-";"-";"7 285,00";"-10,00000%";"7,82";"0,00";"-";"-";"-";"-";"-";"-";"-";"-";"-";"-";"-";"-";"-";"-";"-";"-";"-";"-"
"07 Paź 2024 23:02:01";"Koszty Utrzymania Pozycji";"O2-D5-96SWM1";"-";"-";"Solana (USD)";"-";"-";"-";"-";"-";"-";"-";"-";"-";"-";"-";"-";"12 238,80";"-27,50000%";"-36,51";"0,00";"-";"-";"-";"-";"-";"-";"-";"-";"-";"-";"-";"-";"-";"-";"-";"-";"-";"-"
"07 Paź 2024 23:02:01";"Koszty Utrzymania Pozycji";"O2-D4-95EL0T";"-";"-";"Solana (USD)";"-";"-";"-";"-";"-";"-";"-";"-";"-";"-";"-";"-";"4 371,00";"-27,50000%";"-13,04";"0,00";"-";"-";"-";"-";"-";"-";"-";"-";"-";"-";"-";"-";"-";"-";"-";"-";"-";"-"
"07 Paź 2024 23:02:01";"Koszty Utrzymania Pozycji";"O2-D4-96156D";"-";"-";"Solana (USD)";"-";"-";"-";"-";"-";"-";"-";"-";"-";"-";"-";"-";"3 569,65";"-27,50000%";"-10,65";"0,00";"-";"-";"-";"-";"-";"-";"-";"-";"-";"-";"-";"-";"-";"-";"-";"-";"-";"-"
"07 Paź 2024 23:02:01";"Koszty Utrzymania Pozycji";"O2-D5-97FD8D";"-";"-";"Solana (USD)";"-";"-";"-";"-";"-";"-";"-";"-";"-";"-";"-";"-";"7 285,00";"-10,00000%";"7,82";"0,00";"-";"-";"-";"-";"-";"-";"-";"-";"-";"-";"-";"-";"-";"-";"-";"-";"-";"-"
"07 Paź 2024 23:02:01";"Koszty Utrzymania Pozycji";"O2-D4-95K8MW";"-";"-";"Solana (USD)";"-";"-";"-";"-";"-";"-";"-";"-";"-";"-";"-";"-";"7 285,00";"-10,00000%";"7,82";"0,00";"-";"-";"-";"-";"-";"-";"-";"-";"-";"-";"-";"-";"-";"-";"-";"-";"-";"-"
"07 Paź 2024 23:02:01";"Koszty Utrzymania Pozycji";"O2-D5-96WE65";"-";"-";"Solana (USD)";"-";"-";"-";"-";"-";"-";"-";"-";"-";"-";"-";"-";"6 993,60";"-27,50000%";"-20,86";"0,00";"-";"-";"-";"-";"-";"-";"-";"-";"-";"-";"-";"-";"-";"-";"-";"-";"-";"-"
"07 Paź 2024 23:02:01";"Koszty Utrzymania Pozycji";"O2-D3-94JY88";"-";"-";"Solana (USD)";"-";"-";"-";"-";"-";"-";"-";"-";"-";"-";"-";"-";"3 642,50";"-27,50000%";"-10,87";"0,00";"-";"-";"-";"-";"-";"-";"-";"-";"-";"-";"-";"-";"-";"-";"-";"-";"-";"-"
"07 Paź 2024 23:02:01";"Koszty Utrzymania Pozycji";"O2-D6-98C2XK";"-";"-";"Solana (USD)";"-";"-";"-";"-";"-";"-";"-";"-";"-";"-";"-";"-";"5 019,36";"-27,50000%";"-14,97";"0,00";"-";"-";"-";"-";"-";"-";"-";"-";"-";"-";"-";"-";"-";"-";"-";"-";"-";"-"
"07 Paź 2024 23:02:01";"Koszty Utrzymania Pozycji";"O2-D6-97M8KS";"-";"-";"Solana (USD)";"-";"-";"-";"-";"-";"-";"-";"-";"-";"-";"-";"-";"8 742,00";"-27,50000%";"-26,08";"0,00";"-";"-";"-";"-";"-";"-";"-";"-";"-";"-";"-";"-";"-";"-";"-";"-";"-";"-"
"07 Paź 2024 23:02:01";"Koszty Utrzymania Pozycji";"O2-D6-97Z6BV";"-";"-";"Solana (USD)";"-";"-";"-";"-";"-";"-";"-";"-";"-";"-";"-";"-";"5 092,21";"-10,00000%";"5,47";"0,00";"-";"-";"-";"-";"-";"-";"-";"-";"-";"-";"-";"-";"-";"-";"-";"-";"-";"-"
"07 Paź 2024 23:02:01";"Koszty Utrzymania Pozycji";"O2-D6-97W2F5";"-";"-";"Solana (USD)";"-";"-";"-";"-";"-";"-";"-";"-";"-";"-";"-";"-";"3 642,50";"-10,00000%";"3,91";"0,00";"-";"-";"-";"-";"-";"-";"-";"-";"-";"-";"-";"-";"-";"-";"-";"-";"-";"-"
"07 Paź 2024 23:02:01";"Koszty Utrzymania Pozycji";"O2-D6-97PWJQ";"-";"-";"Solana (USD)";"-";"-";"-";"-";"-";"-";"-";"-";"-";"-";"-";"-";"5 755,15";"-10,00000%";"6,18";"0,00";"-";"-";"-";"-";"-";"-";"-";"-";"-";"-";"-";"-";"-";"-";"-";"-";"-";"-"
"07 Paź 2024 23:02:01";"Koszty Utrzymania Pozycji";"O2-D5-977RC9";"-";"-";"Solana (USD)";"-";"-";"-";"-";"-";"-";"-";"-";"-";"-";"-";"-";"9 470,50";"-10,00000%";"10,17";"0,00";"-";"-";"-";"-";"-";"-";"-";"-";"-";"-";"-";"-";"-";"-";"-";"-";"-";"-"
"07 Paź 2024 12:08:28";" Zamknięcie Transakcji";"O2-D8-99FXMV";"T2-D8-5M4W20";"O2-D6-97M6H8";"Solana (USD)";"4 Jednost.";"146,940";"-";"-";"-";"-";"3,92296";"2 328,93";"144,91";"39 042,52";"-";"-";"-";"-";"-";"-";"-";"-";"-";"-";"-";"-";"-";"-";"-";"-";"-";"-";"-";"-";"-";"-";"-";"-"
"07 Paź 2024 12:02:19";" Zamknięcie Transakcji";"O2-D8-99FXB2";"T2-D8-5M4VSN";"O2-D6-97M6H8";"Solana (USD)";"25 Jednost.";"146,915";"-";"-";"-";"-";"3,92485";"14 560,34";"903,70";"38 897,61";"-";"-";"-";"-";"-";"-";"-";"-";"-";"-";"-";"-";"-";"-";"-";"-";"-";"-";"-";"-";"-";"-";"-";"-"
"07 Paź 2024 08:46:16";" Transakcja Kupna";"O2-D8-99FH3B";"T2-D8-5M4J64";"-";"Solana (USD)";"12,2 Jednost.";"149,156";"-";"-";"-";"-";"3,954152";"7 195,38";"0,00";"-";"-";"-";"-";"-";"-";"-";"-";"-";"-";"-";"-";"-";"-";"-";"-";"-";"-";"-";"-";"-";"-";"-";"-";"-"
"04 Paź 2024 23:02:11";"Koszty Utrzymania Pozycji";"1378359298";"-";"-";"Rachunek";"-";"-";"-";"-";"-";"-";"-";"-";"-338,41";"37 993,91";"-";"-";"-";"-";"-";"-338,41";"-";"-";"-";"-";"-";"-";"-";"-";"-";"-";"-";"-";"-";"-";"-";"-";"-";"-"
"04 Paź 2024 23:02:11";"Koszty Utrzymania Pozycji";"O2-D6-97Q7VH";"-";"-";"Solana (USD)";"-";"-";"-";"-";"-";"-";"-";"-";"-";"-";"-";"-";"9 641,50";"-10,00000%";"31,00";"0,00";"-";"-";"-";"-";"-";"-";"-";"-";"-";"-";"-";"-";"-";"-";"-";"-";"-";"-"
"04 Paź 2024 23:02:11";"Koszty Utrzymania Pozycji";"O2-D5-97BZ7D";"-";"-";"Solana (USD)";"-";"-";"-";"-";"-";"-";"-";"-";"-";"-";"-";"-";"4 317,09";"-10,00000%";"13,88";"0,00";"-";"-";"-";"-";"-";"-";"-";"-";"-";"-";"-";"-";"-";"-";"-";"-";"-";"-"
"04 Paź 2024 23:02:11";"Koszty Utrzymania Pozycji";"O2-D4-95TL4Z";"-";"-";"Solana (USD)";"-";"-";"-";"-";"-";"-";"-";"-";"-";"-";"-";"-";"3 237,81";"-27,50000%";"-28,92";"0,00";"-";"-";"-";"-";"-";"-";"-";"-";"-";"-";"-";"-";"-";"-";"-";"-";"-";"-"
"04 Paź 2024 23:02:11";"Koszty Utrzymania Pozycji";"O2-D5-97FGFP";"-";"-";"Solana (USD)";"-";"-";"-";"-";"-";"-";"-";"-";"-";"-";"-";"-";"7 195,15";"-10,00000%";"23,14";"0,00";"-";"-";"-";"-";"-";"-";"-";"-";"-";"-";"-";"-";"-";"-";"-";"-";"-";"-"
"04 Paź 2024 23:02:11";"Koszty Utrzymania Pozycji";"O2-D5-96SWM1";"-";"-";"Solana (USD)";"-";"-";"-";"-";"-";"-";"-";"-";"-";"-";"-";"-";"12 087,85";"-27,50000%";"-107,96";"0,00";"-";"-";"-";"-";"-";"-";"-";"-";"-";"-";"-";"-";"-";"-";"-";"-";"-";"-"
"04 Paź 2024 23:02:11";"Koszty Utrzymania Pozycji";"O2-D4-95EL0T";"-";"-";"Solana (USD)";"-";"-";"-";"-";"-";"-";"-";"-";"-";"-";"-";"-";"4 317,09";"-27,50000%";"-38,56";"0,00";"-";"-";"-";"-";"-";"-";"-";"-";"-";"-";"-";"-";"-";"-";"-";"-";"-";"-"
"04 Paź 2024 23:02:11";"Koszty Utrzymania Pozycji";"O2-D4-96156D";"-";"-";"Solana (USD)";"-";"-";"-";"-";"-";"-";"-";"-";"-";"-";"-";"-";"3 525,62";"-27,50000%";"-31,49";"0,00";"-";"-";"-";"-";"-";"-";"-";"-";"-";"-";"-";"-";"-";"-";"-";"-";"-";"-"
"04 Paź 2024 23:02:11";"Koszty Utrzymania Pozycji";"O2-D5-97FD8D";"-";"-";"Solana (USD)";"-";"-";"-";"-";"-";"-";"-";"-";"-";"-";"-";"-";"7 195,15";"-10,00000%";"23,14";"0,00";"-";"-";"-";"-";"-";"-";"-";"-";"-";"-";"-";"-";"-";"-";"-";"-";"-";"-"
"04 Paź 2024 23:02:11";"Koszty Utrzymania Pozycji";"O2-D4-95K8MW";"-";"-";"Solana (USD)";"-";"-";"-";"-";"-";"-";"-";"-";"-";"-";"-";"-";"7 195,15";"-10,00000%";"23,14";"0,00";"-";"-";"-";"-";"-";"-";"-";"-";"-";"-";"-";"-";"-";"-";"-";"-";"-";"-"
"04 Paź 2024 23:02:11";"Koszty Utrzymania Pozycji";"O2-D5-96WE65";"-";"-";"Solana (USD)";"-";"-";"-";"-";"-";"-";"-";"-";"-";"-";"-";"-";"6 907,34";"-27,50000%";"-61,69";"0,00";"-";"-";"-";"-";"-";"-";"-";"-";"-";"-";"-";"-";"-";"-";"-";"-";"-";"-"
"04 Paź 2024 23:02:11";"Koszty Utrzymania Pozycji";"O2-D3-94JY88";"-";"-";"Solana (USD)";"-";"-";"-";"-";"-";"-";"-";"-";"-";"-";"-";"-";"3 597,57";"-27,50000%";"-32,13";"0,00";"-";"-";"-";"-";"-";"-";"-";"-";"-";"-";"-";"-";"-";"-";"-";"-";"-";"-"
"04 Paź 2024 23:02:11";"Koszty Utrzymania Pozycji";"O2-D6-98C2XK";"-";"-";"Solana (USD)";"-";"-";"-";"-";"-";"-";"-";"-";"-";"-";"-";"-";"4 957,45";"-27,50000%";"-44,28";"0,00";"-";"-";"-";"-";"-";"-";"-";"-";"-";"-";"-";"-";"-";"-";"-";"-";"-";"-"
"04 Paź 2024 23:02:11";"Koszty Utrzymania Pozycji";"O2-D6-97M8KS";"-";"-";"Solana (USD)";"-";"-";"-";"-";"-";"-";"-";"-";"-";"-";"-";"-";"8 634,18";"-27,50000%";"-77,11";"0,00";"-";"-";"-";"-";"-";"-";"-";"-";"-";"-";"-";"-";"-";"-";"-";"-";"-";"-"
"04 Paź 2024 23:02:11";"Koszty Utrzymania Pozycji";"O2-D6-97Z6BV";"-";"-";"Solana (USD)";"-";"-";"-";"-";"-";"-";"-";"-";"-";"-";"-";"-";"5 029,40";"-10,00000%";"16,17";"0,00";"-";"-";"-";"-";"-";"-";"-";"-";"-";"-";"-";"-";"-";"-";"-";"-";"-";"-"
"04 Paź 2024 23:02:11";"Koszty Utrzymania Pozycji";"O2-D6-97W2F5";"-";"-";"Solana (USD)";"-";"-";"-";"-";"-";"-";"-";"-";"-";"-";"-";"-";"3 597,57";"-10,00000%";"11,57";"0,00";"-";"-";"-";"-";"-";"-";"-";"-";"-";"-";"-";"-";"-";"-";"-";"-";"-";"-"
"04 Paź 2024 23:02:11";"Koszty Utrzymania Pozycji";"O2-D6-97PWJQ";"-";"-";"Solana (USD)";"-";"-";"-";"-";"-";"-";"-";"-";"-";"-";"-";"-";"5 684,16";"-10,00000%";"18,28";"0,00";"-";"-";"-";"-";"-";"-";"-";"-";"-";"-";"-";"-";"-";"-";"-";"-";"-";"-"
"04 Paź 2024 23:02:11";"Koszty Utrzymania Pozycji";"O2-D5-977RC9";"-";"-";"Solana (USD)";"-";"-";"-";"-";"-";"-";"-";"-";"-";"-";"-";"-";"9 353,69";"-10,00000%";"30,08";"0,00";"-";"-";"-";"-";"-";"-";"-";"-";"-";"-";"-";"-";"-";"-";"-";"-";"-";"-"
"04 Paź 2024 23:02:11";"Koszty Utrzymania Pozycji";"O2-D6-97M6H8";"-";"-";"Solana (USD)";"-";"-";"-";"-";"-";"-";"-";"-";"-";"-";"-";"-";"11 943,94";"-27,50000%";"-106,67";"0,00";"-";"-";"-";"-";"-";"-";"-";"-";"-";"-";"-";"-";"-";"-";"-";"-";"-";"-"
"03 Paź 2024 23:02:08";"Koszty Utrzymania Pozycji";"1377995277";"-";"-";"Rachunek";"-";"-";"-";"-";"-";"-";"-";"-";"-105,98";"38 332,32";"-";"-";"-";"-";"-";"-105,98";"-";"-";"-";"-";"-";"-";"-";"-";"-";"-";"-";"-";"-";"-";"-";"-";"-";"-"
"03 Paź 2024 23:02:08";"Koszty Utrzymania Pozycji";"O2-D6-97Q7VH";"-";"-";"Solana (USD)";"-";"-";"-";"-";"-";"-";"-";"-";"-";"-";"-";"-";"9 118,03";"-10,00000%";"9,71";"0,00";"-";"-";"-";"-";"-";"-";"-";"-";"-";"-";"-";"-";"-";"-";"-";"-";"-";"-"
"03 Paź 2024 23:02:08";"Koszty Utrzymania Pozycji";"O2-D5-97BZ7D";"-";"-";"Solana (USD)";"-";"-";"-";"-";"-";"-";"-";"-";"-";"-";"-";"-";"4 082,70";"-10,00000%";"4,35";"0,00";"-";"-";"-";"-";"-";"-";"-";"-";"-";"-";"-";"-";"-";"-";"-";"-";"-";"-"
"03 Paź 2024 23:02:08";"Koszty Utrzymania Pozycji";"O2-D4-95TL4Z";"-";"-";"Solana (USD)";"-";"-";"-";"-";"-";"-";"-";"-";"-";"-";"-";"-";"3 062,02";"-27,50000%";"-9,06";"0,00";"-";"-";"-";"-";"-";"-";"-";"-";"-";"-";"-";"-";"-";"-";"-";"-";"-";"-"
"03 Paź 2024 23:02:08";"Koszty Utrzymania Pozycji";"O2-D5-97FGFP";"-";"-";"Solana (USD)";"-";"-";"-";"-";"-";"-";"-";"-";"-";"-";"-";"-";"6 804,50";"-10,00000%";"7,25";"0,00";"-";"-";"-";"-";"-";"-";"-";"-";"-";"-";"-";"-";"-";"-";"-";"-";"-";"-"
"03 Paź 2024 23:02:08";"Koszty Utrzymania Pozycji";"O2-D5-96SWM1";"-";"-";"Solana (USD)";"-";"-";"-";"-";"-";"-";"-";"-";"-";"-";"-";"-";"11 431,56";"-27,50000%";"-33,81";"0,00";"-";"-";"-";"-";"-";"-";"-";"-";"-";"-";"-";"-";"-";"-";"-";"-";"-";"-"
"03 Paź 2024 23:02:08";"Koszty Utrzymania Pozycji";"O2-D4-95EL0T";"-";"-";"Solana (USD)";"-";"-";"-";"-";"-";"-";"-";"-";"-";"-";"-";"-";"4 082,70";"-27,50000%";"-12,07";"0,00";"-";"-";"-";"-";"-";"-";"-";"-";"-";"-";"-";"-";"-";"-";"-";"-";"-";"-"
"03 Paź 2024 23:02:08";"Koszty Utrzymania Pozycji";"O2-D4-96156D";"-";"-";"Solana (USD)";"-";"-";"-";"-";"-";"-";"-";"-";"-";"-";"-";"-";"3 334,20";"-27,50000%";"-9,86";"0,00";"-";"-";"-";"-";"-";"-";"-";"-";"-";"-";"-";"-";"-";"-";"-";"-";"-";"-"
"03 Paź 2024 23:02:08";"Koszty Utrzymania Pozycji";"O2-D5-97FD8D";"-";"-";"Solana (USD)";"-";"-";"-";"-";"-";"-";"-";"-";"-";"-";"-";"-";"6 804,50";"-10,00000%";"7,25";"0,00";"-";"-";"-";"-";"-";"-";"-";"-";"-";"-";"-";"-";"-";"-";"-";"-";"-";"-"
"03 Paź 2024 23:02:08";"Koszty Utrzymania Pozycji";"O2-D4-95K8MW";"-";"-";"Solana (USD)";"-";"-";"-";"-";"-";"-";"-";"-";"-";"-";"-";"-";"6 804,50";"-10,00000%";"7,25";"0,00";"-";"-";"-";"-";"-";"-";"-";"-";"-";"-";"-";"-";"-";"-";"-";"-";"-";"-"
"03 Paź 2024 23:02:08";"Koszty Utrzymania Pozycji";"O2-D5-96WE65";"-";"-";"Solana (USD)";"-";"-";"-";"-";"-";"-";"-";"-";"-";"-";"-";"-";"6 532,32";"-27,50000%";"-19,32";"0,00";"-";"-";"-";"-";"-";"-";"-";"-";"-";"-";"-";"-";"-";"-";"-";"-";"-";"-"
"03 Paź 2024 23:02:08";"Koszty Utrzymania Pozycji";"O2-D3-94JY88";"-";"-";"Solana (USD)";"-";"-";"-";"-";"-";"-";"-";"-";"-";"-";"-";"-";"3 402,25";"-27,50000%";"-10,06";"0,00";"-";"-";"-";"-";"-";"-";"-";"-";"-";"-";"-";"-";"-";"-";"-";"-";"-";"-"
"03 Paź 2024 23:02:08";"Koszty Utrzymania Pozycji";"O2-D6-98C2XK";"-";"-";"Solana (USD)";"-";"-";"-";"-";"-";"-";"-";"-";"-";"-";"-";"-";"4 688,30";"-27,50000%";"-13,87";"0,00";"-";"-";"-";"-";"-";"-";"-";"-";"-";"-";"-";"-";"-";"-";"-";"-";"-";"-"
"03 Paź 2024 23:02:08";"Koszty Utrzymania Pozycji";"O2-D6-97M8KS";"-";"-";"Solana (USD)";"-";"-";"-";"-";"-";"-";"-";"-";"-";"-";"-";"-";"8 165,40";"-27,50000%";"-24,15";"0,00";"-";"-";"-";"-";"-";"-";"-";"-";"-";"-";"-";"-";"-";"-";"-";"-";"-";"-"
"03 Paź 2024 23:02:08";"Koszty Utrzymania Pozycji";"O2-D6-97Z6BV";"-";"-";"Solana (USD)";"-";"-";"-";"-";"-";"-";"-";"-";"-";"-";"-";"-";"4 756,34";"-10,00000%";"5,06";"0,00";"-";"-";"-";"-";"-";"-";"-";"-";"-";"-";"-";"-";"-";"-";"-";"-";"-";"-"
"03 Paź 2024 23:02:08";"Koszty Utrzymania Pozycji";"O2-D6-97W2F5";"-";"-";"Solana (USD)";"-";"-";"-";"-";"-";"-";"-";"-";"-";"-";"-";"-";"3 402,25";"-10,00000%";"3,62";"0,00";"-";"-";"-";"-";"-";"-";"-";"-";"-";"-";"-";"-";"-";"-";"-";"-";"-";"-"
"03 Paź 2024 23:02:08";"Koszty Utrzymania Pozycji";"O2-D6-97PWJQ";"-";"-";"Solana (USD)";"-";"-";"-";"-";"-";"-";"-";"-";"-";"-";"-";"-";"5 375,55";"-10,00000%";"5,72";"0,00";"-";"-";"-";"-";"-";"-";"-";"-";"-";"-";"-";"-";"-";"-";"-";"-";"-";"-"
"03 Paź 2024 23:02:08";"Koszty Utrzymania Pozycji";"O2-D5-977RC9";"-";"-";"Solana (USD)";"-";"-";"-";"-";"-";"-";"-";"-";"-";"-";"-";"-";"8 845,85";"-10,00000%";"9,42";"0,00";"-";"-";"-";"-";"-";"-";"-";"-";"-";"-";"-";"-";"-";"-";"-";"-";"-";"-"
"03 Paź 2024 23:02:08";"Koszty Utrzymania Pozycji";"O2-D6-97M6H8";"-";"-";"Solana (USD)";"-";"-";"-";"-";"-";"-";"-";"-";"-";"-";"-";"-";"11 295,47";"-27,50000%";"-33,41";"0,00";"-";"-";"-";"-";"-";"-";"-";"-";"-";"-";"-";"-";"-";"-";"-";"-";"-";"-"
"02 Paź 2024 23:02:03";"Koszty Utrzymania Pozycji";"1377655566";"-";"-";"Rachunek";"-";"-";"-";"-";"-";"-";"-";"-";"-109,15";"38 438,30";"-";"-";"-";"-";"-";"-109,15";"-";"-";"-";"-";"-";"-";"-";"-";"-";"-";"-";"-";"-";"-";"-";"-";"-";"-"
"02 Paź 2024 23:02:03";"Koszty Utrzymania Pozycji";"O2-D6-97Q7VH";"-";"-";"Solana (USD)";"-";"-";"-";"-";"-";"-";"-";"-";"-";"-";"-";"-";"9 434,20";"-10,00000%";"10,00";"0,00";"-";"-";"-";"-";"-";"-";"-";"-";"-";"-";"-";"-";"-";"-";"-";"-";"-";"-"
"02 Paź 2024 23:02:03";"Koszty Utrzymania Pozycji";"O2-D5-97BZ7D";"-";"-";"Solana (USD)";"-";"-";"-";"-";"-";"-";"-";"-";"-";"-";"-";"-";"4 224,27";"-10,00000%";"4,48";"0,00";"-";"-";"-";"-";"-";"-";"-";"-";"-";"-";"-";"-";"-";"-";"-";"-";"-";"-"
"02 Paź 2024 23:02:03";"Koszty Utrzymania Pozycji";"O2-D4-95TL4Z";"-";"-";"Solana (USD)";"-";"-";"-";"-";"-";"-";"-";"-";"-";"-";"-";"-";"3 168,20";"-27,50000%";"-9,33";"0,00";"-";"-";"-";"-";"-";"-";"-";"-";"-";"-";"-";"-";"-";"-";"-";"-";"-";"-"
"02 Paź 2024 23:02:03";"Koszty Utrzymania Pozycji";"O2-D5-97FGFP";"-";"-";"Solana (USD)";"-";"-";"-";"-";"-";"-";"-";"-";"-";"-";"-";"-";"7 040,45";"-10,00000%";"7,46";"0,00";"-";"-";"-";"-";"-";"-";"-";"-";"-";"-";"-";"-";"-";"-";"-";"-";"-";"-"
"02 Paź 2024 23:02:03";"Koszty Utrzymania Pozycji";"O2-D5-96SWM1";"-";"-";"Solana (USD)";"-";"-";"-";"-";"-";"-";"-";"-";"-";"-";"-";"-";"11 827,95";"-27,50000%";"-34,82";"0,00";"-";"-";"-";"-";"-";"-";"-";"-";"-";"-";"-";"-";"-";"-";"-";"-";"-";"-"
"02 Paź 2024 23:02:03";"Koszty Utrzymania Pozycji";"O2-D4-95EL0T";"-";"-";"Solana (USD)";"-";"-";"-";"-";"-";"-";"-";"-";"-";"-";"-";"-";"4 224,27";"-27,50000%";"-12,43";"0,00";"-";"-";"-";"-";"-";"-";"-";"-";"-";"-";"-";"-";"-";"-";"-";"-";"-";"-"
"02 Paź 2024 23:02:03";"Koszty Utrzymania Pozycji";"O2-D4-96156D";"-";"-";"Solana (USD)";"-";"-";"-";"-";"-";"-";"-";"-";"-";"-";"-";"-";"3 449,82";"-27,50000%";"-10,16";"0,00";"-";"-";"-";"-";"-";"-";"-";"-";"-";"-";"-";"-";"-";"-";"-";"-";"-";"-"
"02 Paź 2024 23:02:03";"Koszty Utrzymania Pozycji";"O2-D5-97FD8D";"-";"-";"Solana (USD)";"-";"-";"-";"-";"-";"-";"-";"-";"-";"-";"-";"-";"7 040,45";"-10,00000%";"7,46";"0,00";"-";"-";"-";"-";"-";"-";"-";"-";"-";"-";"-";"-";"-";"-";"-";"-";"-";"-"
"02 Paź 2024 23:02:03";"Koszty Utrzymania Pozycji";"O2-D4-95K8MW";"-";"-";"Solana (USD)";"-";"-";"-";"-";"-";"-";"-";"-";"-";"-";"-";"-";"7 040,45";"-10,00000%";"7,46";"0,00";"-";"-";"-";"-";"-";"-";"-";"-";"-";"-";"-";"-";"-";"-";"-";"-";"-";"-"
"02 Paź 2024 23:02:03";"Koszty Utrzymania Pozycji";"O2-D5-96WE65";"-";"-";"Solana (USD)";"-";"-";"-";"-";"-";"-";"-";"-";"-";"-";"-";"-";"6 758,83";"-27,50000%";"-19,90";"0,00";"-";"-";"-";"-";"-";"-";"-";"-";"-";"-";"-";"-";"-";"-";"-";"-";"-";"-"
"02 Paź 2024 23:02:03";"Koszty Utrzymania Pozycji";"O2-D3-94JY88";"-";"-";"Solana (USD)";"-";"-";"-";"-";"-";"-";"-";"-";"-";"-";"-";"-";"3 520,22";"-27,50000%";"-10,36";"0,00";"-";"-";"-";"-";"-";"-";"-";"-";"-";"-";"-";"-";"-";"-";"-";"-";"-";"-"
"02 Paź 2024 23:02:03";"Koszty Utrzymania Pozycji";"O2-D6-98C2XK";"-";"-";"Solana (USD)";"-";"-";"-";"-";"-";"-";"-";"-";"-";"-";"-";"-";"4 850,87";"-27,50000%";"-14,28";"0,00";"-";"-";"-";"-";"-";"-";"-";"-";"-";"-";"-";"-";"-";"-";"-";"-";"-";"-"
"02 Paź 2024 23:02:03";"Koszty Utrzymania Pozycji";"O2-D6-97M8KS";"-";"-";"Solana (USD)";"-";"-";"-";"-";"-";"-";"-";"-";"-";"-";"-";"-";"8 448,54";"-27,50000%";"-24,87";"0,00";"-";"-";"-";"-";"-";"-";"-";"-";"-";"-";"-";"-";"-";"-";"-";"-";"-";"-"
"02 Paź 2024 23:02:03";"Koszty Utrzymania Pozycji";"O2-D6-97Z6BV";"-";"-";"Solana (USD)";"-";"-";"-";"-";"-";"-";"-";"-";"-";"-";"-";"-";"4 921,27";"-10,00000%";"5,22";"0,00";"-";"-";"-";"-";"-";"-";"-";"-";"-";"-";"-";"-";"-";"-";"-";"-";"-";"-"
"02 Paź 2024 23:02:03";"Koszty Utrzymania Pozycji";"O2-D6-97W2F5";"-";"-";"Solana (USD)";"-";"-";"-";"-";"-";"-";"-";"-";"-";"-";"-";"-";"3 520,22";"-10,00000%";"3,73";"0,00";"-";"-";"-";"-";"-";"-";"-";"-";"-";"-";"-";"-";"-";"-";"-";"-";"-";"-"
"02 Paź 2024 23:02:03";"Koszty Utrzymania Pozycji";"O2-D6-97PWJQ";"-";"-";"Solana (USD)";"-";"-";"-";"-";"-";"-";"-";"-";"-";"-";"-";"-";"5 561,95";"-10,00000%";"5,89";"0,00";"-";"-";"-";"-";"-";"-";"-";"-";"-";"-";"-";"-";"-";"-";"-";"-";"-";"-"
"02 Paź 2024 23:02:03";"Koszty Utrzymania Pozycji";"O2-D5-977RC9";"-";"-";"Solana (USD)";"-";"-";"-";"-";"-";"-";"-";"-";"-";"-";"-";"-";"9 152,58";"-10,00000%";"9,70";"0,00";"-";"-";"-";"-";"-";"-";"-";"-";"-";"-";"-";"-";"-";"-";"-";"-";"-";"-"
"02 Paź 2024 23:02:03";"Koszty Utrzymania Pozycji";"O2-D6-97M6H8";"-";"-";"Solana (USD)";"-";"-";"-";"-";"-";"-";"-";"-";"-";"-";"-";"-";"11 687,14";"-27,50000%";"-34,40";"0,00";"-";"-";"-";"-";"-";"-";"-";"-";"-";"-";"-";"-";"-";"-";"-";"-";"-";"-"
"01 Paź 2024 23:02:04";"Koszty Utrzymania Pozycji";"1377291419";"-";"-";"Rachunek";"-";"-";"-";"-";"-";"-";"-";"-";"-112,07";"38 547,45";"-";"-";"-";"-";"-";"-112,07";"-";"-";"-";"-";"-";"-";"-";"-";"-";"-";"-";"-";"-";"-";"-";"-";"-";"-"
"01 Paź 2024 23:02:04";"Koszty Utrzymania Pozycji";"O2-D6-97Q7VH";"-";"-";"Solana (USD)";"-";"-";"-";"-";"-";"-";"-";"-";"-";"-";"-";"-";"9 720,02";"-10,00000%";"10,27";"0,00";"-";"-";"-";"-";"-";"-";"-";"-";"-";"-";"-";"-";"-";"-";"-";"-";"-";"-"
"01 Paź 2024 23:02:04";"Koszty Utrzymania Pozycji";"O2-D5-97BZ7D";"-";"-";"Solana (USD)";"-";"-";"-";"-";"-";"-";"-";"-";"-";"-";"-";"-";"4 352,25";"-10,00000%";"4,60";"0,00";"-";"-";"-";"-";"-";"-";"-";"-";"-";"-";"-";"-";"-";"-";"-";"-";"-";"-"
"01 Paź 2024 23:02:04";"Koszty Utrzymania Pozycji";"O2-D4-95TL4Z";"-";"-";"Solana (USD)";"-";"-";"-";"-";"-";"-";"-";"-";"-";"-";"-";"-";"3 264,18";"-27,50000%";"-9,58";"0,00";"-";"-";"-";"-";"-";"-";"-";"-";"-";"-";"-";"-";"-";"-";"-";"-";"-";"-"
"01 Paź 2024 23:02:04";"Koszty Utrzymania Pozycji";"O2-D5-97FGFP";"-";"-";"Solana (USD)";"-";"-";"-";"-";"-";"-";"-";"-";"-";"-";"-";"-";"7 253,75";"-10,00000%";"7,66";"0,00";"-";"-";"-";"-";"-";"-";"-";"-";"-";"-";"-";"-";"-";"-";"-";"-";"-";"-"
"01 Paź 2024 23:02:04";"Koszty Utrzymania Pozycji";"O2-D5-96SWM1";"-";"-";"Solana (USD)";"-";"-";"-";"-";"-";"-";"-";"-";"-";"-";"-";"-";"12 186,30";"-27,50000%";"-35,75";"0,00";"-";"-";"-";"-";"-";"-";"-";"-";"-";"-";"-";"-";"-";"-";"-";"-";"-";"-"
"01 Paź 2024 23:02:04";"Koszty Utrzymania Pozycji";"O2-D4-95EL0T";"-";"-";"Solana (USD)";"-";"-";"-";"-";"-";"-";"-";"-";"-";"-";"-";"-";"4 352,25";"-27,50000%";"-12,77";"0,00";"-";"-";"-";"-";"-";"-";"-";"-";"-";"-";"-";"-";"-";"-";"-";"-";"-";"-"
"01 Paź 2024 23:02:04";"Koszty Utrzymania Pozycji";"O2-D4-96156D";"-";"-";"Solana (USD)";"-";"-";"-";"-";"-";"-";"-";"-";"-";"-";"-";"-";"3 554,33";"-27,50000%";"-10,43";"0,00";"-";"-";"-";"-";"-";"-";"-";"-";"-";"-";"-";"-";"-";"-";"-";"-";"-";"-"
"01 Paź 2024 23:02:04";"Koszty Utrzymania Pozycji";"O2-D5-97FD8D";"-";"-";"Solana (USD)";"-";"-";"-";"-";"-";"-";"-";"-";"-";"-";"-";"-";"7 253,75";"-10,00000%";"7,66";"0,00";"-";"-";"-";"-";"-";"-";"-";"-";"-";"-";"-";"-";"-";"-";"-";"-";"-";"-"
"01 Paź 2024 23:02:04";"Koszty Utrzymania Pozycji";"O2-D4-95K8MW";"-";"-";"Solana (USD)";"-";"-";"-";"-";"-";"-";"-";"-";"-";"-";"-";"-";"7 253,75";"-10,00000%";"7,66";"0,00";"-";"-";"-";"-";"-";"-";"-";"-";"-";"-";"-";"-";"-";"-";"-";"-";"-";"-"
"01 Paź 2024 23:02:04";"Koszty Utrzymania Pozycji";"O2-D5-96WE65";"-";"-";"Solana (USD)";"-";"-";"-";"-";"-";"-";"-";"-";"-";"-";"-";"-";"6 963,60";"-27,50000%";"-20,43";"0,00";"-";"-";"-";"-";"-";"-";"-";"-";"-";"-";"-";"-";"-";"-";"-";"-";"-";"-"
"01 Paź 2024 23:02:04";"Koszty Utrzymania Pozycji";"O2-D3-94JY88";"-";"-";"Solana (USD)";"-";"-";"-";"-";"-";"-";"-";"-";"-";"-";"-";"-";"3 626,87";"-27,50000%";"-10,64";"0,00";"-";"-";"-";"-";"-";"-";"-";"-";"-";"-";"-";"-";"-";"-";"-";"-";"-";"-"
"01 Paź 2024 23:02:04";"Koszty Utrzymania Pozycji";"O2-D6-98C2XK";"-";"-";"Solana (USD)";"-";"-";"-";"-";"-";"-";"-";"-";"-";"-";"-";"-";"4 997,83";"-27,50000%";"-14,66";"0,00";"-";"-";"-";"-";"-";"-";"-";"-";"-";"-";"-";"-";"-";"-";"-";"-";"-";"-"
"01 Paź 2024 23:02:04";"Koszty Utrzymania Pozycji";"O2-D6-97M8KS";"-";"-";"Solana (USD)";"-";"-";"-";"-";"-";"-";"-";"-";"-";"-";"-";"-";"8 704,50";"-27,50000%";"-25,54";"0,00";"-";"-";"-";"-";"-";"-";"-";"-";"-";"-";"-";"-";"-";"-";"-";"-";"-";"-"
"01 Paź 2024 23:02:04";"Koszty Utrzymania Pozycji";"O2-D6-97Z6BV";"-";"-";"Solana (USD)";"-";"-";"-";"-";"-";"-";"-";"-";"-";"-";"-";"-";"5 070,37";"-10,00000%";"5,36";"0,00";"-";"-";"-";"-";"-";"-";"-";"-";"-";"-";"-";"-";"-";"-";"-";"-";"-";"-"
"01 Paź 2024 23:02:04";"Koszty Utrzymania Pozycji";"O2-D6-97W2F5";"-";"-";"Solana (USD)";"-";"-";"-";"-";"-";"-";"-";"-";"-";"-";"-";"-";"3 626,87";"-10,00000%";"3,83";"0,00";"-";"-";"-";"-";"-";"-";"-";"-";"-";"-";"-";"-";"-";"-";"-";"-";"-";"-"
"01 Paź 2024 23:02:04";"Koszty Utrzymania Pozycji";"O2-D6-97PWJQ";"-";"-";"Solana (USD)";"-";"-";"-";"-";"-";"-";"-";"-";"-";"-";"-";"-";"5 730,46";"-10,00000%";"6,05";"0,00";"-";"-";"-";"-";"-";"-";"-";"-";"-";"-";"-";"-";"-";"-";"-";"-";"-";"-"
"01 Paź 2024 23:02:04";"Koszty Utrzymania Pozycji";"O2-D5-977RC9";"-";"-";"Solana (USD)";"-";"-";"-";"-";"-";"-";"-";"-";"-";"-";"-";"-";"9 429,87";"-10,00000%";"9,96";"0,00";"-";"-";"-";"-";"-";"-";"-";"-";"-";"-";"-";"-";"-";"-";"-";"-";"-";"-"
"01 Paź 2024 23:02:04";"Koszty Utrzymania Pozycji";"O2-D6-97M6H8";"-";"-";"Solana (USD)";"-";"-";"-";"-";"-";"-";"-";"-";"-";"-";"-";"-";"12 041,22";"-27,50000%";"-35,32";"0,00";"-";"-";"-";"-";"-";"-";"-";"-";"-";"-";"-";"-";"-";"-";"-";"-";"-";"-"
"30 Wrz 2024 23:02:10";"Koszty Utrzymania Pozycji";"1376915986";"-";"-";"Rachunek";"-";"-";"-";"-";"-";"-";"-";"-";"-120,16";"38 659,52";"-";"-";"-";"-";"-";"-120,16";"-";"-";"-";"-";"-";"-";"-";"-";"-";"-";"-";"-";"-";"-";"-";"-";"-";"-"
"30 Wrz 2024 23:02:10";"Koszty Utrzymania Pozycji";"O2-D6-97Q7VH";"-";"-";"Solana (USD)";"-";"-";"-";"-";"-";"-";"-";"-";"-";"-";"-";"-";"10 494,67";"-10,00000%";"11,01";"0,00";"-";"-";"-";"-";"-";"-";"-";"-";"-";"-";"-";"-";"-";"-";"-";"-";"-";"-"
"30 Wrz 2024 23:02:10";"Koszty Utrzymania Pozycji";"O2-D5-97BZ7D";"-";"-";"Solana (USD)";"-";"-";"-";"-";"-";"-";"-";"-";"-";"-";"-";"-";"4 699,11";"-10,00000%";"4,93";"0,00";"-";"-";"-";"-";"-";"-";"-";"-";"-";"-";"-";"-";"-";"-";"-";"-";"-";"-"
"30 Wrz 2024 23:02:10";"Koszty Utrzymania Pozycji";"O2-D4-95TL4Z";"-";"-";"Solana (USD)";"-";"-";"-";"-";"-";"-";"-";"-";"-";"-";"-";"-";"3 524,33";"-27,50000%";"-10,27";"0,00";"-";"-";"-";"-";"-";"-";"-";"-";"-";"-";"-";"-";"-";"-";"-";"-";"-";"-"
"30 Wrz 2024 23:02:10";"Koszty Utrzymania Pozycji";"O2-D5-97FGFP";"-";"-";"Solana (USD)";"-";"-";"-";"-";"-";"-";"-";"-";"-";"-";"-";"-";"7 831,85";"-10,00000%";"8,22";"0,00";"-";"-";"-";"-";"-";"-";"-";"-";"-";"-";"-";"-";"-";"-";"-";"-";"-";"-"
"30 Wrz 2024 23:02:10";"Koszty Utrzymania Pozycji";"O2-D5-96SWM1";"-";"-";"Solana (USD)";"-";"-";"-";"-";"-";"-";"-";"-";"-";"-";"-";"-";"13 157,50";"-27,50000%";"-38,34";"0,00";"-";"-";"-";"-";"-";"-";"-";"-";"-";"-";"-";"-";"-";"-";"-";"-";"-";"-"
"30 Wrz 2024 23:02:10";"Koszty Utrzymania Pozycji";"O2-D4-95EL0T";"-";"-";"Solana (USD)";"-";"-";"-";"-";"-";"-";"-";"-";"-";"-";"-";"-";"4 699,11";"-27,50000%";"-13,69";"0,00";"-";"-";"-";"-";"-";"-";"-";"-";"-";"-";"-";"-";"-";"-";"-";"-";"-";"-"
"30 Wrz 2024 23:02:10";"Koszty Utrzymania Pozycji";"O2-D4-96156D";"-";"-";"Solana (USD)";"-";"-";"-";"-";"-";"-";"-";"-";"-";"-";"-";"-";"3 837,60";"-27,50000%";"-11,18";"0,00";"-";"-";"-";"-";"-";"-";"-";"-";"-";"-";"-";"-";"-";"-";"-";"-";"-";"-"
"30 Wrz 2024 23:02:10";"Koszty Utrzymania Pozycji";"O2-D5-97FD8D";"-";"-";"Solana (USD)";"-";"-";"-";"-";"-";"-";"-";"-";"-";"-";"-";"-";"7 831,85";"-10,00000%";"8,22";"0,00";"-";"-";"-";"-";"-";"-";"-";"-";"-";"-";"-";"-";"-";"-";"-";"-";"-";"-"
"30 Wrz 2024 23:02:10";"Koszty Utrzymania Pozycji";"O2-D4-95K8MW";"-";"-";"Solana (USD)";"-";"-";"-";"-";"-";"-";"-";"-";"-";"-";"-";"-";"7 831,85";"-10,00000%";"8,22";"0,00";"-";"-";"-";"-";"-";"-";"-";"-";"-";"-";"-";"-";"-";"-";"-";"-";"-";"-"
"30 Wrz 2024 23:02:10";"Koszty Utrzymania Pozycji";"O2-D5-96WE65";"-";"-";"Solana (USD)";"-";"-";"-";"-";"-";"-";"-";"-";"-";"-";"-";"-";"7 518,57";"-27,50000%";"-21,91";"0,00";"-";"-";"-";"-";"-";"-";"-";"-";"-";"-";"-";"-";"-";"-";"-";"-";"-";"-"
"30 Wrz 2024 23:02:10";"Koszty Utrzymania Pozycji";"O2-D3-94JY88";"-";"-";"Solana (USD)";"-";"-";"-";"-";"-";"-";"-";"-";"-";"-";"-";"-";"3 915,92";"-27,50000%";"-11,41";"0,00";"-";"-";"-";"-";"-";"-";"-";"-";"-";"-";"-";"-";"-";"-";"-";"-";"-";"-"
"30 Wrz 2024 23:02:10";"Koszty Utrzymania Pozycji";"O2-D6-98C2XK";"-";"-";"Solana (USD)";"-";"-";"-";"-";"-";"-";"-";"-";"-";"-";"-";"-";"5 396,14";"-27,50000%";"-15,72";"0,00";"-";"-";"-";"-";"-";"-";"-";"-";"-";"-";"-";"-";"-";"-";"-";"-";"-";"-"
"30 Wrz 2024 23:02:10";"Koszty Utrzymania Pozycji";"O2-D6-97M8KS";"-";"-";"Solana (USD)";"-";"-";"-";"-";"-";"-";"-";"-";"-";"-";"-";"-";"9 398,22";"-27,50000%";"-27,38";"0,00";"-";"-";"-";"-";"-";"-";"-";"-";"-";"-";"-";"-";"-";"-";"-";"-";"-";"-"
"30 Wrz 2024 23:02:10";"Koszty Utrzymania Pozycji";"O2-D6-97Z6BV";"-";"-";"Solana (USD)";"-";"-";"-";"-";"-";"-";"-";"-";"-";"-";"-";"-";"5 474,46";"-10,00000%";"5,74";"0,00";"-";"-";"-";"-";"-";"-";"-";"-";"-";"-";"-";"-";"-";"-";"-";"-";"-";"-"
"30 Wrz 2024 23:02:10";"Koszty Utrzymania Pozycji";"O2-D6-97W2F5";"-";"-";"Solana (USD)";"-";"-";"-";"-";"-";"-";"-";"-";"-";"-";"-";"-";"3 915,92";"-10,00000%";"4,11";"0,00";"-";"-";"-";"-";"-";"-";"-";"-";"-";"-";"-";"-";"-";"-";"-";"-";"-";"-"
"30 Wrz 2024 23:02:10";"Koszty Utrzymania Pozycji";"O2-D6-97PWJQ";"-";"-";"Solana (USD)";"-";"-";"-";"-";"-";"-";"-";"-";"-";"-";"-";"-";"6 187,16";"-10,00000%";"6,49";"0,00";"-";"-";"-";"-";"-";"-";"-";"-";"-";"-";"-";"-";"-";"-";"-";"-";"-";"-"
"30 Wrz 2024 23:02:10";"Koszty Utrzymania Pozycji";"O2-D5-977RC9";"-";"-";"Solana (USD)";"-";"-";"-";"-";"-";"-";"-";"-";"-";"-";"-";"-";"10 181,40";"-10,00000%";"10,68";"0,00";"-";"-";"-";"-";"-";"-";"-";"-";"-";"-";"-";"-";"-";"-";"-";"-";"-";"-"
"30 Wrz 2024 23:02:10";"Koszty Utrzymania Pozycji";"O2-D6-97M6H8";"-";"-";"Solana (USD)";"-";"-";"-";"-";"-";"-";"-";"-";"-";"-";"-";"-";"13 000,87";"-27,50000%";"-37,88";"0,00";"-";"-";"-";"-";"-";"-";"-";"-";"-";"-";"-";"-";"-";"-";"-";"-";"-";"-"
"27 Wrz 2024 23:01:58";"Koszty Utrzymania Pozycji";"1376563801";"-";"-";"Rachunek";"-";"-";"-";"-";"-";"-";"-";"-";"-361,18";"38 779,68";"-";"-";"-";"-";"-";"-361,18";"-";"-";"-";"-";"-";"-";"-";"-";"-";"-";"-";"-";"-";"-";"-";"-";"-";"-"
"27 Wrz 2024 23:01:58";"Koszty Utrzymania Pozycji";"O2-D6-97Q7VH";"-";"-";"Solana (USD)";"-";"-";"-";"-";"-";"-";"-";"-";"-";"-";"-";"-";"10 561,94";"-10,00000%";"33,09";"0,00";"-";"-";"-";"-";"-";"-";"-";"-";"-";"-";"-";"-";"-";"-";"-";"-";"-";"-"
"27 Wrz 2024 23:01:58";"Koszty Utrzymania Pozycji";"O2-D5-97BZ7D";"-";"-";"Solana (USD)";"-";"-";"-";"-";"-";"-";"-";"-";"-";"-";"-";"-";"4 729,23";"-10,00000%";"14,81";"0,00";"-";"-";"-";"-";"-";"-";"-";"-";"-";"-";"-";"-";"-";"-";"-";"-";"-";"-"
"27 Wrz 2024 23:01:58";"Koszty Utrzymania Pozycji";"O2-D4-95TL4Z";"-";"-";"Solana (USD)";"-";"-";"-";"-";"-";"-";"-";"-";"-";"-";"-";"-";"3 546,92";"-27,50000%";"-30,86";"0,00";"-";"-";"-";"-";"-";"-";"-";"-";"-";"-";"-";"-";"-";"-";"-";"-";"-";"-"
"27 Wrz 2024 23:01:58";"Koszty Utrzymania Pozycji";"O2-D5-97FGFP";"-";"-";"Solana (USD)";"-";"-";"-";"-";"-";"-";"-";"-";"-";"-";"-";"-";"7 882,05";"-10,00000%";"24,69";"0,00";"-";"-";"-";"-";"-";"-";"-";"-";"-";"-";"-";"-";"-";"-";"-";"-";"-";"-"
"27 Wrz 2024 23:01:58";"Koszty Utrzymania Pozycji";"O2-D5-96SWM1";"-";"-";"Solana (USD)";"-";"-";"-";"-";"-";"-";"-";"-";"-";"-";"-";"-";"13 241,84";"-27,50000%";"-115,22";"0,00";"-";"-";"-";"-";"-";"-";"-";"-";"-";"-";"-";"-";"-";"-";"-";"-";"-";"-"
"27 Wrz 2024 23:01:58";"Koszty Utrzymania Pozycji";"O2-D4-95EL0T";"-";"-";"Solana (USD)";"-";"-";"-";"-";"-";"-";"-";"-";"-";"-";"-";"-";"4 729,23";"-27,50000%";"-41,15";"0,00";"-";"-";"-";"-";"-";"-";"-";"-";"-";"-";"-";"-";"-";"-";"-";"-";"-";"-"
"27 Wrz 2024 23:01:58";"Koszty Utrzymania Pozycji";"O2-D4-96156D";"-";"-";"Solana (USD)";"-";"-";"-";"-";"-";"-";"-";"-";"-";"-";"-";"-";"3 862,20";"-27,50000%";"-33,61";"0,00";"-";"-";"-";"-";"-";"-";"-";"-";"-";"-";"-";"-";"-";"-";"-";"-";"-";"-"
"27 Wrz 2024 23:01:58";"Koszty Utrzymania Pozycji";"O2-D5-97FD8D";"-";"-";"Solana (USD)";"-";"-";"-";"-";"-";"-";"-";"-";"-";"-";"-";"-";"7 882,05";"-10,00000%";"24,69";"0,00";"-";"-";"-";"-";"-";"-";"-";"-";"-";"-";"-";"-";"-";"-";"-";"-";"-";"-"
"27 Wrz 2024 23:01:58";"Koszty Utrzymania Pozycji";"O2-D4-95K8MW";"-";"-";"Solana (USD)";"-";"-";"-";"-";"-";"-";"-";"-";"-";"-";"-";"-";"7 882,05";"-10,00000%";"24,69";"0,00";"-";"-";"-";"-";"-";"-";"-";"-";"-";"-";"-";"-";"-";"-";"-";"-";"-";"-"
"27 Wrz 2024 23:01:58";"Koszty Utrzymania Pozycji";"O2-D5-96WE65";"-";"-";"Solana (USD)";"-";"-";"-";"-";"-";"-";"-";"-";"-";"-";"-";"-";"7 566,76";"-27,50000%";"-65,84";"0,00";"-";"-";"-";"-";"-";"-";"-";"-";"-";"-";"-";"-";"-";"-";"-";"-";"-";"-"
"27 Wrz 2024 23:01:58";"Koszty Utrzymania Pozycji";"O2-D3-94JY88";"-";"-";"Solana (USD)";"-";"-";"-";"-";"-";"-";"-";"-";"-";"-";"-";"-";"3 941,02";"-27,50000%";"-34,29";"0,00";"-";"-";"-";"-";"-";"-";"-";"-";"-";"-";"-";"-";"-";"-";"-";"-";"-";"-"
"27 Wrz 2024 23:01:58";"Koszty Utrzymania Pozycji";"O2-D6-98C2XK";"-";"-";"Solana (USD)";"-";"-";"-";"-";"-";"-";"-";"-";"-";"-";"-";"-";"5 430,73";"-27,50000%";"-47,25";"0,00";"-";"-";"-";"-";"-";"-";"-";"-";"-";"-";"-";"-";"-";"-";"-";"-";"-";"-"
"27 Wrz 2024 23:01:58";"Koszty Utrzymania Pozycji";"O2-D6-97M8KS";"-";"-";"Solana (USD)";"-";"-";"-";"-";"-";"-";"-";"-";"-";"-";"-";"-";"9 458,46";"-27,50000%";"-82,30";"0,00";"-";"-";"-";"-";"-";"-";"-";"-";"-";"-";"-";"-";"-";"-";"-";"-";"-";"-"
"27 Wrz 2024 23:01:58";"Koszty Utrzymania Pozycji";"O2-D6-97Z6BV";"-";"-";"Solana (USD)";"-";"-";"-";"-";"-";"-";"-";"-";"-";"-";"-";"-";"5 509,55";"-10,00000%";"17,26";"0,00";"-";"-";"-";"-";"-";"-";"-";"-";"-";"-";"-";"-";"-";"-";"-";"-";"-";"-"
"27 Wrz 2024 23:01:58";"Koszty Utrzymania Pozycji";"O2-D6-97W2F5";"-";"-";"Solana (USD)";"-";"-";"-";"-";"-";"-";"-";"-";"-";"-";"-";"-";"3 941,02";"-10,00000%";"12,35";"0,00";"-";"-";"-";"-";"-";"-";"-";"-";"-";"-";"-";"-";"-";"-";"-";"-";"-";"-"
"27 Wrz 2024 23:01:58";"Koszty Utrzymania Pozycji";"O2-D6-97PWJQ";"-";"-";"Solana (USD)";"-";"-";"-";"-";"-";"-";"-";"-";"-";"-";"-";"-";"6 226,81";"-10,00000%";"19,51";"0,00";"-";"-";"-";"-";"-";"-";"-";"-";"-";"-";"-";"-";"-";"-";"-";"-";"-";"-"
"27 Wrz 2024 23:01:58";"Koszty Utrzymania Pozycji";"O2-D5-977RC9";"-";"-";"Solana (USD)";"-";"-";"-";"-";"-";"-";"-";"-";"-";"-";"-";"-";"10 246,66";"-10,00000%";"32,10";"0,00";"-";"-";"-";"-";"-";"-";"-";"-";"-";"-";"-";"-";"-";"-";"-";"-";"-";"-"
"27 Wrz 2024 23:01:58";"Koszty Utrzymania Pozycji";"O2-D6-97M6H8";"-";"-";"Solana (USD)";"-";"-";"-";"-";"-";"-";"-";"-";"-";"-";"-";"-";"13 084,20";"-27,50000%";"-113,85";"0,00";"-";"-";"-";"-";"-";"-";"-";"-";"-";"-";"-";"-";"-";"-";"-";"-";"-";"-"
"26 Wrz 2024 23:02:09";"Koszty Utrzymania Pozycji";"1376221112";"-";"-";"Rachunek";"-";"-";"-";"-";"-";"-";"-";"-";"-117,89";"39 140,86";"-";"-";"-";"-";"-";"-117,89";"-";"-";"-";"-";"-";"-";"-";"-";"-";"-";"-";"-";"-";"-";"-";"-";"-";"-"
"26 Wrz 2024 23:02:09";"Koszty Utrzymania Pozycji";"O2-D6-97Q7VH";"-";"-";"Solana (USD)";"-";"-";"-";"-";"-";"-";"-";"-";"-";"-";"-";"-";"10 358,53";"-10,00000%";"10,80";"0,00";"-";"-";"-";"-";"-";"-";"-";"-";"-";"-";"-";"-";"-";"-";"-";"-";"-";"-"
"26 Wrz 2024 23:02:09";"Koszty Utrzymania Pozycji";"O2-D5-97BZ7D";"-";"-";"Solana (USD)";"-";"-";"-";"-";"-";"-";"-";"-";"-";"-";"-";"-";"4 638,15";"-10,00000%";"4,84";"0,00";"-";"-";"-";"-";"-";"-";"-";"-";"-";"-";"-";"-";"-";"-";"-";"-";"-";"-"
"26 Wrz 2024 23:02:09";"Koszty Utrzymania Pozycji";"O2-D4-95TL4Z";"-";"-";"Solana (USD)";"-";"-";"-";"-";"-";"-";"-";"-";"-";"-";"-";"-";"3 478,61";"-27,50000%";"-10,07";"0,00";"-";"-";"-";"-";"-";"-";"-";"-";"-";"-";"-";"-";"-";"-";"-";"-";"-";"-"
"26 Wrz 2024 23:02:09";"Koszty Utrzymania Pozycji";"O2-D5-97FGFP";"-";"-";"Solana (USD)";"-";"-";"-";"-";"-";"-";"-";"-";"-";"-";"-";"-";"7 730,25";"-10,00000%";"8,06";"0,00";"-";"-";"-";"-";"-";"-";"-";"-";"-";"-";"-";"-";"-";"-";"-";"-";"-";"-"
"26 Wrz 2024 23:02:09";"Koszty Utrzymania Pozycji";"O2-D5-96SWM1";"-";"-";"Solana (USD)";"-";"-";"-";"-";"-";"-";"-";"-";"-";"-";"-";"-";"12 986,82";"-27,50000%";"-37,61";"0,00";"-";"-";"-";"-";"-";"-";"-";"-";"-";"-";"-";"-";"-";"-";"-";"-";"-";"-"
"26 Wrz 2024 23:02:09";"Koszty Utrzymania Pozycji";"O2-D4-95EL0T";"-";"-";"Solana (USD)";"-";"-";"-";"-";"-";"-";"-";"-";"-";"-";"-";"-";"4 638,15";"-27,50000%";"-13,43";"0,00";"-";"-";"-";"-";"-";"-";"-";"-";"-";"-";"-";"-";"-";"-";"-";"-";"-";"-"
"26 Wrz 2024 23:02:09";"Koszty Utrzymania Pozycji";"O2-D4-96156D";"-";"-";"Solana (USD)";"-";"-";"-";"-";"-";"-";"-";"-";"-";"-";"-";"-";"3 787,82";"-27,50000%";"-10,97";"0,00";"-";"-";"-";"-";"-";"-";"-";"-";"-";"-";"-";"-";"-";"-";"-";"-";"-";"-"
"26 Wrz 2024 23:02:09";"Koszty Utrzymania Pozycji";"O2-D5-97FD8D";"-";"-";"Solana (USD)";"-";"-";"-";"-";"-";"-";"-";"-";"-";"-";"-";"-";"7 730,25";"-10,00000%";"8,06";"0,00";"-";"-";"-";"-";"-";"-";"-";"-";"-";"-";"-";"-";"-";"-";"-";"-";"-";"-"
"26 Wrz 2024 23:02:09";"Koszty Utrzymania Pozycji";"O2-D4-95K8MW";"-";"-";"Solana (USD)";"-";"-";"-";"-";"-";"-";"-";"-";"-";"-";"-";"-";"7 730,25";"-10,00000%";"8,06";"0,00";"-";"-";"-";"-";"-";"-";"-";"-";"-";"-";"-";"-";"-";"-";"-";"-";"-";"-"
"26 Wrz 2024 23:02:09";"Koszty Utrzymania Pozycji";"O2-D5-96WE65";"-";"-";"Solana (USD)";"-";"-";"-";"-";"-";"-";"-";"-";"-";"-";"-";"-";"7 421,04";"-27,50000%";"-21,49";"0,00";"-";"-";"-";"-";"-";"-";"-";"-";"-";"-";"-";"-";"-";"-";"-";"-";"-";"-"
"26 Wrz 2024 23:02:09";"Koszty Utrzymania Pozycji";"O2-D3-94JY88";"-";"-";"Solana (USD)";"-";"-";"-";"-";"-";"-";"-";"-";"-";"-";"-";"-";"3 865,12";"-27,50000%";"-11,19";"0,00";"-";"-";"-";"-";"-";"-";"-";"-";"-";"-";"-";"-";"-";"-";"-";"-";"-";"-"
"26 Wrz 2024 23:02:09";"Koszty Utrzymania Pozycji";"O2-D6-98C2XK";"-";"-";"Solana (USD)";"-";"-";"-";"-";"-";"-";"-";"-";"-";"-";"-";"-";"5 326,14";"-27,50000%";"-15,43";"0,00";"-";"-";"-";"-";"-";"-";"-";"-";"-";"-";"-";"-";"-";"-";"-";"-";"-";"-"
"26 Wrz 2024 23:02:09";"Koszty Utrzymania Pozycji";"O2-D6-97M8KS";"-";"-";"Solana (USD)";"-";"-";"-";"-";"-";"-";"-";"-";"-";"-";"-";"-";"9 276,30";"-27,50000%";"-26,87";"0,00";"-";"-";"-";"-";"-";"-";"-";"-";"-";"-";"-";"-";"-";"-";"-";"-";"-";"-"
"26 Wrz 2024 23:02:09";"Koszty Utrzymania Pozycji";"O2-D6-97Z6BV";"-";"-";"Solana (USD)";"-";"-";"-";"-";"-";"-";"-";"-";"-";"-";"-";"-";"5 403,44";"-10,00000%";"5,63";"0,00";"-";"-";"-";"-";"-";"-";"-";"-";"-";"-";"-";"-";"-";"-";"-";"-";"-";"-"
"26 Wrz 2024 23:02:09";"Koszty Utrzymania Pozycji";"O2-D6-97W2F5";"-";"-";"Solana (USD)";"-";"-";"-";"-";"-";"-";"-";"-";"-";"-";"-";"-";"3 865,12";"-10,00000%";"4,03";"0,00";"-";"-";"-";"-";"-";"-";"-";"-";"-";"-";"-";"-";"-";"-";"-";"-";"-";"-"
"26 Wrz 2024 23:02:09";"Koszty Utrzymania Pozycji";"O2-D6-97PWJQ";"-";"-";"Solana (USD)";"-";"-";"-";"-";"-";"-";"-";"-";"-";"-";"-";"-";"6 106,89";"-10,00000%";"6,37";"0,00";"-";"-";"-";"-";"-";"-";"-";"-";"-";"-";"-";"-";"-";"-";"-";"-";"-";"-"
"26 Wrz 2024 23:02:09";"Koszty Utrzymania Pozycji";"O2-D5-977RC9";"-";"-";"Solana (USD)";"-";"-";"-";"-";"-";"-";"-";"-";"-";"-";"-";"-";"10 049,32";"-10,00000%";"10,48";"0,00";"-";"-";"-";"-";"-";"-";"-";"-";"-";"-";"-";"-";"-";"-";"-";"-";"-";"-"
"26 Wrz 2024 23:02:09";"Koszty Utrzymania Pozycji";"O2-D6-97M6H8";"-";"-";"Solana (USD)";"-";"-";"-";"-";"-";"-";"-";"-";"-";"-";"-";"-";"12 832,21";"-27,50000%";"-37,16";"0,00";"-";"-";"-";"-";"-";"-";"-";"-";"-";"-";"-";"-";"-";"-";"-";"-";"-";"-"
"25 Wrz 2024 23:02:07";"Koszty Utrzymania Pozycji";"1375853757";"-";"-";"Rachunek";"-";"-";"-";"-";"-";"-";"-";"-";"-114,89";"39 258,75";"-";"-";"-";"-";"-";"-114,89";"-";"-";"-";"-";"-";"-";"-";"-";"-";"-";"-";"-";"-";"-";"-";"-";"-";"-"
"25 Wrz 2024 23:02:07";"Koszty Utrzymania Pozycji";"O2-D6-97Q7VH";"-";"-";"Solana (USD)";"-";"-";"-";"-";"-";"-";"-";"-";"-";"-";"-";"-";"10 071,03";"-10,00000%";"10,53";"0,00";"-";"-";"-";"-";"-";"-";"-";"-";"-";"-";"-";"-";"-";"-";"-";"-";"-";"-"
"25 Wrz 2024 23:02:07";"Koszty Utrzymania Pozycji";"O2-D5-97BZ7D";"-";"-";"Solana (USD)";"-";"-";"-";"-";"-";"-";"-";"-";"-";"-";"-";"-";"4 509,42";"-10,00000%";"4,71";"0,00";"-";"-";"-";"-";"-";"-";"-";"-";"-";"-";"-";"-";"-";"-";"-";"-";"-";"-"
"25 Wrz 2024 23:02:07";"Koszty Utrzymania Pozycji";"O2-D4-95TL4Z";"-";"-";"Solana (USD)";"-";"-";"-";"-";"-";"-";"-";"-";"-";"-";"-";"-";"3 382,06";"-27,50000%";"-9,82";"0,00";"-";"-";"-";"-";"-";"-";"-";"-";"-";"-";"-";"-";"-";"-";"-";"-";"-";"-"
"25 Wrz 2024 23:02:07";"Koszty Utrzymania Pozycji";"O2-D5-97FGFP";"-";"-";"Solana (USD)";"-";"-";"-";"-";"-";"-";"-";"-";"-";"-";"-";"-";"7 515,70";"-10,00000%";"7,86";"0,00";"-";"-";"-";"-";"-";"-";"-";"-";"-";"-";"-";"-";"-";"-";"-";"-";"-";"-"
"25 Wrz 2024 23:02:07";"Koszty Utrzymania Pozycji";"O2-D5-96SWM1";"-";"-";"Solana (USD)";"-";"-";"-";"-";"-";"-";"-";"-";"-";"-";"-";"-";"12 626,37";"-27,50000%";"-36,66";"0,00";"-";"-";"-";"-";"-";"-";"-";"-";"-";"-";"-";"-";"-";"-";"-";"-";"-";"-"
"25 Wrz 2024 23:02:07";"Koszty Utrzymania Pozycji";"O2-D4-95EL0T";"-";"-";"Solana (USD)";"-";"-";"-";"-";"-";"-";"-";"-";"-";"-";"-";"-";"4 509,42";"-27,50000%";"-13,09";"0,00";"-";"-";"-";"-";"-";"-";"-";"-";"-";"-";"-";"-";"-";"-";"-";"-";"-";"-"
"25 Wrz 2024 23:02:07";"Koszty Utrzymania Pozycji";"O2-D4-96156D";"-";"-";"Solana (USD)";"-";"-";"-";"-";"-";"-";"-";"-";"-";"-";"-";"-";"3 682,69";"-27,50000%";"-10,69";"0,00";"-";"-";"-";"-";"-";"-";"-";"-";"-";"-";"-";"-";"-";"-";"-";"-";"-";"-"
"25 Wrz 2024 23:02:07";"Koszty Utrzymania Pozycji";"O2-D5-97FD8D";"-";"-";"Solana (USD)";"-";"-";"-";"-";"-";"-";"-";"-";"-";"-";"-";"-";"7 515,70";"-10,00000%";"7,86";"0,00";"-";"-";"-";"-";"-";"-";"-";"-";"-";"-";"-";"-";"-";"-";"-";"-";"-";"-"
"25 Wrz 2024 23:02:07";"Koszty Utrzymania Pozycji";"O2-D4-95K8MW";"-";"-";"Solana (USD)";"-";"-";"-";"-";"-";"-";"-";"-";"-";"-";"-";"-";"7 515,70";"-10,00000%";"7,86";"0,00";"-";"-";"-";"-";"-";"-";"-";"-";"-";"-";"-";"-";"-";"-";"-";"-";"-";"-"
"25 Wrz 2024 23:02:07";"Koszty Utrzymania Pozycji";"O2-D5-96WE65";"-";"-";"Solana (USD)";"-";"-";"-";"-";"-";"-";"-";"-";"-";"-";"-";"-";"7 215,07";"-27,50000%";"-20,95";"0,00";"-";"-";"-";"-";"-";"-";"-";"-";"-";"-";"-";"-";"-";"-";"-";"-";"-";"-"
"25 Wrz 2024 23:02:07";"Koszty Utrzymania Pozycji";"O2-D3-94JY88";"-";"-";"Solana (USD)";"-";"-";"-";"-";"-";"-";"-";"-";"-";"-";"-";"-";"3 757,85";"-27,50000%";"-10,91";"0,00";"-";"-";"-";"-";"-";"-";"-";"-";"-";"-";"-";"-";"-";"-";"-";"-";"-";"-"
"25 Wrz 2024 23:02:07";"Koszty Utrzymania Pozycji";"O2-D6-98C2XK";"-";"-";"Solana (USD)";"-";"-";"-";"-";"-";"-";"-";"-";"-";"-";"-";"-";"5 178,31";"-27,50000%";"-15,03";"0,00";"-";"-";"-";"-";"-";"-";"-";"-";"-";"-";"-";"-";"-";"-";"-";"-";"-";"-"
"25 Wrz 2024 23:02:07";"Koszty Utrzymania Pozycji";"O2-D6-97M8KS";"-";"-";"Solana (USD)";"-";"-";"-";"-";"-";"-";"-";"-";"-";"-";"-";"-";"9 018,84";"-27,50000%";"-26,18";"0,00";"-";"-";"-";"-";"-";"-";"-";"-";"-";"-";"-";"-";"-";"-";"-";"-";"-";"-"
"25 Wrz 2024 23:02:07";"Koszty Utrzymania Pozycji";"O2-D6-97Z6BV";"-";"-";"Solana (USD)";"-";"-";"-";"-";"-";"-";"-";"-";"-";"-";"-";"-";"5 253,47";"-10,00000%";"5,49";"0,00";"-";"-";"-";"-";"-";"-";"-";"-";"-";"-";"-";"-";"-";"-";"-";"-";"-";"-"
"25 Wrz 2024 23:02:07";"Koszty Utrzymania Pozycji";"O2-D6-97W2F5";"-";"-";"Solana (USD)";"-";"-";"-";"-";"-";"-";"-";"-";"-";"-";"-";"-";"3 757,85";"-10,00000%";"3,93";"0,00";"-";"-";"-";"-";"-";"-";"-";"-";"-";"-";"-";"-";"-";"-";"-";"-";"-";"-"
"25 Wrz 2024 23:02:07";"Koszty Utrzymania Pozycji";"O2-D6-97PWJQ";"-";"-";"Solana (USD)";"-";"-";"-";"-";"-";"-";"-";"-";"-";"-";"-";"-";"5 937,40";"-10,00000%";"6,21";"0,00";"-";"-";"-";"-";"-";"-";"-";"-";"-";"-";"-";"-";"-";"-";"-";"-";"-";"-"
"25 Wrz 2024 23:02:07";"Koszty Utrzymania Pozycji";"O2-D5-977RC9";"-";"-";"Solana (USD)";"-";"-";"-";"-";"-";"-";"-";"-";"-";"-";"-";"-";"9 770,41";"-10,00000%";"10,21";"0,00";"-";"-";"-";"-";"-";"-";"-";"-";"-";"-";"-";"-";"-";"-";"-";"-";"-";"-"
"25 Wrz 2024 23:02:07";"Koszty Utrzymania Pozycji";"O2-D6-97M6H8";"-";"-";"Solana (USD)";"-";"-";"-";"-";"-";"-";"-";"-";"-";"-";"-";"-";"12 476,06";"-27,50000%";"-36,22";"0,00";"-";"-";"-";"-";"-";"-";"-";"-";"-";"-";"-";"-";"-";"-";"-";"-";"-";"-"
"25 Wrz 2024 00:27:56";"Koszty Utrzymania Pozycji";"1375558920";"-";"-";"Rachunek";"-";"-";"-";"-";"-";"-";"-";"-";"-112,69";"39 373,64";"-";"-";"-";"-";"-";"-112,69";"-";"-";"-";"-";"-";"-";"-";"-";"-";"-";"-";"-";"-";"-";"-";"-";"-";"-"
"25 Wrz 2024 00:27:56";"Koszty Utrzymania Pozycji";"O2-D6-97Q7VH";"-";"-";"Solana (USD)";"-";"-";"-";"-";"-";"-";"-";"-";"-";"-";"-";"-";"9 947,82";"-10,00000%";"10,32";"0,00";"-";"-";"-";"-";"-";"-";"-";"-";"-";"-";"-";"-";"-";"-";"-";"-";"-";"-"
"25 Wrz 2024 00:27:56";"Koszty Utrzymania Pozycji";"O2-D5-97BZ7D";"-";"-";"Solana (USD)";"-";"-";"-";"-";"-";"-";"-";"-";"-";"-";"-";"-";"4 454,25";"-10,00000%";"4,62";"0,00";"-";"-";"-";"-";"-";"-";"-";"-";"-";"-";"-";"-";"-";"-";"-";"-";"-";"-"
"25 Wrz 2024 00:27:56";"Koszty Utrzymania Pozycji";"O2-D4-95TL4Z";"-";"-";"Solana (USD)";"-";"-";"-";"-";"-";"-";"-";"-";"-";"-";"-";"-";"3 340,68";"-27,50000%";"-9,63";"0,00";"-";"-";"-";"-";"-";"-";"-";"-";"-";"-";"-";"-";"-";"-";"-";"-";"-";"-"
"25 Wrz 2024 00:27:56";"Koszty Utrzymania Pozycji";"O2-D5-97FGFP";"-";"-";"Solana (USD)";"-";"-";"-";"-";"-";"-";"-";"-";"-";"-";"-";"-";"7 423,75";"-10,00000%";"7,70";"0,00";"-";"-";"-";"-";"-";"-";"-";"-";"-";"-";"-";"-";"-";"-";"-";"-";"-";"-"
"25 Wrz 2024 00:27:56";"Koszty Utrzymania Pozycji";"O2-D5-96SWM1";"-";"-";"Solana (USD)";"-";"-";"-";"-";"-";"-";"-";"-";"-";"-";"-";"-";"12 471,90";"-27,50000%";"-35,94";"0,00";"-";"-";"-";"-";"-";"-";"-";"-";"-";"-";"-";"-";"-";"-";"-";"-";"-";"-"
"25 Wrz 2024 00:27:56";"Koszty Utrzymania Pozycji";"O2-D4-95EL0T";"-";"-";"Solana (USD)";"-";"-";"-";"-";"-";"-";"-";"-";"-";"-";"-";"-";"4 454,25";"-27,50000%";"-12,84";"0,00";"-";"-";"-";"-";"-";"-";"-";"-";"-";"-";"-";"-";"-";"-";"-";"-";"-";"-"
"25 Wrz 2024 00:27:56";"Koszty Utrzymania Pozycji";"O2-D4-96156D";"-";"-";"Solana (USD)";"-";"-";"-";"-";"-";"-";"-";"-";"-";"-";"-";"-";"3 637,63";"-27,50000%";"-10,48";"0,00";"-";"-";"-";"-";"-";"-";"-";"-";"-";"-";"-";"-";"-";"-";"-";"-";"-";"-"
"25 Wrz 2024 00:27:56";"Koszty Utrzymania Pozycji";"O2-D5-97FD8D";"-";"-";"Solana (USD)";"-";"-";"-";"-";"-";"-";"-";"-";"-";"-";"-";"-";"7 423,75";"-10,00000%";"7,70";"0,00";"-";"-";"-";"-";"-";"-";"-";"-";"-";"-";"-";"-";"-";"-";"-";"-";"-";"-"
"25 Wrz 2024 00:27:56";"Koszty Utrzymania Pozycji";"O2-D4-95K8MW";"-";"-";"Solana (USD)";"-";"-";"-";"-";"-";"-";"-";"-";"-";"-";"-";"-";"7 423,75";"-10,00000%";"7,70";"0,00";"-";"-";"-";"-";"-";"-";"-";"-";"-";"-";"-";"-";"-";"-";"-";"-";"-";"-"
"25 Wrz 2024 00:27:56";"Koszty Utrzymania Pozycji";"O2-D5-96WE65";"-";"-";"Solana (USD)";"-";"-";"-";"-";"-";"-";"-";"-";"-";"-";"-";"-";"7 126,80";"-27,50000%";"-20,54";"0,00";"-";"-";"-";"-";"-";"-";"-";"-";"-";"-";"-";"-";"-";"-";"-";"-";"-";"-"
"25 Wrz 2024 00:27:56";"Koszty Utrzymania Pozycji";"O2-D3-94JY88";"-";"-";"Solana (USD)";"-";"-";"-";"-";"-";"-";"-";"-";"-";"-";"-";"-";"3 711,87";"-27,50000%";"-10,70";"0,00";"-";"-";"-";"-";"-";"-";"-";"-";"-";"-";"-";"-";"-";"-";"-";"-";"-";"-"
"25 Wrz 2024 00:27:56";"Koszty Utrzymania Pozycji";"O2-D6-98C2XK";"-";"-";"Solana (USD)";"-";"-";"-";"-";"-";"-";"-";"-";"-";"-";"-";"-";"5 114,96";"-27,50000%";"-14,74";"0,00";"-";"-";"-";"-";"-";"-";"-";"-";"-";"-";"-";"-";"-";"-";"-";"-";"-";"-"
"25 Wrz 2024 00:27:56";"Koszty Utrzymania Pozycji";"O2-D6-97M8KS";"-";"-";"Solana (USD)";"-";"-";"-";"-";"-";"-";"-";"-";"-";"-";"-";"-";"8 908,50";"-27,50000%";"-25,67";"0,00";"-";"-";"-";"-";"-";"-";"-";"-";"-";"-";"-";"-";"-";"-";"-";"-";"-";"-"
"25 Wrz 2024 00:27:56";"Koszty Utrzymania Pozycji";"O2-D6-97Z6BV";"-";"-";"Solana (USD)";"-";"-";"-";"-";"-";"-";"-";"-";"-";"-";"-";"-";"5 189,20";"-10,00000%";"5,38";"0,00";"-";"-";"-";"-";"-";"-";"-";"-";"-";"-";"-";"-";"-";"-";"-";"-";"-";"-"
"25 Wrz 2024 00:27:56";"Koszty Utrzymania Pozycji";"O2-D6-97W2F5";"-";"-";"Solana (USD)";"-";"-";"-";"-";"-";"-";"-";"-";"-";"-";"-";"-";"3 711,87";"-10,00000%";"3,85";"0,00";"-";"-";"-";"-";"-";"-";"-";"-";"-";"-";"-";"-";"-";"-";"-";"-";"-";"-"
"25 Wrz 2024 00:27:56";"Koszty Utrzymania Pozycji";"O2-D6-97PWJQ";"-";"-";"Solana (USD)";"-";"-";"-";"-";"-";"-";"-";"-";"-";"-";"-";"-";"5 864,76";"-10,00000%";"6,08";"0,00";"-";"-";"-";"-";"-";"-";"-";"-";"-";"-";"-";"-";"-";"-";"-";"-";"-";"-"
"25 Wrz 2024 00:27:56";"Koszty Utrzymania Pozycji";"O2-D5-977RC9";"-";"-";"Solana (USD)";"-";"-";"-";"-";"-";"-";"-";"-";"-";"-";"-";"-";"9 650,87";"-10,00000%";"10,01";"0,00";"-";"-";"-";"-";"-";"-";"-";"-";"-";"-";"-";"-";"-";"-";"-";"-";"-";"-"
"25 Wrz 2024 00:27:56";"Koszty Utrzymania Pozycji";"O2-D6-97M6H8";"-";"-";"Solana (USD)";"-";"-";"-";"-";"-";"-";"-";"-";"-";"-";"-";"-";"12 323,42";"-27,50000%";"-35,51";"0,00";"-";"-";"-";"-";"-";"-";"-";"-";"-";"-";"-";"-";"-";"-";"-";"-";"-";"-"
"23 Wrz 2024 23:01:59";"Koszty Utrzymania Pozycji";"1375216794";"-";"-";"Rachunek";"-";"-";"-";"-";"-";"-";"-";"-";"-109,89";"39 486,33";"-";"-";"-";"-";"-";"-109,89";"-";"-";"-";"-";"-";"-";"-";"-";"-";"-";"-";"-";"-";"-";"-";"-";"-";"-"
"23 Wrz 2024 23:01:59";"Koszty Utrzymania Pozycji";"O2-D6-97Q7VH";"-";"-";"Solana (USD)";"-";"-";"-";"-";"-";"-";"-";"-";"-";"-";"-";"-";"9 607,46";"-10,00000%";"10,07";"0,00";"-";"-";"-";"-";"-";"-";"-";"-";"-";"-";"-";"-";"-";"-";"-";"-";"-";"-"
"23 Wrz 2024 23:01:59";"Koszty Utrzymania Pozycji";"O2-D5-97BZ7D";"-";"-";"Solana (USD)";"-";"-";"-";"-";"-";"-";"-";"-";"-";"-";"-";"-";"4 301,85";"-10,00000%";"4,51";"0,00";"-";"-";"-";"-";"-";"-";"-";"-";"-";"-";"-";"-";"-";"-";"-";"-";"-";"-"
"23 Wrz 2024 23:01:59";"Koszty Utrzymania Pozycji";"O2-D4-95TL4Z";"-";"-";"Solana (USD)";"-";"-";"-";"-";"-";"-";"-";"-";"-";"-";"-";"-";"3 226,38";"-27,50000%";"-9,39";"0,00";"-";"-";"-";"-";"-";"-";"-";"-";"-";"-";"-";"-";"-";"-";"-";"-";"-";"-"
"23 Wrz 2024 23:01:59";"Koszty Utrzymania Pozycji";"O2-D5-97FGFP";"-";"-";"Solana (USD)";"-";"-";"-";"-";"-";"-";"-";"-";"-";"-";"-";"-";"7 169,75";"-10,00000%";"7,51";"0,00";"-";"-";"-";"-";"-";"-";"-";"-";"-";"-";"-";"-";"-";"-";"-";"-";"-";"-"
"23 Wrz 2024 23:01:59";"Koszty Utrzymania Pozycji";"O2-D5-96SWM1";"-";"-";"Solana (USD)";"-";"-";"-";"-";"-";"-";"-";"-";"-";"-";"-";"-";"12 045,18";"-27,50000%";"-35,06";"0,00";"-";"-";"-";"-";"-";"-";"-";"-";"-";"-";"-";"-";"-";"-";"-";"-";"-";"-"
"23 Wrz 2024 23:01:59";"Koszty Utrzymania Pozycji";"O2-D4-95EL0T";"-";"-";"Solana (USD)";"-";"-";"-";"-";"-";"-";"-";"-";"-";"-";"-";"-";"4 301,85";"-27,50000%";"-12,52";"0,00";"-";"-";"-";"-";"-";"-";"-";"-";"-";"-";"-";"-";"-";"-";"-";"-";"-";"-"
"23 Wrz 2024 23:01:59";"Koszty Utrzymania Pozycji";"O2-D4-96156D";"-";"-";"Solana (USD)";"-";"-";"-";"-";"-";"-";"-";"-";"-";"-";"-";"-";"3 513,17";"-27,50000%";"-10,23";"0,00";"-";"-";"-";"-";"-";"-";"-";"-";"-";"-";"-";"-";"-";"-";"-";"-";"-";"-"
"23 Wrz 2024 23:01:59";"Koszty Utrzymania Pozycji";"O2-D5-97FD8D";"-";"-";"Solana (USD)";"-";"-";"-";"-";"-";"-";"-";"-";"-";"-";"-";"-";"7 169,75";"-10,00000%";"7,51";"0,00";"-";"-";"-";"-";"-";"-";"-";"-";"-";"-";"-";"-";"-";"-";"-";"-";"-";"-"
"23 Wrz 2024 23:01:59";"Koszty Utrzymania Pozycji";"O2-D4-95K8MW";"-";"-";"Solana (USD)";"-";"-";"-";"-";"-";"-";"-";"-";"-";"-";"-";"-";"7 169,75";"-10,00000%";"7,51";"0,00";"-";"-";"-";"-";"-";"-";"-";"-";"-";"-";"-";"-";"-";"-";"-";"-";"-";"-"
"23 Wrz 2024 23:01:59";"Koszty Utrzymania Pozycji";"O2-D5-96WE65";"-";"-";"Solana (USD)";"-";"-";"-";"-";"-";"-";"-";"-";"-";"-";"-";"-";"6 882,96";"-27,50000%";"-20,03";"0,00";"-";"-";"-";"-";"-";"-";"-";"-";"-";"-";"-";"-";"-";"-";"-";"-";"-";"-"
"23 Wrz 2024 23:01:59";"Koszty Utrzymania Pozycji";"O2-D3-94JY88";"-";"-";"Solana (USD)";"-";"-";"-";"-";"-";"-";"-";"-";"-";"-";"-";"-";"3 584,87";"-27,50000%";"-10,43";"0,00";"-";"-";"-";"-";"-";"-";"-";"-";"-";"-";"-";"-";"-";"-";"-";"-";"-";"-"
"23 Wrz 2024 23:01:59";"Koszty Utrzymania Pozycji";"O2-D6-98C2XK";"-";"-";"Solana (USD)";"-";"-";"-";"-";"-";"-";"-";"-";"-";"-";"-";"-";"4 939,95";"-27,50000%";"-14,38";"0,00";"-";"-";"-";"-";"-";"-";"-";"-";"-";"-";"-";"-";"-";"-";"-";"-";"-";"-"
"23 Wrz 2024 23:01:59";"Koszty Utrzymania Pozycji";"O2-D6-97M8KS";"-";"-";"Solana (USD)";"-";"-";"-";"-";"-";"-";"-";"-";"-";"-";"-";"-";"8 603,70";"-27,50000%";"-25,04";"0,00";"-";"-";"-";"-";"-";"-";"-";"-";"-";"-";"-";"-";"-";"-";"-";"-";"-";"-"
"23 Wrz 2024 23:01:59";"Koszty Utrzymania Pozycji";"O2-D6-97Z6BV";"-";"-";"Solana (USD)";"-";"-";"-";"-";"-";"-";"-";"-";"-";"-";"-";"-";"5 011,65";"-10,00000%";"5,25";"0,00";"-";"-";"-";"-";"-";"-";"-";"-";"-";"-";"-";"-";"-";"-";"-";"-";"-";"-"
"23 Wrz 2024 23:01:59";"Koszty Utrzymania Pozycji";"O2-D6-97W2F5";"-";"-";"Solana (USD)";"-";"-";"-";"-";"-";"-";"-";"-";"-";"-";"-";"-";"3 584,87";"-10,00000%";"3,76";"0,00";"-";"-";"-";"-";"-";"-";"-";"-";"-";"-";"-";"-";"-";"-";"-";"-";"-";"-"
"23 Wrz 2024 23:01:59";"Koszty Utrzymania Pozycji";"O2-D6-97PWJQ";"-";"-";"Solana (USD)";"-";"-";"-";"-";"-";"-";"-";"-";"-";"-";"-";"-";"5 664,10";"-10,00000%";"5,94";"0,00";"-";"-";"-";"-";"-";"-";"-";"-";"-";"-";"-";"-";"-";"-";"-";"-";"-";"-"
"23 Wrz 2024 23:01:59";"Koszty Utrzymania Pozycji";"O2-D5-977RC9";"-";"-";"Solana (USD)";"-";"-";"-";"-";"-";"-";"-";"-";"-";"-";"-";"-";"9 320,67";"-10,00000%";"9,77";"0,00";"-";"-";"-";"-";"-";"-";"-";"-";"-";"-";"-";"-";"-";"-";"-";"-";"-";"-"
"23 Wrz 2024 23:01:59";"Koszty Utrzymania Pozycji";"O2-D6-97M6H8";"-";"-";"Solana (USD)";"-";"-";"-";"-";"-";"-";"-";"-";"-";"-";"-";"-";"11 901,78";"-27,50000%";"-34,64";"0,00";"-";"-";"-";"-";"-";"-";"-";"-";"-";"-";"-";"-";"-";"-";"-";"-";"-";"-"
"20 Wrz 2024 23:02:12";"Koszty Utrzymania Pozycji";"1374935991";"-";"-";"Rachunek";"-";"-";"-";"-";"-";"-";"-";"-";"-335,67";"39 596,22";"-";"-";"-";"-";"-";"-335,67";"-";"-";"-";"-";"-";"-";"-";"-";"-";"-";"-";"-";"-";"-";"-";"-";"-";"-"
"20 Wrz 2024 23:02:12";"Koszty Utrzymania Pozycji";"O2-D6-98C2XK";"-";"-";"Solana (USD)";"-";"-";"-";"-";"-";"-";"-";"-";"-";"-";"-";"-";"5 054,50";"-27,50000%";"-43,92";"0,00";"-";"-";"-";"-";"-";"-";"-";"-";"-";"-";"-";"-";"-";"-";"-";"-";"-";"-"
"20 Wrz 2024 23:02:12";"Koszty Utrzymania Pozycji";"O2-D6-97M8KS";"-";"-";"Solana (USD)";"-";"-";"-";"-";"-";"-";"-";"-";"-";"-";"-";"-";"8 803,20";"-27,50000%";"-76,49";"0,00";"-";"-";"-";"-";"-";"-";"-";"-";"-";"-";"-";"-";"-";"-";"-";"-";"-";"-"
"20 Wrz 2024 23:02:12";"Koszty Utrzymania Pozycji";"O2-D6-97Z6BV";"-";"-";"Solana (USD)";"-";"-";"-";"-";"-";"-";"-";"-";"-";"-";"-";"-";"5 127,86";"-10,00000%";"16,04";"0,00";"-";"-";"-";"-";"-";"-";"-";"-";"-";"-";"-";"-";"-";"-";"-";"-";"-";"-"
"20 Wrz 2024 23:02:12";"Koszty Utrzymania Pozycji";"O2-D6-97W2F5";"-";"-";"Solana (USD)";"-";"-";"-";"-";"-";"-";"-";"-";"-";"-";"-";"-";"3 668,00";"-10,00000%";"11,47";"0,00";"-";"-";"-";"-";"-";"-";"-";"-";"-";"-";"-";"-";"-";"-";"-";"-";"-";"-"
"20 Wrz 2024 23:02:12";"Koszty Utrzymania Pozycji";"O2-D6-97PWJQ";"-";"-";"Solana (USD)";"-";"-";"-";"-";"-";"-";"-";"-";"-";"-";"-";"-";"5 795,44";"-10,00000%";"18,13";"0,00";"-";"-";"-";"-";"-";"-";"-";"-";"-";"-";"-";"-";"-";"-";"-";"-";"-";"-"
"20 Wrz 2024 23:02:12";"Koszty Utrzymania Pozycji";"O2-D5-977RC9";"-";"-";"Solana (USD)";"-";"-";"-";"-";"-";"-";"-";"-";"-";"-";"-";"-";"9 536,80";"-10,00000%";"29,83";"0,00";"-";"-";"-";"-";"-";"-";"-";"-";"-";"-";"-";"-";"-";"-";"-";"-";"-";"-"
"20 Wrz 2024 23:02:12";"Koszty Utrzymania Pozycji";"O2-D6-97M6H8";"-";"-";"Solana (USD)";"-";"-";"-";"-";"-";"-";"-";"-";"-";"-";"-";"-";"12 177,76";"-27,50000%";"-105,81";"0,00";"-";"-";"-";"-";"-";"-";"-";"-";"-";"-";"-";"-";"-";"-";"-";"-";"-";"-"
"20 Wrz 2024 23:02:12";"Koszty Utrzymania Pozycji";"O2-D6-97Q7VH";"-";"-";"Solana (USD)";"-";"-";"-";"-";"-";"-";"-";"-";"-";"-";"-";"-";"9 830,24";"-10,00000%";"30,75";"0,00";"-";"-";"-";"-";"-";"-";"-";"-";"-";"-";"-";"-";"-";"-";"-";"-";"-";"-"
"20 Wrz 2024 23:02:12";"Koszty Utrzymania Pozycji";"O2-D5-97BZ7D";"-";"-";"Solana (USD)";"-";"-";"-";"-";"-";"-";"-";"-";"-";"-";"-";"-";"4 401,60";"-10,00000%";"13,77";"0,00";"-";"-";"-";"-";"-";"-";"-";"-";"-";"-";"-";"-";"-";"-";"-";"-";"-";"-"
"20 Wrz 2024 23:02:12";"Koszty Utrzymania Pozycji";"O2-D4-95TL4Z";"-";"-";"Solana (USD)";"-";"-";"-";"-";"-";"-";"-";"-";"-";"-";"-";"-";"3 301,20";"-27,50000%";"-28,68";"0,00";"-";"-";"-";"-";"-";"-";"-";"-";"-";"-";"-";"-";"-";"-";"-";"-";"-";"-"
"20 Wrz 2024 23:02:12";"Koszty Utrzymania Pozycji";"O2-D5-97FGFP";"-";"-";"Solana (USD)";"-";"-";"-";"-";"-";"-";"-";"-";"-";"-";"-";"-";"7 336,00";"-10,00000%";"22,95";"0,00";"-";"-";"-";"-";"-";"-";"-";"-";"-";"-";"-";"-";"-";"-";"-";"-";"-";"-"
"20 Wrz 2024 23:02:12";"Koszty Utrzymania Pozycji";"O2-D5-96SWM1";"-";"-";"Solana (USD)";"-";"-";"-";"-";"-";"-";"-";"-";"-";"-";"-";"-";"12 324,48";"-27,50000%";"-107,08";"0,00";"-";"-";"-";"-";"-";"-";"-";"-";"-";"-";"-";"-";"-";"-";"-";"-";"-";"-"
"20 Wrz 2024 23:02:12";"Koszty Utrzymania Pozycji";"O2-D4-95EL0T";"-";"-";"Solana (USD)";"-";"-";"-";"-";"-";"-";"-";"-";"-";"-";"-";"-";"4 401,60";"-27,50000%";"-38,24";"0,00";"-";"-";"-";"-";"-";"-";"-";"-";"-";"-";"-";"-";"-";"-";"-";"-";"-";"-"
"20 Wrz 2024 23:02:12";"Koszty Utrzymania Pozycji";"O2-D4-96156D";"-";"-";"Solana (USD)";"-";"-";"-";"-";"-";"-";"-";"-";"-";"-";"-";"-";"3 594,64";"-27,50000%";"-31,23";"0,00";"-";"-";"-";"-";"-";"-";"-";"-";"-";"-";"-";"-";"-";"-";"-";"-";"-";"-"
"20 Wrz 2024 23:02:12";"Koszty Utrzymania Pozycji";"O2-D5-97FD8D";"-";"-";"Solana (USD)";"-";"-";"-";"-";"-";"-";"-";"-";"-";"-";"-";"-";"7 336,00";"-10,00000%";"22,95";"0,00";"-";"-";"-";"-";"-";"-";"-";"-";"-";"-";"-";"-";"-";"-";"-";"-";"-";"-"
"20 Wrz 2024 23:02:12";"Koszty Utrzymania Pozycji";"O2-D4-95K8MW";"-";"-";"Solana (USD)";"-";"-";"-";"-";"-";"-";"-";"-";"-";"-";"-";"-";"7 336,00";"-10,00000%";"22,95";"0,00";"-";"-";"-";"-";"-";"-";"-";"-";"-";"-";"-";"-";"-";"-";"-";"-";"-";"-"
"20 Wrz 2024 23:02:12";"Koszty Utrzymania Pozycji";"O2-D5-96WE65";"-";"-";"Solana (USD)";"-";"-";"-";"-";"-";"-";"-";"-";"-";"-";"-";"-";"7 042,56";"-27,50000%";"-61,19";"0,00";"-";"-";"-";"-";"-";"-";"-";"-";"-";"-";"-";"-";"-";"-";"-";"-";"-";"-"
"20 Wrz 2024 23:02:12";"Koszty Utrzymania Pozycji";"O2-D3-94JY88";"-";"-";"Solana (USD)";"-";"-";"-";"-";"-";"-";"-";"-";"-";"-";"-";"-";"3 668,00";"-27,50000%";"-31,87";"0,00";"-";"-";"-";"-";"-";"-";"-";"-";"-";"-";"-";"-";"-";"-";"-";"-";"-";"-"
"19 Wrz 2024 23:02:01";"Koszty Utrzymania Pozycji";"1374612172";"-";"-";"Rachunek";"-";"-";"-";"-";"-";"-";"-";"-";"-109,67";"39 931,89";"-";"-";"-";"-";"-";"-109,67";"-";"-";"-";"-";"-";"-";"-";"-";"-";"-";"-";"-";"-";"-";"-";"-";"-";"-"
"19 Wrz 2024 23:02:01";"Koszty Utrzymania Pozycji";"O2-D3-94JY88";"-";"-";"Solana (USD)";"-";"-";"-";"-";"-";"-";"-";"-";"-";"-";"-";"-";"3 591,62";"-27,50000%";"-10,41";"0,00";"-";"-";"-";"-";"-";"-";"-";"-";"-";"-";"-";"-";"-";"-";"-";"-";"-";"-"
"19 Wrz 2024 23:02:01";"Koszty Utrzymania Pozycji";"O2-D6-98C2XK";"-";"-";"Solana (USD)";"-";"-";"-";"-";"-";"-";"-";"-";"-";"-";"-";"-";"4 949,25";"-27,50000%";"-14,35";"0,00";"-";"-";"-";"-";"-";"-";"-";"-";"-";"-";"-";"-";"-";"-";"-";"-";"-";"-"
"19 Wrz 2024 23:02:01";"Koszty Utrzymania Pozycji";"O2-D6-97M8KS";"-";"-";"Solana (USD)";"-";"-";"-";"-";"-";"-";"-";"-";"-";"-";"-";"-";"8 619,90";"-27,50000%";"-24,99";"0,00";"-";"-";"-";"-";"-";"-";"-";"-";"-";"-";"-";"-";"-";"-";"-";"-";"-";"-"
"19 Wrz 2024 23:02:01";"Koszty Utrzymania Pozycji";"O2-D6-97Z6BV";"-";"-";"Solana (USD)";"-";"-";"-";"-";"-";"-";"-";"-";"-";"-";"-";"-";"5 021,09";"-10,00000%";"5,24";"0,00";"-";"-";"-";"-";"-";"-";"-";"-";"-";"-";"-";"-";"-";"-";"-";"-";"-";"-"
"19 Wrz 2024 23:02:01";"Koszty Utrzymania Pozycji";"O2-D6-97W2F5";"-";"-";"Solana (USD)";"-";"-";"-";"-";"-";"-";"-";"-";"-";"-";"-";"-";"3 591,62";"-10,00000%";"3,75";"0,00";"-";"-";"-";"-";"-";"-";"-";"-";"-";"-";"-";"-";"-";"-";"-";"-";"-";"-"
"19 Wrz 2024 23:02:01";"Koszty Utrzymania Pozycji";"O2-D6-97PWJQ";"-";"-";"Solana (USD)";"-";"-";"-";"-";"-";"-";"-";"-";"-";"-";"-";"-";"5 674,76";"-10,00000%";"5,92";"0,00";"-";"-";"-";"-";"-";"-";"-";"-";"-";"-";"-";"-";"-";"-";"-";"-";"-";"-"
"19 Wrz 2024 23:02:01";"Koszty Utrzymania Pozycji";"O2-D5-977RC9";"-";"-";"Solana (USD)";"-";"-";"-";"-";"-";"-";"-";"-";"-";"-";"-";"-";"9 338,22";"-10,00000%";"9,75";"0,00";"-";"-";"-";"-";"-";"-";"-";"-";"-";"-";"-";"-";"-";"-";"-";"-";"-";"-"
"19 Wrz 2024 23:02:01";"Koszty Utrzymania Pozycji";"O2-D6-97M6H8";"-";"-";"Solana (USD)";"-";"-";"-";"-";"-";"-";"-";"-";"-";"-";"-";"-";"11 924,19";"-27,50000%";"-34,57";"0,00";"-";"-";"-";"-";"-";"-";"-";"-";"-";"-";"-";"-";"-";"-";"-";"-";"-";"-"
"19 Wrz 2024 23:02:01";"Koszty Utrzymania Pozycji";"O2-D6-97Q7VH";"-";"-";"Solana (USD)";"-";"-";"-";"-";"-";"-";"-";"-";"-";"-";"-";"-";"9 625,55";"-10,00000%";"10,05";"0,00";"-";"-";"-";"-";"-";"-";"-";"-";"-";"-";"-";"-";"-";"-";"-";"-";"-";"-"
"19 Wrz 2024 23:02:01";"Koszty Utrzymania Pozycji";"O2-D5-97BZ7D";"-";"-";"Solana (USD)";"-";"-";"-";"-";"-";"-";"-";"-";"-";"-";"-";"-";"4 309,95";"-10,00000%";"4,50";"0,00";"-";"-";"-";"-";"-";"-";"-";"-";"-";"-";"-";"-";"-";"-";"-";"-";"-";"-"
"19 Wrz 2024 23:02:01";"Koszty Utrzymania Pozycji";"O2-D4-95TL4Z";"-";"-";"Solana (USD)";"-";"-";"-";"-";"-";"-";"-";"-";"-";"-";"-";"-";"3 232,46";"-27,50000%";"-9,37";"0,00";"-";"-";"-";"-";"-";"-";"-";"-";"-";"-";"-";"-";"-";"-";"-";"-";"-";"-"
"19 Wrz 2024 23:02:01";"Koszty Utrzymania Pozycji";"O2-D5-97FGFP";"-";"-";"Solana (USD)";"-";"-";"-";"-";"-";"-";"-";"-";"-";"-";"-";"-";"7 183,25";"-10,00000%";"7,50";"0,00";"-";"-";"-";"-";"-";"-";"-";"-";"-";"-";"-";"-";"-";"-";"-";"-";"-";"-"
"19 Wrz 2024 23:02:01";"Koszty Utrzymania Pozycji";"O2-D5-96SWM1";"-";"-";"Solana (USD)";"-";"-";"-";"-";"-";"-";"-";"-";"-";"-";"-";"-";"12 067,86";"-27,50000%";"-34,99";"0,00";"-";"-";"-";"-";"-";"-";"-";"-";"-";"-";"-";"-";"-";"-";"-";"-";"-";"-"
"19 Wrz 2024 23:02:01";"Koszty Utrzymania Pozycji";"O2-D4-95EL0T";"-";"-";"Solana (USD)";"-";"-";"-";"-";"-";"-";"-";"-";"-";"-";"-";"-";"4 309,95";"-27,50000%";"-12,50";"0,00";"-";"-";"-";"-";"-";"-";"-";"-";"-";"-";"-";"-";"-";"-";"-";"-";"-";"-"
"19 Wrz 2024 23:02:01";"Koszty Utrzymania Pozycji";"O2-D4-96156D";"-";"-";"Solana (USD)";"-";"-";"-";"-";"-";"-";"-";"-";"-";"-";"-";"-";"3 519,79";"-27,50000%";"-10,21";"0,00";"-";"-";"-";"-";"-";"-";"-";"-";"-";"-";"-";"-";"-";"-";"-";"-";"-";"-"
"19 Wrz 2024 23:02:01";"Koszty Utrzymania Pozycji";"O2-D5-97FD8D";"-";"-";"Solana (USD)";"-";"-";"-";"-";"-";"-";"-";"-";"-";"-";"-";"-";"7 183,25";"-10,00000%";"7,50";"0,00";"-";"-";"-";"-";"-";"-";"-";"-";"-";"-";"-";"-";"-";"-";"-";"-";"-";"-"
"19 Wrz 2024 23:02:01";"Koszty Utrzymania Pozycji";"O2-D4-95K8MW";"-";"-";"Solana (USD)";"-";"-";"-";"-";"-";"-";"-";"-";"-";"-";"-";"-";"7 183,25";"-10,00000%";"7,50";"0,00";"-";"-";"-";"-";"-";"-";"-";"-";"-";"-";"-";"-";"-";"-";"-";"-";"-";"-"
"19 Wrz 2024 23:02:01";"Koszty Utrzymania Pozycji";"O2-D5-96WE65";"-";"-";"Solana (USD)";"-";"-";"-";"-";"-";"-";"-";"-";"-";"-";"-";"-";"6 895,92";"-27,50000%";"-19,99";"0,00";"-";"-";"-";"-";"-";"-";"-";"-";"-";"-";"-";"-";"-";"-";"-";"-";"-";"-"
"19 Wrz 2024 13:39:02";" Zmodyfikowano Transakcję Kupna";"O2-D6-98C2XK";"T2-D6-5LFWNK";"-";"Solana (USD)";"34,45 Jednost.";"139,110";"-";"-";"-";"-";"-";"-";"0,00";"-";"-";"-";"-";"-";"-";"-";"-";"-";"-";"-";"-";"-";"-";"-";"-";"-";"-";"-";"-";"-";"-";"-";"-";"-"
"19 Wrz 2024 13:38:51";" Transakcja Kupna";"O2-D6-98C2XK";"T2-D6-5LFWNK";"-";"Solana (USD)";"34,45 Jednost.";"139,110";"-";"136,328";"-";"-";"3,841628";"18 410,38";"0,00";"-";"-";"-";"-";"-";"-";"-";"-";"-";"-";"-";"-";"-";"-";"-";"-";"-";"-";"-";"-";"-";"-";"-";"-";"-"
"19 Wrz 2024 13:05:05";" Zamknięcie Transakcji";"O2-D6-98BZCW";"T2-D6-5LFV2H";"O2-D6-97ZT3E";"Solana (USD)";"63 Jednost.";"138,543";"-";"-";"-";"-";"3,80051";"33 504,99";"94,10";"40 041,56";"-";"-";"-";"-";"-";"-";"-";"-";"-";"-";"-";"-";"-";"-";"-";"-";"-";"-";"-";"-";"-";"-";"-";"-"
"18 Wrz 2024 23:02:06";"Koszty Utrzymania Pozycji";"1374243062";"-";"-";"Rachunek";"-";"-";"-";"-";"-";"-";"-";"-";"-111,04";"39 947,46";"-";"-";"-";"-";"-";"-111,04";"-";"-";"-";"-";"-";"-";"-";"-";"-";"-";"-";"-";"-";"-";"-";"-";"-";"-"
"18 Wrz 2024 23:02:06";"Koszty Utrzymania Pozycji";"O2-D6-97Q7VH";"-";"-";"Solana (USD)";"-";"-";"-";"-";"-";"-";"-";"-";"-";"-";"-";"-";"8 763,60";"-10,00000%";"9,18";"0,00";"-";"-";"-";"-";"-";"-";"-";"-";"-";"-";"-";"-";"-";"-";"-";"-";"-";"-"
"18 Wrz 2024 23:02:06";"Koszty Utrzymania Pozycji";"O2-D5-97BZ7D";"-";"-";"Solana (USD)";"-";"-";"-";"-";"-";"-";"-";"-";"-";"-";"-";"-";"3 924,00";"-10,00000%";"4,11";"0,00";"-";"-";"-";"-";"-";"-";"-";"-";"-";"-";"-";"-";"-";"-";"-";"-";"-";"-"
"18 Wrz 2024 23:02:06";"Koszty Utrzymania Pozycji";"O2-D4-95TL4Z";"-";"-";"Solana (USD)";"-";"-";"-";"-";"-";"-";"-";"-";"-";"-";"-";"-";"2 943,00";"-27,50000%";"-8,56";"0,00";"-";"-";"-";"-";"-";"-";"-";"-";"-";"-";"-";"-";"-";"-";"-";"-";"-";"-"
"18 Wrz 2024 23:02:06";"Koszty Utrzymania Pozycji";"O2-D5-97FGFP";"-";"-";"Solana (USD)";"-";"-";"-";"-";"-";"-";"-";"-";"-";"-";"-";"-";"6 540,00";"-10,00000%";"6,85";"0,00";"-";"-";"-";"-";"-";"-";"-";"-";"-";"-";"-";"-";"-";"-";"-";"-";"-";"-"
"18 Wrz 2024 23:02:06";"Koszty Utrzymania Pozycji";"O2-D5-96SWM1";"-";"-";"Solana (USD)";"-";"-";"-";"-";"-";"-";"-";"-";"-";"-";"-";"-";"10 987,20";"-27,50000%";"-31,96";"0,00";"-";"-";"-";"-";"-";"-";"-";"-";"-";"-";"-";"-";"-";"-";"-";"-";"-";"-"
"18 Wrz 2024 23:02:06";"Koszty Utrzymania Pozycji";"O2-D4-95EL0T";"-";"-";"Solana (USD)";"-";"-";"-";"-";"-";"-";"-";"-";"-";"-";"-";"-";"3 924,00";"-27,50000%";"-11,41";"0,00";"-";"-";"-";"-";"-";"-";"-";"-";"-";"-";"-";"-";"-";"-";"-";"-";"-";"-"
"18 Wrz 2024 23:02:06";"Koszty Utrzymania Pozycji";"O2-D4-96156D";"-";"-";"Solana (USD)";"-";"-";"-";"-";"-";"-";"-";"-";"-";"-";"-";"-";"3 204,60";"-27,50000%";"-9,32";"0,00";"-";"-";"-";"-";"-";"-";"-";"-";"-";"-";"-";"-";"-";"-";"-";"-";"-";"-"
"18 Wrz 2024 23:02:06";"Koszty Utrzymania Pozycji";"O2-D5-97FD8D";"-";"-";"Solana (USD)";"-";"-";"-";"-";"-";"-";"-";"-";"-";"-";"-";"-";"6 540,00";"-10,00000%";"6,85";"0,00";"-";"-";"-";"-";"-";"-";"-";"-";"-";"-";"-";"-";"-";"-";"-";"-";"-";"-"
"18 Wrz 2024 23:02:06";"Koszty Utrzymania Pozycji";"O2-D4-95K8MW";"-";"-";"Solana (USD)";"-";"-";"-";"-";"-";"-";"-";"-";"-";"-";"-";"-";"6 540,00";"-10,00000%";"6,85";"0,00";"-";"-";"-";"-";"-";"-";"-";"-";"-";"-";"-";"-";"-";"-";"-";"-";"-";"-"
"18 Wrz 2024 23:02:06";"Koszty Utrzymania Pozycji";"O2-D5-96WE65";"-";"-";"Solana (USD)";"-";"-";"-";"-";"-";"-";"-";"-";"-";"-";"-";"-";"6 278,40";"-27,50000%";"-18,26";"0,00";"-";"-";"-";"-";"-";"-";"-";"-";"-";"-";"-";"-";"-";"-";"-";"-";"-";"-"
"18 Wrz 2024 23:02:06";"Koszty Utrzymania Pozycji";"O2-D3-94JY88";"-";"-";"Solana (USD)";"-";"-";"-";"-";"-";"-";"-";"-";"-";"-";"-";"-";"3 270,00";"-27,50000%";"-9,51";"0,00";"-";"-";"-";"-";"-";"-";"-";"-";"-";"-";"-";"-";"-";"-";"-";"-";"-";"-"
"18 Wrz 2024 23:02:06";"Koszty Utrzymania Pozycji";"O2-D6-97M8KS";"-";"-";"Solana (USD)";"-";"-";"-";"-";"-";"-";"-";"-";"-";"-";"-";"-";"7 848,00";"-27,50000%";"-22,83";"0,00";"-";"-";"-";"-";"-";"-";"-";"-";"-";"-";"-";"-";"-";"-";"-";"-";"-";"-"
"18 Wrz 2024 23:02:06";"Koszty Utrzymania Pozycji";"O2-D6-97Z6BV";"-";"-";"Solana (USD)";"-";"-";"-";"-";"-";"-";"-";"-";"-";"-";"-";"-";"4 571,46";"-10,00000%";"4,79";"0,00";"-";"-";"-";"-";"-";"-";"-";"-";"-";"-";"-";"-";"-";"-";"-";"-";"-";"-"
"18 Wrz 2024 23:02:06";"Koszty Utrzymania Pozycji";"O2-D6-97W2F5";"-";"-";"Solana (USD)";"-";"-";"-";"-";"-";"-";"-";"-";"-";"-";"-";"-";"3 270,00";"-10,00000%";"3,42";"0,00";"-";"-";"-";"-";"-";"-";"-";"-";"-";"-";"-";"-";"-";"-";"-";"-";"-";"-"
"18 Wrz 2024 23:02:06";"Koszty Utrzymania Pozycji";"O2-D6-97ZT3E";"-";"-";"Solana (USD)";"-";"-";"-";"-";"-";"-";"-";"-";"-";"-";"-";"-";"8 240,40";"-27,50000%";"-23,97";"0,00";"-";"-";"-";"-";"-";"-";"-";"-";"-";"-";"-";"-";"-";"-";"-";"-";"-";"-"
"18 Wrz 2024 23:02:06";"Koszty Utrzymania Pozycji";"O2-D6-97PWJQ";"-";"-";"Solana (USD)";"-";"-";"-";"-";"-";"-";"-";"-";"-";"-";"-";"-";"5 166,60";"-10,00000%";"5,41";"0,00";"-";"-";"-";"-";"-";"-";"-";"-";"-";"-";"-";"-";"-";"-";"-";"-";"-";"-"
"18 Wrz 2024 23:02:06";"Koszty Utrzymania Pozycji";"O2-D5-977RC9";"-";"-";"Solana (USD)";"-";"-";"-";"-";"-";"-";"-";"-";"-";"-";"-";"-";"8 502,00";"-10,00000%";"8,90";"0,00";"-";"-";"-";"-";"-";"-";"-";"-";"-";"-";"-";"-";"-";"-";"-";"-";"-";"-"
"18 Wrz 2024 23:02:06";"Koszty Utrzymania Pozycji";"O2-D6-97M6H8";"-";"-";"Solana (USD)";"-";"-";"-";"-";"-";"-";"-";"-";"-";"-";"-";"-";"10 856,40";"-27,50000%";"-31,58";"0,00";"-";"-";"-";"-";"-";"-";"-";"-";"-";"-";"-";"-";"-";"-";"-";"-";"-";"-"
"17 Wrz 2024 23:02:03";"Koszty Utrzymania Pozycji";"1373887793";"-";"-";"Rachunek";"-";"-";"-";"-";"-";"-";"-";"-";"-112,20";"40 058,50";"-";"-";"-";"-";"-";"-112,20";"-";"-";"-";"-";"-";"-";"-";"-";"-";"-";"-";"-";"-";"-";"-";"-";"-";"-"
"17 Wrz 2024 23:02:03";"Koszty Utrzymania Pozycji";"O2-D6-97Q7VH";"-";"-";"Solana (USD)";"-";"-";"-";"-";"-";"-";"-";"-";"-";"-";"-";"-";"8 844,73";"-10,00000%";"9,27";"0,00";"-";"-";"-";"-";"-";"-";"-";"-";"-";"-";"-";"-";"-";"-";"-";"-";"-";"-"
"17 Wrz 2024 23:02:03";"Koszty Utrzymania Pozycji";"O2-D5-97BZ7D";"-";"-";"Solana (USD)";"-";"-";"-";"-";"-";"-";"-";"-";"-";"-";"-";"-";"3 960,33";"-10,00000%";"4,15";"0,00";"-";"-";"-";"-";"-";"-";"-";"-";"-";"-";"-";"-";"-";"-";"-";"-";"-";"-"
"17 Wrz 2024 23:02:03";"Koszty Utrzymania Pozycji";"O2-D4-95TL4Z";"-";"-";"Solana (USD)";"-";"-";"-";"-";"-";"-";"-";"-";"-";"-";"-";"-";"2 970,24";"-27,50000%";"-8,65";"0,00";"-";"-";"-";"-";"-";"-";"-";"-";"-";"-";"-";"-";"-";"-";"-";"-";"-";"-"
"17 Wrz 2024 23:02:03";"Koszty Utrzymania Pozycji";"O2-D5-97FGFP";"-";"-";"Solana (USD)";"-";"-";"-";"-";"-";"-";"-";"-";"-";"-";"-";"-";"6 600,55";"-10,00000%";"6,92";"0,00";"-";"-";"-";"-";"-";"-";"-";"-";"-";"-";"-";"-";"-";"-";"-";"-";"-";"-"
"17 Wrz 2024 23:02:03";"Koszty Utrzymania Pozycji";"O2-D5-96SWM1";"-";"-";"Solana (USD)";"-";"-";"-";"-";"-";"-";"-";"-";"-";"-";"-";"-";"11 088,92";"-27,50000%";"-32,29";"0,00";"-";"-";"-";"-";"-";"-";"-";"-";"-";"-";"-";"-";"-";"-";"-";"-";"-";"-"
"17 Wrz 2024 23:02:03";"Koszty Utrzymania Pozycji";"O2-D4-95EL0T";"-";"-";"Solana (USD)";"-";"-";"-";"-";"-";"-";"-";"-";"-";"-";"-";"-";"3 960,33";"-27,50000%";"-11,53";"0,00";"-";"-";"-";"-";"-";"-";"-";"-";"-";"-";"-";"-";"-";"-";"-";"-";"-";"-"
"17 Wrz 2024 23:02:03";"Koszty Utrzymania Pozycji";"O2-D4-96156D";"-";"-";"Solana (USD)";"-";"-";"-";"-";"-";"-";"-";"-";"-";"-";"-";"-";"3 234,26";"-27,50000%";"-9,42";"0,00";"-";"-";"-";"-";"-";"-";"-";"-";"-";"-";"-";"-";"-";"-";"-";"-";"-";"-"
"17 Wrz 2024 23:02:03";"Koszty Utrzymania Pozycji";"O2-D5-97FD8D";"-";"-";"Solana (USD)";"-";"-";"-";"-";"-";"-";"-";"-";"-";"-";"-";"-";"6 600,55";"-10,00000%";"6,92";"0,00";"-";"-";"-";"-";"-";"-";"-";"-";"-";"-";"-";"-";"-";"-";"-";"-";"-";"-"
"17 Wrz 2024 23:02:03";"Koszty Utrzymania Pozycji";"O2-D4-95K8MW";"-";"-";"Solana (USD)";"-";"-";"-";"-";"-";"-";"-";"-";"-";"-";"-";"-";"6 600,55";"-10,00000%";"6,92";"0,00";"-";"-";"-";"-";"-";"-";"-";"-";"-";"-";"-";"-";"-";"-";"-";"-";"-";"-"
"17 Wrz 2024 23:02:03";"Koszty Utrzymania Pozycji";"O2-D5-96WE65";"-";"-";"Solana (USD)";"-";"-";"-";"-";"-";"-";"-";"-";"-";"-";"-";"-";"6 336,52";"-27,50000%";"-18,45";"0,00";"-";"-";"-";"-";"-";"-";"-";"-";"-";"-";"-";"-";"-";"-";"-";"-";"-";"-"
"17 Wrz 2024 23:02:03";"Koszty Utrzymania Pozycji";"O2-D3-94JY88";"-";"-";"Solana (USD)";"-";"-";"-";"-";"-";"-";"-";"-";"-";"-";"-";"-";"3 300,27";"-27,50000%";"-9,61";"0,00";"-";"-";"-";"-";"-";"-";"-";"-";"-";"-";"-";"-";"-";"-";"-";"-";"-";"-"
"17 Wrz 2024 23:02:03";"Koszty Utrzymania Pozycji";"O2-D6-97M8KS";"-";"-";"Solana (USD)";"-";"-";"-";"-";"-";"-";"-";"-";"-";"-";"-";"-";"7 920,66";"-27,50000%";"-23,07";"0,00";"-";"-";"-";"-";"-";"-";"-";"-";"-";"-";"-";"-";"-";"-";"-";"-";"-";"-"
"17 Wrz 2024 23:02:03";"Koszty Utrzymania Pozycji";"O2-D6-97Z6BV";"-";"-";"Solana (USD)";"-";"-";"-";"-";"-";"-";"-";"-";"-";"-";"-";"-";"4 613,78";"-10,00000%";"4,84";"0,00";"-";"-";"-";"-";"-";"-";"-";"-";"-";"-";"-";"-";"-";"-";"-";"-";"-";"-"
"17 Wrz 2024 23:02:03";"Koszty Utrzymania Pozycji";"O2-D6-97W2F5";"-";"-";"Solana (USD)";"-";"-";"-";"-";"-";"-";"-";"-";"-";"-";"-";"-";"3 300,27";"-10,00000%";"3,46";"0,00";"-";"-";"-";"-";"-";"-";"-";"-";"-";"-";"-";"-";"-";"-";"-";"-";"-";"-"
"17 Wrz 2024 23:02:03";"Koszty Utrzymania Pozycji";"O2-D6-97ZT3E";"-";"-";"Solana (USD)";"-";"-";"-";"-";"-";"-";"-";"-";"-";"-";"-";"-";"8 316,69";"-27,50000%";"-24,22";"0,00";"-";"-";"-";"-";"-";"-";"-";"-";"-";"-";"-";"-";"-";"-";"-";"-";"-";"-"
"17 Wrz 2024 23:02:03";"Koszty Utrzymania Pozycji";"O2-D6-97PWJQ";"-";"-";"Solana (USD)";"-";"-";"-";"-";"-";"-";"-";"-";"-";"-";"-";"-";"5 214,43";"-10,00000%";"5,47";"0,00";"-";"-";"-";"-";"-";"-";"-";"-";"-";"-";"-";"-";"-";"-";"-";"-";"-";"-"
"17 Wrz 2024 23:02:03";"Koszty Utrzymania Pozycji";"O2-D5-977RC9";"-";"-";"Solana (USD)";"-";"-";"-";"-";"-";"-";"-";"-";"-";"-";"-";"-";"8 580,71";"-10,00000%";"9,00";"0,00";"-";"-";"-";"-";"-";"-";"-";"-";"-";"-";"-";"-";"-";"-";"-";"-";"-";"-"
"17 Wrz 2024 23:02:03";"Koszty Utrzymania Pozycji";"O2-D6-97M6H8";"-";"-";"Solana (USD)";"-";"-";"-";"-";"-";"-";"-";"-";"-";"-";"-";"-";"10 956,91";"-27,50000%";"-31,91";"0,00";"-";"-";"-";"-";"-";"-";"-";"-";"-";"-";"-";"-";"-";"-";"-";"-";"-";"-"
"16 Wrz 2024 23:02:00";"Koszty Utrzymania Pozycji";"1373569889";"-";"-";"Rachunek";"-";"-";"-";"-";"-";"-";"-";"-";"-110,43";"40 170,70";"-";"-";"-";"-";"-";"-110,43";"-";"-";"-";"-";"-";"-";"-";"-";"-";"-";"-";"-";"-";"-";"-";"-";"-";"-"
"16 Wrz 2024 23:02:00";"Koszty Utrzymania Pozycji";"O2-D6-97Q7VH";"-";"-";"Solana (USD)";"-";"-";"-";"-";"-";"-";"-";"-";"-";"-";"-";"-";"8 716,09";"-10,00000%";"9,13";"0,00";"-";"-";"-";"-";"-";"-";"-";"-";"-";"-";"-";"-";"-";"-";"-";"-";"-";"-"
"16 Wrz 2024 23:02:00";"Koszty Utrzymania Pozycji";"O2-D5-97BZ7D";"-";"-";"Solana (USD)";"-";"-";"-";"-";"-";"-";"-";"-";"-";"-";"-";"-";"3 902,73";"-10,00000%";"4,09";"0,00";"-";"-";"-";"-";"-";"-";"-";"-";"-";"-";"-";"-";"-";"-";"-";"-";"-";"-"
"16 Wrz 2024 23:02:00";"Koszty Utrzymania Pozycji";"O2-D4-95TL4Z";"-";"-";"Solana (USD)";"-";"-";"-";"-";"-";"-";"-";"-";"-";"-";"-";"-";"2 927,04";"-27,50000%";"-8,51";"0,00";"-";"-";"-";"-";"-";"-";"-";"-";"-";"-";"-";"-";"-";"-";"-";"-";"-";"-"
"16 Wrz 2024 23:02:00";"Koszty Utrzymania Pozycji";"O2-D5-97FGFP";"-";"-";"Solana (USD)";"-";"-";"-";"-";"-";"-";"-";"-";"-";"-";"-";"-";"6 504,55";"-10,00000%";"6,81";"0,00";"-";"-";"-";"-";"-";"-";"-";"-";"-";"-";"-";"-";"-";"-";"-";"-";"-";"-"
"16 Wrz 2024 23:02:00";"Koszty Utrzymania Pozycji";"O2-D5-96SWM1";"-";"-";"Solana (USD)";"-";"-";"-";"-";"-";"-";"-";"-";"-";"-";"-";"-";"10 927,64";"-27,50000%";"-31,78";"0,00";"-";"-";"-";"-";"-";"-";"-";"-";"-";"-";"-";"-";"-";"-";"-";"-";"-";"-"
"16 Wrz 2024 23:02:00";"Koszty Utrzymania Pozycji";"O2-D4-95EL0T";"-";"-";"Solana (USD)";"-";"-";"-";"-";"-";"-";"-";"-";"-";"-";"-";"-";"3 902,73";"-27,50000%";"-11,35";"0,00";"-";"-";"-";"-";"-";"-";"-";"-";"-";"-";"-";"-";"-";"-";"-";"-";"-";"-"
"16 Wrz 2024 23:02:00";"Koszty Utrzymania Pozycji";"O2-D4-96156D";"-";"-";"Solana (USD)";"-";"-";"-";"-";"-";"-";"-";"-";"-";"-";"-";"-";"3 187,22";"-27,50000%";"-9,27";"0,00";"-";"-";"-";"-";"-";"-";"-";"-";"-";"-";"-";"-";"-";"-";"-";"-";"-";"-"
"16 Wrz 2024 23:02:00";"Koszty Utrzymania Pozycji";"O2-D5-97FD8D";"-";"-";"Solana (USD)";"-";"-";"-";"-";"-";"-";"-";"-";"-";"-";"-";"-";"6 504,55";"-10,00000%";"6,81";"0,00";"-";"-";"-";"-";"-";"-";"-";"-";"-";"-";"-";"-";"-";"-";"-";"-";"-";"-"
"16 Wrz 2024 23:02:00";"Koszty Utrzymania Pozycji";"O2-D4-95K8MW";"-";"-";"Solana (USD)";"-";"-";"-";"-";"-";"-";"-";"-";"-";"-";"-";"-";"6 504,55";"-10,00000%";"6,81";"0,00";"-";"-";"-";"-";"-";"-";"-";"-";"-";"-";"-";"-";"-";"-";"-";"-";"-";"-"
"16 Wrz 2024 23:02:00";"Koszty Utrzymania Pozycji";"O2-D5-96WE65";"-";"-";"Solana (USD)";"-";"-";"-";"-";"-";"-";"-";"-";"-";"-";"-";"-";"6 244,36";"-27,50000%";"-18,16";"0,00";"-";"-";"-";"-";"-";"-";"-";"-";"-";"-";"-";"-";"-";"-";"-";"-";"-";"-"
"16 Wrz 2024 23:02:00";"Koszty Utrzymania Pozycji";"O2-D3-94JY88";"-";"-";"Solana (USD)";"-";"-";"-";"-";"-";"-";"-";"-";"-";"-";"-";"-";"3 252,27";"-27,50000%";"-9,46";"0,00";"-";"-";"-";"-";"-";"-";"-";"-";"-";"-";"-";"-";"-";"-";"-";"-";"-";"-"
"16 Wrz 2024 23:02:00";"Koszty Utrzymania Pozycji";"O2-D6-97M8KS";"-";"-";"Solana (USD)";"-";"-";"-";"-";"-";"-";"-";"-";"-";"-";"-";"-";"7 805,46";"-27,50000%";"-22,70";"0,00";"-";"-";"-";"-";"-";"-";"-";"-";"-";"-";"-";"-";"-";"-";"-";"-";"-";"-"
"16 Wrz 2024 23:02:00";"Koszty Utrzymania Pozycji";"O2-D6-97Z6BV";"-";"-";"Solana (USD)";"-";"-";"-";"-";"-";"-";"-";"-";"-";"-";"-";"-";"4 546,68";"-10,00000%";"4,76";"0,00";"-";"-";"-";"-";"-";"-";"-";"-";"-";"-";"-";"-";"-";"-";"-";"-";"-";"-"
"16 Wrz 2024 23:02:00";"Koszty Utrzymania Pozycji";"O2-D6-97W2F5";"-";"-";"Solana (USD)";"-";"-";"-";"-";"-";"-";"-";"-";"-";"-";"-";"-";"3 252,27";"-10,00000%";"3,41";"0,00";"-";"-";"-";"-";"-";"-";"-";"-";"-";"-";"-";"-";"-";"-";"-";"-";"-";"-"
"16 Wrz 2024 23:02:00";"Koszty Utrzymania Pozycji";"O2-D6-97ZT3E";"-";"-";"Solana (USD)";"-";"-";"-";"-";"-";"-";"-";"-";"-";"-";"-";"-";"8 195,73";"-27,50000%";"-23,84";"0,00";"-";"-";"-";"-";"-";"-";"-";"-";"-";"-";"-";"-";"-";"-";"-";"-";"-";"-"
"16 Wrz 2024 23:02:00";"Koszty Utrzymania Pozycji";"O2-D6-97PWJQ";"-";"-";"Solana (USD)";"-";"-";"-";"-";"-";"-";"-";"-";"-";"-";"-";"-";"5 138,59";"-10,00000%";"5,38";"0,00";"-";"-";"-";"-";"-";"-";"-";"-";"-";"-";"-";"-";"-";"-";"-";"-";"-";"-"
"16 Wrz 2024 23:02:00";"Koszty Utrzymania Pozycji";"O2-D5-977RC9";"-";"-";"Solana (USD)";"-";"-";"-";"-";"-";"-";"-";"-";"-";"-";"-";"-";"8 455,91";"-10,00000%";"8,85";"0,00";"-";"-";"-";"-";"-";"-";"-";"-";"-";"-";"-";"-";"-";"-";"-";"-";"-";"-"
"16 Wrz 2024 23:02:00";"Koszty Utrzymania Pozycji";"O2-D6-97M6H8";"-";"-";"Solana (USD)";"-";"-";"-";"-";"-";"-";"-";"-";"-";"-";"-";"-";"10 797,55";"-27,50000%";"-31,41";"0,00";"-";"-";"-";"-";"-";"-";"-";"-";"-";"-";"-";"-";"-";"-";"-";"-";"-";"-"
"16 Wrz 2024 00:03:50";" Zamknięcie Transakcji";"O2-D6-9807RG";"T2-D6-5L8N8S";"O2-D6-97Q7VH";"Solana (USD)";"3 Jednost.";"131,410";"-";"-";"-";"-";"3,84515";"1 531,10";"2,06";"40 281,13";"-";"-";"-";"-";"-";"-";"-";"-";"-";"-";"-";"-";"-";"-";"-";"-";"-";"-";"-";"-";"-";"-";"-";"-"
"13 Wrz 2024 23:01:57";"Koszty Utrzymania Pozycji";"1373241011";"-";"-";"Rachunek";"-";"-";"-";"-";"-";"-";"-";"-";"-352,51";"40 279,07";"-";"-";"-";"-";"-";"-352,51";"-";"-";"-";"-";"-";"-";"-";"-";"-";"-";"-";"-";"-";"-";"-";"-";"-";"-"
"13 Wrz 2024 23:01:57";"Koszty Utrzymania Pozycji";"O2-D6-97Q7VH";"-";"-";"Solana (USD)";"-";"-";"-";"-";"-";"-";"-";"-";"-";"-";"-";"-";"9 664,06";"-10,00000%";"30,55";"0,00";"-";"-";"-";"-";"-";"-";"-";"-";"-";"-";"-";"-";"-";"-";"-";"-";"-";"-"
"13 Wrz 2024 23:01:57";"Koszty Utrzymania Pozycji";"O2-D5-97BZ7D";"-";"-";"Solana (USD)";"-";"-";"-";"-";"-";"-";"-";"-";"-";"-";"-";"-";"4 141,74";"-10,00000%";"13,09";"0,00";"-";"-";"-";"-";"-";"-";"-";"-";"-";"-";"-";"-";"-";"-";"-";"-";"-";"-"
"13 Wrz 2024 23:01:57";"Koszty Utrzymania Pozycji";"O2-D4-95TL4Z";"-";"-";"Solana (USD)";"-";"-";"-";"-";"-";"-";"-";"-";"-";"-";"-";"-";"3 106,30";"-27,50000%";"-27,27";"0,00";"-";"-";"-";"-";"-";"-";"-";"-";"-";"-";"-";"-";"-";"-";"-";"-";"-";"-"
"13 Wrz 2024 23:01:57";"Koszty Utrzymania Pozycji";"O2-D5-97FGFP";"-";"-";"Solana (USD)";"-";"-";"-";"-";"-";"-";"-";"-";"-";"-";"-";"-";"6 902,90";"-10,00000%";"21,82";"0,00";"-";"-";"-";"-";"-";"-";"-";"-";"-";"-";"-";"-";"-";"-";"-";"-";"-";"-"
"13 Wrz 2024 23:01:57";"Koszty Utrzymania Pozycji";"O2-D5-96SWM1";"-";"-";"Solana (USD)";"-";"-";"-";"-";"-";"-";"-";"-";"-";"-";"-";"-";"11 596,87";"-27,50000%";"-101,83";"0,00";"-";"-";"-";"-";"-";"-";"-";"-";"-";"-";"-";"-";"-";"-";"-";"-";"-";"-"
"13 Wrz 2024 23:01:57";"Koszty Utrzymania Pozycji";"O2-D4-95EL0T";"-";"-";"Solana (USD)";"-";"-";"-";"-";"-";"-";"-";"-";"-";"-";"-";"-";"4 141,74";"-27,50000%";"-36,37";"0,00";"-";"-";"-";"-";"-";"-";"-";"-";"-";"-";"-";"-";"-";"-";"-";"-";"-";"-"
"13 Wrz 2024 23:01:57";"Koszty Utrzymania Pozycji";"O2-D4-96156D";"-";"-";"Solana (USD)";"-";"-";"-";"-";"-";"-";"-";"-";"-";"-";"-";"-";"3 382,42";"-27,50000%";"-29,70";"0,00";"-";"-";"-";"-";"-";"-";"-";"-";"-";"-";"-";"-";"-";"-";"-";"-";"-";"-"
"13 Wrz 2024 23:01:57";"Koszty Utrzymania Pozycji";"O2-D5-97FD8D";"-";"-";"Solana (USD)";"-";"-";"-";"-";"-";"-";"-";"-";"-";"-";"-";"-";"6 902,90";"-10,00000%";"21,82";"0,00";"-";"-";"-";"-";"-";"-";"-";"-";"-";"-";"-";"-";"-";"-";"-";"-";"-";"-"
"13 Wrz 2024 23:01:57";"Koszty Utrzymania Pozycji";"O2-D4-95K8MW";"-";"-";"Solana (USD)";"-";"-";"-";"-";"-";"-";"-";"-";"-";"-";"-";"-";"6 902,90";"-10,00000%";"21,82";"0,00";"-";"-";"-";"-";"-";"-";"-";"-";"-";"-";"-";"-";"-";"-";"-";"-";"-";"-"
"13 Wrz 2024 23:01:57";"Koszty Utrzymania Pozycji";"O2-D5-96WE65";"-";"-";"Solana (USD)";"-";"-";"-";"-";"-";"-";"-";"-";"-";"-";"-";"-";"6 626,78";"-27,50000%";"-58,19";"0,00";"-";"-";"-";"-";"-";"-";"-";"-";"-";"-";"-";"-";"-";"-";"-";"-";"-";"-"
"13 Wrz 2024 23:01:57";"Koszty Utrzymania Pozycji";"O2-D3-94JY88";"-";"-";"Solana (USD)";"-";"-";"-";"-";"-";"-";"-";"-";"-";"-";"-";"-";"3 451,45";"-27,50000%";"-30,31";"0,00";"-";"-";"-";"-";"-";"-";"-";"-";"-";"-";"-";"-";"-";"-";"-";"-";"-";"-"
"13 Wrz 2024 23:01:57";"Koszty Utrzymania Pozycji";"O2-D6-97M8KS";"-";"-";"Solana (USD)";"-";"-";"-";"-";"-";"-";"-";"-";"-";"-";"-";"-";"8 283,48";"-27,50000%";"-72,73";"0,00";"-";"-";"-";"-";"-";"-";"-";"-";"-";"-";"-";"-";"-";"-";"-";"-";"-";"-"
"13 Wrz 2024 23:01:57";"Koszty Utrzymania Pozycji";"O2-D6-97Z6BV";"-";"-";"Solana (USD)";"-";"-";"-";"-";"-";"-";"-";"-";"-";"-";"-";"-";"4 825,12";"-10,00000%";"15,25";"0,00";"-";"-";"-";"-";"-";"-";"-";"-";"-";"-";"-";"-";"-";"-";"-";"-";"-";"-"
"13 Wrz 2024 23:01:57";"Koszty Utrzymania Pozycji";"O2-D6-97W2F5";"-";"-";"Solana (USD)";"-";"-";"-";"-";"-";"-";"-";"-";"-";"-";"-";"-";"3 451,45";"-10,00000%";"10,91";"0,00";"-";"-";"-";"-";"-";"-";"-";"-";"-";"-";"-";"-";"-";"-";"-";"-";"-";"-"
"13 Wrz 2024 23:01:57";"Koszty Utrzymania Pozycji";"O2-D6-97ZT3E";"-";"-";"Solana (USD)";"-";"-";"-";"-";"-";"-";"-";"-";"-";"-";"-";"-";"8 697,65";"-27,50000%";"-76,37";"0,00";"-";"-";"-";"-";"-";"-";"-";"-";"-";"-";"-";"-";"-";"-";"-";"-";"-";"-"
"13 Wrz 2024 23:01:57";"Koszty Utrzymania Pozycji";"O2-D6-97PWJQ";"-";"-";"Solana (USD)";"-";"-";"-";"-";"-";"-";"-";"-";"-";"-";"-";"-";"5 453,29";"-10,00000%";"17,24";"0,00";"-";"-";"-";"-";"-";"-";"-";"-";"-";"-";"-";"-";"-";"-";"-";"-";"-";"-"
"13 Wrz 2024 23:01:57";"Koszty Utrzymania Pozycji";"O2-D5-977RC9";"-";"-";"Solana (USD)";"-";"-";"-";"-";"-";"-";"-";"-";"-";"-";"-";"-";"8 973,77";"-10,00000%";"28,37";"0,00";"-";"-";"-";"-";"-";"-";"-";"-";"-";"-";"-";"-";"-";"-";"-";"-";"-";"-"
"13 Wrz 2024 23:01:57";"Koszty Utrzymania Pozycji";"O2-D6-97M6H8";"-";"-";"Solana (USD)";"-";"-";"-";"-";"-";"-";"-";"-";"-";"-";"-";"-";"11 458,81";"-27,50000%";"-100,61";"0,00";"-";"-";"-";"-";"-";"-";"-";"-";"-";"-";"-";"-";"-";"-";"-";"-";"-";"-"
"13 Wrz 2024 20:40:08";" Zmodyfikowano Transakcję Kupna";"O2-D6-97ZT3E";"T2-D6-5L8HNG";"-";"Solana (USD)";"63 Jednost.";"138,150";"-";"-";"-";"-";"-";"-";"0,00";"-";"-";"-";"-";"-";"-";"-";"-";"-";"-";"-";"-";"-";"-";"-";"-";"-";"-";"-";"-";"-";"-";"-";"-";"-"
"13 Wrz 2024 20:39:59";" Transakcja Kupna";"O2-D6-97ZT3E";"T2-D6-5L8HNG";"-";"Solana (USD)";"63 Jednost.";"138,150";"-";"135,387";"-";"-";"3,881527";"33 782,67";"0,00";"-";"-";"-";"-";"-";"-";"-";"-";"-";"-";"-";"-";"-";"-";"-";"-";"-";"-";"-";"-";"-";"-";"-";"-";"-"
"13 Wrz 2024 18:18:02";" Zamknięcie Transakcji";"O2-D6-97ZBJ7";"T2-D6-5L8BXL";"O2-D6-97M8KS";"Solana (USD)";"5 Jednost.";"136,630";"-";"-";"-";"-";"3,84205";"2 651,06";"1,79";"40 631,58";"-";"-";"-";"-";"-";"-";"-";"-";"-";"-";"-";"-";"-";"-";"-";"-";"-";"-";"-";"-";"-";"-";"-";"-"
"13 Wrz 2024 18:17:23";" Zamknięcie Transakcji";"O2-D6-97ZBH3";"T2-D6-5L8BWP";"O2-D6-97M8KS";"Solana (USD)";"5 Jednost.";"136,785";"-";"-";"-";"-";"3,84306";"2 654,78";"4,77";"40 629,79";"-";"-";"-";"-";"-";"-";"-";"-";"-";"-";"-";"-";"-";"-";"-";"-";"-";"-";"-";"-";"-";"-";"-";"-"
"13 Wrz 2024 17:45:52";"Zmodyfikowano Transakcję Sprzedaży";"O2-D6-97Z6BV";"T2-D6-5L88QC";"-";"Solana (USD)";"34,95 Jednost.";"135,700";"-";"-";"-";"-";"-";"-";"0,00";"-";"-";"-";"-";"-";"-";"-";"-";"-";"-";"-";"-";"-";"-";"-";"-";"-";"-";"-";"-";"-";"-";"-";"-";"-"
"13 Wrz 2024 17:45:41";"Transakcja Sprzedaży";"O2-D6-97Z6BV";"T2-D6-5L88QC";"-";"Solana (USD)";"34,95 Jednost.";"135,700";"-";"138,414";"-";"-";"3,879994";"18 401,70";"0,00";"-";"-";"-";"-";"-";"-";"-";"-";"-";"-";"-";"-";"-";"-";"-";"-";"-";"-";"-";"-";"-";"-";"-";"-";"-"
"13 Wrz 2024 14:34:47";"Odrzucono Zlecenie: brak wystarczających środków";"O2-D6-97YED2";"-";"-";"Solana (USD)";"48,5 Jednost.";"-";"-";"-";"-";"-";"-";"-";"-";"-";"-";"-";"-";"-";"-";"-";"-";"-";"-";"-";"-";"-";"-";"-";"-";"-";"-";"-";"-";"-";"-";"-";"-";"-"
"13 Wrz 2024 14:33:15";" Zamknięcie Transakcji";"O2-D6-97YE6R";"T2-D6-5L7PK0";"O2-D6-97JRN1";"Solana (USD)";"33,8 Jednost.";"132,230";"-";"-";"-";"-";"3,84894";"17 375,17";"188,64";"40 625,02";"-";"-";"-";"-";"-";"-";"-";"-";"-";"-";"-";"-";"-";"-";"-";"-";"-";"-";"-";"-";"-";"-";"-";"-"
"12 Wrz 2024 23:01:58";"Koszty Utrzymania Pozycji";"1372919223";"-";"-";"Rachunek";"-";"-";"-";"-";"-";"-";"-";"-";"-94,82";"40 436,38";"-";"-";"-";"-";"-";"-94,82";"-";"-";"-";"-";"-";"-";"-";"-";"-";"-";"-";"-";"-";"-";"-";"-";"-";"-"
"12 Wrz 2024 23:01:58";"Koszty Utrzymania Pozycji";"O2-D6-97Q7VH";"-";"-";"Solana (USD)";"-";"-";"-";"-";"-";"-";"-";"-";"-";"-";"-";"-";"9 509,57";"-10,00000%";"10,03";"0,00";"-";"-";"-";"-";"-";"-";"-";"-";"-";"-";"-";"-";"-";"-";"-";"-";"-";"-"
"12 Wrz 2024 23:01:58";"Koszty Utrzymania Pozycji";"O2-D5-97BZ7D";"-";"-";"Solana (USD)";"-";"-";"-";"-";"-";"-";"-";"-";"-";"-";"-";"-";"4 075,53";"-10,00000%";"4,30";"0,00";"-";"-";"-";"-";"-";"-";"-";"-";"-";"-";"-";"-";"-";"-";"-";"-";"-";"-"
"12 Wrz 2024 23:01:58";"Koszty Utrzymania Pozycji";"O2-D4-95TL4Z";"-";"-";"Solana (USD)";"-";"-";"-";"-";"-";"-";"-";"-";"-";"-";"-";"-";"3 056,64";"-27,50000%";"-8,96";"0,00";"-";"-";"-";"-";"-";"-";"-";"-";"-";"-";"-";"-";"-";"-";"-";"-";"-";"-"
"12 Wrz 2024 23:01:58";"Koszty Utrzymania Pozycji";"O2-D5-97FGFP";"-";"-";"Solana (USD)";"-";"-";"-";"-";"-";"-";"-";"-";"-";"-";"-";"-";"6 792,55";"-10,00000%";"7,17";"0,00";"-";"-";"-";"-";"-";"-";"-";"-";"-";"-";"-";"-";"-";"-";"-";"-";"-";"-"
"12 Wrz 2024 23:01:58";"Koszty Utrzymania Pozycji";"O2-D5-96SWM1";"-";"-";"Solana (USD)";"-";"-";"-";"-";"-";"-";"-";"-";"-";"-";"-";"-";"11 411,48";"-27,50000%";"-33,44";"0,00";"-";"-";"-";"-";"-";"-";"-";"-";"-";"-";"-";"-";"-";"-";"-";"-";"-";"-"
"12 Wrz 2024 23:01:58";"Koszty Utrzymania Pozycji";"O2-D4-95EL0T";"-";"-";"Solana (USD)";"-";"-";"-";"-";"-";"-";"-";"-";"-";"-";"-";"-";"4 075,53";"-27,50000%";"-11,94";"0,00";"-";"-";"-";"-";"-";"-";"-";"-";"-";"-";"-";"-";"-";"-";"-";"-";"-";"-"
"12 Wrz 2024 23:01:58";"Koszty Utrzymania Pozycji";"O2-D4-96156D";"-";"-";"Solana (USD)";"-";"-";"-";"-";"-";"-";"-";"-";"-";"-";"-";"-";"3 328,34";"-27,50000%";"-9,75";"0,00";"-";"-";"-";"-";"-";"-";"-";"-";"-";"-";"-";"-";"-";"-";"-";"-";"-";"-"
"12 Wrz 2024 23:01:58";"Koszty Utrzymania Pozycji";"O2-D5-97FD8D";"-";"-";"Solana (USD)";"-";"-";"-";"-";"-";"-";"-";"-";"-";"-";"-";"-";"6 792,55";"-10,00000%";"7,17";"0,00";"-";"-";"-";"-";"-";"-";"-";"-";"-";"-";"-";"-";"-";"-";"-";"-";"-";"-"
"12 Wrz 2024 23:01:58";"Koszty Utrzymania Pozycji";"O2-D4-95K8MW";"-";"-";"Solana (USD)";"-";"-";"-";"-";"-";"-";"-";"-";"-";"-";"-";"-";"6 792,55";"-10,00000%";"7,17";"0,00";"-";"-";"-";"-";"-";"-";"-";"-";"-";"-";"-";"-";"-";"-";"-";"-";"-";"-"
"12 Wrz 2024 23:01:58";"Koszty Utrzymania Pozycji";"O2-D5-96WE65";"-";"-";"Solana (USD)";"-";"-";"-";"-";"-";"-";"-";"-";"-";"-";"-";"-";"6 520,84";"-27,50000%";"-19,11";"0,00";"-";"-";"-";"-";"-";"-";"-";"-";"-";"-";"-";"-";"-";"-";"-";"-";"-";"-"
"12 Wrz 2024 23:01:58";"Koszty Utrzymania Pozycji";"O2-D3-94JY88";"-";"-";"Solana (USD)";"-";"-";"-";"-";"-";"-";"-";"-";"-";"-";"-";"-";"3 396,27";"-27,50000%";"-9,95";"0,00";"-";"-";"-";"-";"-";"-";"-";"-";"-";"-";"-";"-";"-";"-";"-";"-";"-";"-"
"12 Wrz 2024 23:01:58";"Koszty Utrzymania Pozycji";"O2-D6-97W2F5";"-";"-";"Solana (USD)";"-";"-";"-";"-";"-";"-";"-";"-";"-";"-";"-";"-";"3 396,27";"-10,00000%";"3,58";"0,00";"-";"-";"-";"-";"-";"-";"-";"-";"-";"-";"-";"-";"-";"-";"-";"-";"-";"-"
"12 Wrz 2024 23:01:58";"Koszty Utrzymania Pozycji";"O2-D6-97JRN1";"-";"-";"Solana (USD)";"-";"-";"-";"-";"-";"-";"-";"-";"-";"-";"-";"-";"4 591,76";"-10,00000%";"4,84";"0,00";"-";"-";"-";"-";"-";"-";"-";"-";"-";"-";"-";"-";"-";"-";"-";"-";"-";"-"
"12 Wrz 2024 23:01:58";"Koszty Utrzymania Pozycji";"O2-D6-97M8KS";"-";"-";"Solana (USD)";"-";"-";"-";"-";"-";"-";"-";"-";"-";"-";"-";"-";"9 509,57";"-27,50000%";"-27,86";"0,00";"-";"-";"-";"-";"-";"-";"-";"-";"-";"-";"-";"-";"-";"-";"-";"-";"-";"-"
"12 Wrz 2024 23:01:58";"Koszty Utrzymania Pozycji";"O2-D6-97PWJQ";"-";"-";"Solana (USD)";"-";"-";"-";"-";"-";"-";"-";"-";"-";"-";"-";"-";"5 366,11";"-10,00000%";"5,66";"0,00";"-";"-";"-";"-";"-";"-";"-";"-";"-";"-";"-";"-";"-";"-";"-";"-";"-";"-"
"12 Wrz 2024 23:01:58";"Koszty Utrzymania Pozycji";"O2-D5-977RC9";"-";"-";"Solana (USD)";"-";"-";"-";"-";"-";"-";"-";"-";"-";"-";"-";"-";"8 830,31";"-10,00000%";"9,31";"0,00";"-";"-";"-";"-";"-";"-";"-";"-";"-";"-";"-";"-";"-";"-";"-";"-";"-";"-"
"12 Wrz 2024 23:01:58";"Koszty Utrzymania Pozycji";"O2-D6-97M6H8";"-";"-";"Solana (USD)";"-";"-";"-";"-";"-";"-";"-";"-";"-";"-";"-";"-";"11 275,63";"-27,50000%";"-33,04";"0,00";"-";"-";"-";"-";"-";"-";"-";"-";"-";"-";"-";"-";"-";"-";"-";"-";"-";"-"
"12 Wrz 2024 20:32:43";"Zmodyfikowano Transakcję Sprzedaży";"O2-D6-97W2F5";"T2-D6-5L6RWJ";"-";"Solana (USD)";"25 Jednost.";"135,285";"-";"-";"-";"-";"-";"-";"0,00";"-";"-";"-";"-";"-";"-";"-";"-";"-";"-";"-";"-";"-";"-";"-";"-";"-";"-";"-";"-";"-";"-";"-";"-";"-"
"12 Wrz 2024 20:32:34";"Transakcja Sprzedaży";"O2-D6-97W2F5";"T2-D6-5L6RWJ";"-";"Solana (USD)";"25 Jednost.";"135,285";"-";"137,990";"-";"-";"3,892589";"13 165,22";"0,00";"-";"-";"-";"-";"-";"-";"-";"-";"-";"-";"-";"-";"-";"-";"-";"-";"-";"-";"-";"-";"-";"-";"-";"-";"-"
"12 Wrz 2024 20:31:36";"Odrzucono Zlecenie: brak wystarczających środków";"O2-D6-97W23F";"-";"-";"Solana (USD)";"30 Jednost.";"-";"-";"-";"-";"-";"-";"-";"-";"-";"-";"-";"-";"-";"-";"-";"-";"-";"-";"-";"-";"-";"-";"-";"-";"-";"-";"-";"-";"-";"-";"-";"-";"-"
"12 Wrz 2024 09:05:49";" Zamknięcie Transakcji";"O2-D6-97S4YP";"T2-D6-5L5984";"O2-D6-97ME22";"Solana (USD)";"28,2 Jednost.";"134,985";"-";"-";"-";"-";"3,88202";"14 925,68";"78,82";"40 531,20";"-";"-";"-";"-";"-";"-";"-";"-";"-";"-";"-";"-";"-";"-";"-";"-";"-";"-";"-";"-";"-";"-";"-";"-"
"11 Wrz 2024 23:02:05";"Koszty Utrzymania Pozycji";"1372568698";"-";"-";"Rachunek";"-";"-";"-";"-";"-";"-";"-";"-";"-92,75";"40 452,38";"-";"-";"-";"-";"-";"-92,75";"-";"-";"-";"-";"-";"-";"-";"-";"-";"-";"-";"-";"-";"-";"-";"-";"-";"-"
"11 Wrz 2024 23:02:05";"Koszty Utrzymania Pozycji";"O2-D6-97Q7VH";"-";"-";"Solana (USD)";"-";"-";"-";"-";"-";"-";"-";"-";"-";"-";"-";"-";"9 284,80";"-10,00000%";"9,86";"0,00";"-";"-";"-";"-";"-";"-";"-";"-";"-";"-";"-";"-";"-";"-";"-";"-";"-";"-"
"11 Wrz 2024 23:02:05";"Koszty Utrzymania Pozycji";"O2-D6-97ME22";"-";"-";"Solana (USD)";"-";"-";"-";"-";"-";"-";"-";"-";"-";"-";"-";"-";"3 740,44";"-10,00000%";"3,97";"0,00";"-";"-";"-";"-";"-";"-";"-";"-";"-";"-";"-";"-";"-";"-";"-";"-";"-";"-"
"11 Wrz 2024 23:02:05";"Koszty Utrzymania Pozycji";"O2-D5-97BZ7D";"-";"-";"Solana (USD)";"-";"-";"-";"-";"-";"-";"-";"-";"-";"-";"-";"-";"3 979,20";"-10,00000%";"4,23";"0,00";"-";"-";"-";"-";"-";"-";"-";"-";"-";"-";"-";"-";"-";"-";"-";"-";"-";"-"
"11 Wrz 2024 23:02:05";"Koszty Utrzymania Pozycji";"O2-D4-95TL4Z";"-";"-";"Solana (USD)";"-";"-";"-";"-";"-";"-";"-";"-";"-";"-";"-";"-";"2 984,40";"-27,50000%";"-8,80";"0,00";"-";"-";"-";"-";"-";"-";"-";"-";"-";"-";"-";"-";"-";"-";"-";"-";"-";"-"
"11 Wrz 2024 23:02:05";"Koszty Utrzymania Pozycji";"O2-D5-97FGFP";"-";"-";"Solana (USD)";"-";"-";"-";"-";"-";"-";"-";"-";"-";"-";"-";"-";"6 632,00";"-10,00000%";"7,04";"0,00";"-";"-";"-";"-";"-";"-";"-";"-";"-";"-";"-";"-";"-";"-";"-";"-";"-";"-"
"11 Wrz 2024 23:02:05";"Koszty Utrzymania Pozycji";"O2-D5-96SWM1";"-";"-";"Solana (USD)";"-";"-";"-";"-";"-";"-";"-";"-";"-";"-";"-";"-";"11 141,76";"-27,50000%";"-32,86";"0,00";"-";"-";"-";"-";"-";"-";"-";"-";"-";"-";"-";"-";"-";"-";"-";"-";"-";"-"
"11 Wrz 2024 23:02:05";"Koszty Utrzymania Pozycji";"O2-D4-95EL0T";"-";"-";"Solana (USD)";"-";"-";"-";"-";"-";"-";"-";"-";"-";"-";"-";"-";"3 979,20";"-27,50000%";"-11,74";"0,00";"-";"-";"-";"-";"-";"-";"-";"-";"-";"-";"-";"-";"-";"-";"-";"-";"-";"-"
"11 Wrz 2024 23:02:05";"Koszty Utrzymania Pozycji";"O2-D4-96156D";"-";"-";"Solana (USD)";"-";"-";"-";"-";"-";"-";"-";"-";"-";"-";"-";"-";"3 249,68";"-27,50000%";"-9,59";"0,00";"-";"-";"-";"-";"-";"-";"-";"-";"-";"-";"-";"-";"-";"-";"-";"-";"-";"-"
"11 Wrz 2024 23:02:05";"Koszty Utrzymania Pozycji";"O2-D5-97FD8D";"-";"-";"Solana (USD)";"-";"-";"-";"-";"-";"-";"-";"-";"-";"-";"-";"-";"6 632,00";"-10,00000%";"7,04";"0,00";"-";"-";"-";"-";"-";"-";"-";"-";"-";"-";"-";"-";"-";"-";"-";"-";"-";"-"
"11 Wrz 2024 23:02:05";"Koszty Utrzymania Pozycji";"O2-D4-95K8MW";"-";"-";"Solana (USD)";"-";"-";"-";"-";"-";"-";"-";"-";"-";"-";"-";"-";"6 632,00";"-10,00000%";"7,04";"0,00";"-";"-";"-";"-";"-";"-";"-";"-";"-";"-";"-";"-";"-";"-";"-";"-";"-";"-"
"11 Wrz 2024 23:02:05";"Koszty Utrzymania Pozycji";"O2-D5-96WE65";"-";"-";"Solana (USD)";"-";"-";"-";"-";"-";"-";"-";"-";"-";"-";"-";"-";"6 366,72";"-27,50000%";"-18,78";"0,00";"-";"-";"-";"-";"-";"-";"-";"-";"-";"-";"-";"-";"-";"-";"-";"-";"-";"-"
"11 Wrz 2024 23:02:05";"Koszty Utrzymania Pozycji";"O2-D3-94JY88";"-";"-";"Solana (USD)";"-";"-";"-";"-";"-";"-";"-";"-";"-";"-";"-";"-";"3 316,00";"-27,50000%";"-9,78";"0,00";"-";"-";"-";"-";"-";"-";"-";"-";"-";"-";"-";"-";"-";"-";"-";"-";"-";"-"
"11 Wrz 2024 23:02:05";"Koszty Utrzymania Pozycji";"O2-D6-97JRN1";"-";"-";"Solana (USD)";"-";"-";"-";"-";"-";"-";"-";"-";"-";"-";"-";"-";"4 483,23";"-10,00000%";"4,76";"0,00";"-";"-";"-";"-";"-";"-";"-";"-";"-";"-";"-";"-";"-";"-";"-";"-";"-";"-"
"11 Wrz 2024 23:02:05";"Koszty Utrzymania Pozycji";"O2-D6-97M8KS";"-";"-";"Solana (USD)";"-";"-";"-";"-";"-";"-";"-";"-";"-";"-";"-";"-";"9 284,80";"-27,50000%";"-27,39";"0,00";"-";"-";"-";"-";"-";"-";"-";"-";"-";"-";"-";"-";"-";"-";"-";"-";"-";"-"
"11 Wrz 2024 23:02:05";"Koszty Utrzymania Pozycji";"O2-D6-97PWJQ";"-";"-";"Solana (USD)";"-";"-";"-";"-";"-";"-";"-";"-";"-";"-";"-";"-";"5 239,28";"-10,00000%";"5,56";"0,00";"-";"-";"-";"-";"-";"-";"-";"-";"-";"-";"-";"-";"-";"-";"-";"-";"-";"-"
"11 Wrz 2024 23:02:05";"Koszty Utrzymania Pozycji";"O2-D5-977RC9";"-";"-";"Solana (USD)";"-";"-";"-";"-";"-";"-";"-";"-";"-";"-";"-";"-";"8 621,60";"-10,00000%";"9,16";"0,00";"-";"-";"-";"-";"-";"-";"-";"-";"-";"-";"-";"-";"-";"-";"-";"-";"-";"-"
"11 Wrz 2024 23:02:05";"Koszty Utrzymania Pozycji";"O2-D6-97M6H8";"-";"-";"Solana (USD)";"-";"-";"-";"-";"-";"-";"-";"-";"-";"-";"-";"-";"11 009,12";"-27,50000%";"-32,47";"0,00";"-";"-";"-";"-";"-";"-";"-";"-";"-";"-";"-";"-";"-";"-";"-";"-";"-";"-"
"11 Wrz 2024 18:09:54";"Zmodyfikowano Transakcję Sprzedaży";"O2-D6-97Q7VH";"T2-D6-5L4CTK";"-";"Solana (USD)";"70 Jednost.";"131,589";"-";"-";"-";"-";"-";"-";"0,00";"-";"-";"-";"-";"-";"-";"-";"-";"-";"-";"-";"-";"-";"-";"-";"-";"-";"-";"-";"-";"-";"-";"-";"-";"-"
"11 Wrz 2024 18:09:44";"Transakcja Sprzedaży";"O2-D6-97Q7VH";"T2-D6-5L4CTK";"-";"Solana (USD)";"70 Jednost.";"131,589";"-";"134,220";"-";"-";"3,918331";"36 092,64";"0,00";"-";"-";"-";"-";"-";"-";"-";"-";"-";"-";"-";"-";"-";"-";"-";"-";"-";"-";"-";"-";"-";"-";"-";"-";"-"
"11 Wrz 2024 18:00:55";" Zamknięcie Transakcji";"O2-D6-97Q6PZ";"T2-D6-5L4BQ3";"O2-D6-97Q5JF";"Solana (USD)";"70 Jednost.";"131,315";"-";"-";"-";"-";"3,88148";"36 037,38";"58,96";"40 545,13";"-";"-";"-";"-";"-";"-";"-";"-";"-";"-";"-";"-";"-";"-";"-";"-";"-";"-";"-";"-";"-";"-";"-";"-"
"11 Wrz 2024 17:51:50";"Zmodyfikowano Transakcję Sprzedaży";"O2-D6-97Q5JF";"T2-D6-5L49NR";"-";"Solana (USD)";"70 Jednost.";"131,532";"-";"-";"-";"-";"-";"-";"0,00";"-";"-";"-";"-";"-";"-";"-";"-";"-";"-";"-";"-";"-";"-";"-";"-";"-";"-";"-";"-";"-";"-";"-";"-";"-"
"11 Wrz 2024 17:51:41";"Transakcja Sprzedaży";"O2-D6-97Q5JF";"T2-D6-5L49NR";"-";"Solana (USD)";"70 Jednost.";"131,532";"-";"134,162";"-";"-";"3,918872";"36 081,99";"0,00";"-";"-";"-";"-";"-";"-";"-";"-";"-";"-";"-";"-";"-";"-";"-";"-";"-";"-";"-";"-";"-";"-";"-";"-";"-"
"11 Wrz 2024 17:42:29";" Zamknięcie Transakcji";"O2-D6-97Q3LD";"T2-D6-5L48QT";"O2-D6-97K13Q";"Solana (USD)";"20 Jednost.";"131,966";"-";"-";"-";"-";"3,87965";"10 342,54";"172,49";"40 486,17";"-";"-";"-";"-";"-";"-";"-";"-";"-";"-";"-";"-";"-";"-";"-";"-";"-";"-";"-";"-";"-";"-";"-";"-"
"11 Wrz 2024 17:38:51";" Zamknięcie Transakcji";"O2-D6-97Q2SE";"T2-D6-5L4858";"O2-D6-97NDPP";"Solana (USD)";"50 Jednost.";"131,265";"-";"-";"-";"-";"3,91819";"25 716,06";"-48,00";"40 313,68";"-";"-";"-";"-";"-";"-";"-";"-";"-";"-";"-";"-";"-";"-";"-";"-";"-";"-";"-";"-";"-";"-";"-";"-"
"11 Wrz 2024 17:02:04";"Zmodyfikowano Transakcję Sprzedaży";"O2-D6-97PWJQ";"T2-D6-5L43MP";"-";"Solana (USD)";"39,5 Jednost.";"129,278";"-";"-";"-";"-";"-";"-";"0,00";"-";"-";"-";"-";"-";"-";"-";"-";"-";"-";"-";"-";"-";"-";"-";"-";"-";"-";"-";"-";"-";"-";"-";"-";"-"
"11 Wrz 2024 17:01:50";"Transakcja Sprzedaży";"O2-D6-97PWJQ";"T2-D6-5L43MP";"-";"Solana (USD)";"39,5 Jednost.";"129,278";"-";"131,863";"-";"-";"3,91817";"20 008,06";"0,00";"-";"-";"-";"-";"-";"-";"-";"-";"-";"-";"-";"-";"-";"-";"-";"-";"-";"-";"-";"-";"-";"-";"-";"-";"-"
"11 Wrz 2024 16:59:36";" Zamknięcie Transakcji";"O2-D6-97PW5B";"T2-D6-5L4384";"O2-D6-97NP1D";"Solana (USD)";"8,65 Jednost.";"129,675";"-";"-";"-";"-";"3,88016";"4 396,06";"39,24";"40 361,68";"-";"-";"-";"-";"-";"-";"-";"-";"-";"-";"-";"-";"-";"-";"-";"-";"-";"-";"-";"-";"-";"-";"-";"-"
"11 Wrz 2024 16:55:14";" Zamknięcie Transakcji";"O2-D6-97PVJM";"T2-D6-5L42NM";"O2-D5-977ENK";"Solana (USD)";"30 Jednost.";"128,883";"-";"-";"-";"-";"3,88226";"15 161,61";"149,78";"40 322,44";"-";"-";"-";"-";"-";"-";"-";"-";"-";"-";"-";"-";"-";"-";"-";"-";"-";"-";"-";"-";"-";"-";"-";"-"
"11 Wrz 2024 12:58:15";"Zmodyfikowano Transakcję Sprzedaży";"O2-D6-97NP1D";"T2-D6-5L37QM";"-";"Solana (USD)";"8,65 Jednost.";"130,844";"-";"-";"-";"-";"-";"-";"0,00";"-";"-";"-";"-";"-";"-";"-";"-";"-";"-";"-";"-";"-";"-";"-";"-";"-";"-";"-";"-";"-";"-";"-";"-";"-"
"11 Wrz 2024 12:58:07";"Transakcja Sprzedaży";"O2-D6-97NP1D";"T2-D6-5L37QM";"-";"Solana (USD)";"8,65 Jednost.";"130,844";"-";"133,477";"-";"-";"3,901687";"4 415,93";"0,00";"-";"-";"-";"-";"-";"-";"-";"-";"-";"-";"-";"-";"-";"-";"-";"-";"-";"-";"-";"-";"-";"-";"-";"-";"-"
"11 Wrz 2024 10:44:44";"Zmodyfikowano Transakcję Sprzedaży";"O2-D6-97NDPP";"T2-D6-5L330E";"-";"Solana (USD)";"50 Jednost.";"131,020";"-";"-";"-";"-";"-";"-";"0,00";"-";"-";"-";"-";"-";"-";"-";"-";"-";"-";"-";"-";"-";"-";"-";"-";"-";"-";"-";"-";"-";"-";"-";"-";"-"
"11 Wrz 2024 10:44:28";"Transakcja Sprzedaży";"O2-D6-97NDPP";"T2-D6-5L330E";"-";"Solana (USD)";"50 Jednost.";"131,020";"-";"133,640";"-";"-";"3,900635";"25 553,05";"0,00";"-";"-";"-";"-";"-";"-";"-";"-";"-";"-";"-";"-";"-";"-";"-";"-";"-";"-";"-";"-";"-";"-";"-";"-";"-"
"11 Wrz 2024 09:31:38";" Zamknięcie Transakcji";"O2-D6-97N78K";"T2-D6-5L3016";"O2-D6-97JRN1";"Solana (USD)";"30 Jednost.";"132,395";"-";"-";"-";"-";"3,85342";"15 459,02";"148,55";"40 172,66";"-";"-";"-";"-";"-";"-";"-";"-";"-";"-";"-";"-";"-";"-";"-";"-";"-";"-";"-";"-";"-";"-";"-";"-"
"10 Wrz 2024 23:25:57";" Zamknięcie Transakcji";"O2-D6-97ME7B";"T2-D6-5L2KG1";"O2-D6-97ME22";"Solana (USD)";"21,8 Jednost.";"135,525";"-";"-";"-";"-";"3,86386";"11 530,28";"15,16";"40 024,11";"-";"-";"-";"-";"-";"-";"-";"-";"-";"-";"-";"-";"-";"-";"-";"-";"-";"-";"-";"-";"-";"-";"-";"-"
"10 Wrz 2024 23:02:00";"Koszty Utrzymania Pozycji";"1372120548";"-";"-";"Rachunek";"-";"-";"-";"-";"-";"-";"-";"-";"-95,75";"40 008,95";"-";"-";"-";"-";"-";"-95,75";"-";"-";"-";"-";"-";"-";"-";"-";"-";"-";"-";"-";"-";"-";"-";"-";"-";"-"
"10 Wrz 2024 23:02:00";"Koszty Utrzymania Pozycji";"O2-D6-97K13Q";"-";"-";"Solana (USD)";"-";"-";"-";"-";"-";"-";"-";"-";"-";"-";"-";"-";"2 715,20";"-10,00000%";"2,88";"0,00";"-";"-";"-";"-";"-";"-";"-";"-";"-";"-";"-";"-";"-";"-";"-";"-";"-";"-"
"10 Wrz 2024 23:02:00";"Koszty Utrzymania Pozycji";"O2-D5-97BZ7D";"-";"-";"Solana (USD)";"-";"-";"-";"-";"-";"-";"-";"-";"-";"-";"-";"-";"4 072,80";"-10,00000%";"4,31";"0,00";"-";"-";"-";"-";"-";"-";"-";"-";"-";"-";"-";"-";"-";"-";"-";"-";"-";"-"
"10 Wrz 2024 23:02:00";"Koszty Utrzymania Pozycji";"O2-D5-977ENK";"-";"-";"Solana (USD)";"-";"-";"-";"-";"-";"-";"-";"-";"-";"-";"-";"-";"4 072,80";"-10,00000%";"4,31";"0,00";"-";"-";"-";"-";"-";"-";"-";"-";"-";"-";"-";"-";"-";"-";"-";"-";"-";"-"
"10 Wrz 2024 23:02:00";"Koszty Utrzymania Pozycji";"O2-D4-95TL4Z";"-";"-";"Solana (USD)";"-";"-";"-";"-";"-";"-";"-";"-";"-";"-";"-";"-";"3 054,60";"-27,50000%";"-8,98";"0,00";"-";"-";"-";"-";"-";"-";"-";"-";"-";"-";"-";"-";"-";"-";"-";"-";"-";"-"
"10 Wrz 2024 23:02:00";"Koszty Utrzymania Pozycji";"O2-D5-97FGFP";"-";"-";"Solana (USD)";"-";"-";"-";"-";"-";"-";"-";"-";"-";"-";"-";"-";"6 788,00";"-10,00000%";"7,19";"0,00";"-";"-";"-";"-";"-";"-";"-";"-";"-";"-";"-";"-";"-";"-";"-";"-";"-";"-"
"10 Wrz 2024 23:02:00";"Koszty Utrzymania Pozycji";"O2-D5-96SWM1";"-";"-";"Solana (USD)";"-";"-";"-";"-";"-";"-";"-";"-";"-";"-";"-";"-";"11 403,84";"-27,50000%";"-33,54";"0,00";"-";"-";"-";"-";"-";"-";"-";"-";"-";"-";"-";"-";"-";"-";"-";"-";"-";"-"
"10 Wrz 2024 23:02:00";"Koszty Utrzymania Pozycji";"O2-D4-95EL0T";"-";"-";"Solana (USD)";"-";"-";"-";"-";"-";"-";"-";"-";"-";"-";"-";"-";"4 072,80";"-27,50000%";"-11,98";"0,00";"-";"-";"-";"-";"-";"-";"-";"-";"-";"-";"-";"-";"-";"-";"-";"-";"-";"-"
"10 Wrz 2024 23:02:00";"Koszty Utrzymania Pozycji";"O2-D4-96156D";"-";"-";"Solana (USD)";"-";"-";"-";"-";"-";"-";"-";"-";"-";"-";"-";"-";"3 326,12";"-27,50000%";"-9,78";"0,00";"-";"-";"-";"-";"-";"-";"-";"-";"-";"-";"-";"-";"-";"-";"-";"-";"-";"-"
"10 Wrz 2024 23:02:00";"Koszty Utrzymania Pozycji";"O2-D5-97FD8D";"-";"-";"Solana (USD)";"-";"-";"-";"-";"-";"-";"-";"-";"-";"-";"-";"-";"6 788,00";"-10,00000%";"7,19";"0,00";"-";"-";"-";"-";"-";"-";"-";"-";"-";"-";"-";"-";"-";"-";"-";"-";"-";"-"
"10 Wrz 2024 23:02:00";"Koszty Utrzymania Pozycji";"O2-D4-95K8MW";"-";"-";"Solana (USD)";"-";"-";"-";"-";"-";"-";"-";"-";"-";"-";"-";"-";"6 788,00";"-10,00000%";"7,19";"0,00";"-";"-";"-";"-";"-";"-";"-";"-";"-";"-";"-";"-";"-";"-";"-";"-";"-";"-"
"10 Wrz 2024 23:02:00";"Koszty Utrzymania Pozycji";"O2-D5-96WE65";"-";"-";"Solana (USD)";"-";"-";"-";"-";"-";"-";"-";"-";"-";"-";"-";"-";"6 516,48";"-27,50000%";"-19,17";"0,00";"-";"-";"-";"-";"-";"-";"-";"-";"-";"-";"-";"-";"-";"-";"-";"-";"-";"-"
"10 Wrz 2024 23:02:00";"Koszty Utrzymania Pozycji";"O2-D3-94JY88";"-";"-";"Solana (USD)";"-";"-";"-";"-";"-";"-";"-";"-";"-";"-";"-";"-";"3 394,00";"-27,50000%";"-9,98";"0,00";"-";"-";"-";"-";"-";"-";"-";"-";"-";"-";"-";"-";"-";"-";"-";"-";"-";"-"
"10 Wrz 2024 23:02:00";"Koszty Utrzymania Pozycji";"O2-D6-97M8KS";"-";"-";"Solana (USD)";"-";"-";"-";"-";"-";"-";"-";"-";"-";"-";"-";"-";"9 503,20";"-27,50000%";"-27,95";"0,00";"-";"-";"-";"-";"-";"-";"-";"-";"-";"-";"-";"-";"-";"-";"-";"-";"-";"-"
"10 Wrz 2024 23:02:00";"Koszty Utrzymania Pozycji";"O2-D6-97JRN1";"-";"-";"Solana (USD)";"-";"-";"-";"-";"-";"-";"-";"-";"-";"-";"-";"-";"8 661,48";"-10,00000%";"9,17";"0,00";"-";"-";"-";"-";"-";"-";"-";"-";"-";"-";"-";"-";"-";"-";"-";"-";"-";"-"
"10 Wrz 2024 23:02:00";"Koszty Utrzymania Pozycji";"O2-D5-977RC9";"-";"-";"Solana (USD)";"-";"-";"-";"-";"-";"-";"-";"-";"-";"-";"-";"-";"8 824,40";"-10,00000%";"9,34";"0,00";"-";"-";"-";"-";"-";"-";"-";"-";"-";"-";"-";"-";"-";"-";"-";"-";"-";"-"
"10 Wrz 2024 23:02:00";"Koszty Utrzymania Pozycji";"O2-D6-97ME22";"-";"-";"Solana (USD)";"-";"-";"-";"-";"-";"-";"-";"-";"-";"-";"-";"-";"6 788,00";"-10,00000%";"7,19";"0,00";"-";"-";"-";"-";"-";"-";"-";"-";"-";"-";"-";"-";"-";"-";"-";"-";"-";"-"
"10 Wrz 2024 23:02:00";"Koszty Utrzymania Pozycji";"O2-D6-97M6H8";"-";"-";"Solana (USD)";"-";"-";"-";"-";"-";"-";"-";"-";"-";"-";"-";"-";"11 268,08";"-27,50000%";"-33,14";"0,00";"-";"-";"-";"-";"-";"-";"-";"-";"-";"-";"-";"-";"-";"-";"-";"-";"-";"-"
"10 Wrz 2024 22:57:05";"Zmodyfikowano Transakcję Sprzedaży";"O2-D6-97ME22";"T2-D6-5L2KCH";"-";"Solana (USD)";"50 Jednost.";"135,705";"-";"-";"-";"-";"-";"-";"0,00";"-";"-";"-";"-";"-";"-";"-";"-";"-";"-";"-";"-";"-";"-";"-";"-";"-";"-";"-";"-";"-";"-";"-";"-";"-"
"10 Wrz 2024 22:56:56";"Transakcja Sprzedaży";"O2-D6-97ME22";"T2-D6-5L2KCH";"-";"Solana (USD)";"50 Jednost.";"135,705";"-";"138,419";"-";"-";"3,903942";"26 489,22";"0,00";"-";"-";"-";"-";"-";"-";"-";"-";"-";"-";"-";"-";"-";"-";"-";"-";"-";"-";"-";"-";"-";"-";"-";"-";"-"
"10 Wrz 2024 21:02:49";" Zmodyfikowano Transakcję Kupna";"O2-D6-97M8KS";"T2-D6-5L2GFF";"-";"Solana (USD)";"70 Jednost.";"136,537";"-";"-";"-";"-";"-";"-";"0,00";"-";"-";"-";"-";"-";"-";"-";"-";"-";"-";"-";"-";"-";"-";"-";"-";"-";"-";"-";"-";"-";"-";"-";"-";"-"
"10 Wrz 2024 21:02:38";" Transakcja Kupna";"O2-D6-97M8KS";"T2-D6-5L2GFF";"-";"Solana (USD)";"70 Jednost.";"136,537";"-";"133,807";"-";"-";"3,90308";"37 304,03";"0,00";"-";"-";"-";"-";"-";"-";"-";"-";"-";"-";"-";"-";"-";"-";"-";"-";"-";"-";"-";"-";"-";"-";"-";"-";"-"
"10 Wrz 2024 20:55:53";" Zamknięcie Transakcji";"O2-D6-97M7RC";"T2-D6-5L2G6K";"O2-D6-97JWF8";"Solana (USD)";"11 Jednost.";"137,125";"-";"-";"-";"-";"3,86321";"5 885,73";"78,40";"40 104,70";"-";"-";"-";"-";"-";"-";"-";"-";"-";"-";"-";"-";"-";"-";"-";"-";"-";"-";"-";"-";"-";"-";"-";"-"
"10 Wrz 2024 20:48:54";" Zamknięcie Transakcji";"O2-D6-97M78J";"T2-D6-5L2FZ9";"O2-D6-97J69R";"Solana (USD)";"70 Jednost.";"137,205";"-";"-";"-";"-";"3,86436";"37 487,60";"431,19";"40 026,30";"-";"-";"-";"-";"-";"-";"-";"-";"-";"-";"-";"-";"-";"-";"-";"-";"-";"-";"-";"-";"-";"-";"-";"-"
"10 Wrz 2024 20:41:45";" Zmodyfikowano Transakcję Kupna";"O2-D6-97M6H8";"T2-D6-5L2FQX";"-";"Solana (USD)";"83 Jednost.";"137,705";"-";"-";"-";"-";"-";"-";"0,00";"-";"-";"-";"-";"-";"-";"-";"-";"-";"-";"-";"-";"-";"-";"-";"-";"-";"-";"-";"-";"-";"-";"-";"-";"-"
"10 Wrz 2024 20:41:34";" Transakcja Kupna";"O2-D6-97M6H8";"T2-D6-5L2FQX";"-";"Solana (USD)";"83 Jednost.";"137,705";"-";"134,951";"-";"-";"3,902359";"44 602,07";"0,00";"-";"-";"-";"-";"-";"-";"-";"-";"-";"-";"-";"-";"-";"-";"-";"-";"-";"-";"-";"-";"-";"-";"-";"-";"-"
"10 Wrz 2024 20:06:46";" Zamknięcie Transakcji";"O2-D6-97M2G4";"T2-D6-5L2E5Z";"O2-D6-97J69R";"Solana (USD)";"2,73 Jednost.";"135,995";"-";"-";"-";"-";"3,86449";"1 449,17";"4,05";"39 595,11";"-";"-";"-";"-";"-";"-";"-";"-";"-";"-";"-";"-";"-";"-";"-";"-";"-";"-";"-";"-";"-";"-";"-";"-"
"10 Wrz 2024 19:14:27";" Zamknięcie Transakcji";"O2-D6-97LQEC";"T2-D6-5L2C0H";"O2-D6-97LFSX";"Solana (USD)";"83 Jednost.";"136,314";"-";"-";"-";"-";"3,86383";"44 154,92";"86,27";"39 591,06";"-";"-";"-";"-";"-";"-";"-";"-";"-";"-";"-";"-";"-";"-";"-";"-";"-";"-";"-";"-";"-";"-";"-";"-"
"10 Wrz 2024 18:13:56";" Zamknięcie Transakcji";"O2-D6-97LLQG";"T2-D6-5L27XB";"O2-D6-97K13Q";"Solana (USD)";"11 Jednost.";"133,995";"-";"-";"-";"-";"3,86515";"5 754,26";"8,25";"39 504,79";"-";"-";"-";"-";"-";"-";"-";"-";"-";"-";"-";"-";"-";"-";"-";"-";"-";"-";"-";"-";"-";"-";"-";"-"
"10 Wrz 2024 17:28:48";" Zmodyfikowano Transakcję Kupna";"O2-D6-97LFSX";"T2-D6-5L23H5";"-";"Solana (USD)";"83 Jednost.";"136,045";"-";"-";"-";"-";"-";"-";"0,00";"-";"-";"-";"-";"-";"-";"-";"-";"-";"-";"-";"-";"-";"-";"-";"-";"-";"-";"-";"-";"-";"-";"-";"-";"-"
"10 Wrz 2024 17:28:28";" Transakcja Kupna";"O2-D6-97LFSX";"T2-D6-5L23H5";"-";"Solana (USD)";"83 Jednost.";"136,045";"-";"133,325";"-";"-";"3,903341";"44 075,49";"0,00";"-";"-";"-";"-";"-";"-";"-";"-";"-";"-";"-";"-";"-";"-";"-";"-";"-";"-";"-";"-";"-";"-";"-";"-";"-"
"10 Wrz 2024 14:06:49";" Zamknięcie Transakcji";"O2-D6-97KE1S";"T2-D6-5L1G8B";"O2-D6-97JWF8";"Solana (USD)";"20 Jednost.";"135,298";"-";"-";"-";"-";"3,8626";"10 557,07";"1,39";"39 496,54";"-";"-";"-";"-";"-";"-";"-";"-";"-";"-";"-";"-";"-";"-";"-";"-";"-";"-";"-";"-";"-";"-";"-";"-"
"10 Wrz 2024 11:03:55";"Zmodyfikowano Transakcję Sprzedaży";"O2-D6-97K13Q";"T2-D6-5L1794";"-";"Solana (USD)";"31 Jednost.";"134,189";"-";"-";"-";"-";"-";"-";"0,00";"-";"-";"-";"-";"-";"-";"-";"-";"-";"-";"-";"-";"-";"-";"-";"-";"-";"-";"-";"-";"-";"-";"-";"-";"-"
"10 Wrz 2024 11:03:28";"Transakcja Sprzedaży";"O2-D6-97K13Q";"T2-D6-5L1794";"-";"Solana (USD)";"31 Jednost.";"134,189";"-";"136,872";"-";"-";"3,901136";"16 228,17";"0,00";"-";"-";"-";"-";"-";"-";"-";"-";"-";"-";"-";"-";"-";"-";"-";"-";"-";"-";"-";"-";"-";"-";"-";"-";"-"
"10 Wrz 2024 09:48:51";" Zmodyfikowano Transakcję Kupna";"O2-D6-97JWF8";"T2-D6-5L13W8";"-";"Solana (USD)";"31 Jednost.";"135,280";"-";"-";"-";"-";"-";"-";"0,00";"-";"-";"-";"-";"-";"-";"-";"-";"-";"-";"-";"-";"-";"-";"-";"-";"-";"-";"-";"-";"-";"-";"-";"-";"-"
"10 Wrz 2024 09:48:41";" Transakcja Kupna";"O2-D6-97JWF8";"T2-D6-5L13W8";"-";"Solana (USD)";"31 Jednost.";"135,280";"-";"132,575";"-";"-";"3,890164";"16 314,10";"0,00";"-";"-";"-";"-";"-";"-";"-";"-";"-";"-";"-";"-";"-";"-";"-";"-";"-";"-";"-";"-";"-";"-";"-";"-";"-"
"10 Wrz 2024 09:06:07";"Zmodyfikowano Transakcję Sprzedaży";"O2-D6-97JRN1";"T2-D6-5L11XF";"-";"Solana (USD)";"63,8 Jednost.";"133,680";"-";"-";"-";"-";"-";"-";"0,00";"-";"-";"-";"-";"-";"-";"-";"-";"-";"-";"-";"-";"-";"-";"-";"-";"-";"-";"-";"-";"-";"-";"-";"-";"-"
"10 Wrz 2024 09:05:58";"Transakcja Sprzedaży";"O2-D6-97JRN1";"T2-D6-5L11XF";"-";"Solana (USD)";"63,8 Jednost.";"133,680";"-";"136,353";"-";"-";"3,892309";"33 196,66";"0,00";"-";"-";"-";"-";"-";"-";"-";"-";"-";"-";"-";"-";"-";"-";"-";"-";"-";"-";"-";"-";"-";"-";"-";"-";"-"
"10 Wrz 2024 08:59:19";" Zamknięcie Transakcji";"O2-D6-97JQQG";"T2-D6-5L11HJ";"O2-D6-97J6BZ";"Solana (USD)";"31,5 Jednost.";"133,997";"-";"-";"-";"-";"3,85192";"16 421,96";"61,64";"39 495,15";"-";"-";"-";"-";"-";"-";"-";"-";"-";"-";"-";"-";"-";"-";"-";"-";"-";"-";"-";"-";"-";"-";"-";"-"
"09 Wrz 2024 23:45:36";"Zmodyfikowano Transakcję Sprzedaży";"O2-D6-97J6BZ";"T2-D6-5L0QV9";"-";"Solana (USD)";"31,5 Jednost.";"134,505";"-";"-";"-";"-";"-";"-";"0,00";"-";"-";"-";"-";"-";"-";"-";"-";"-";"-";"-";"-";"-";"-";"-";"-";"-";"-";"-";"-";"-";"-";"-";"-";"-"
"09 Wrz 2024 23:45:23";"Transakcja Sprzedaży";"O2-D6-97J6BZ";"T2-D6-5L0QV9";"-";"Solana (USD)";"31,5 Jednost.";"134,505";"-";"137,195";"-";"-";"3,894503";"16 500,64";"0,00";"-";"-";"-";"-";"-";"-";"-";"-";"-";"-";"-";"-";"-";"-";"-";"-";"-";"-";"-";"-";"-";"-";"-";"-";"-"
"09 Wrz 2024 23:34:36";" Zmodyfikowano Transakcję Kupna";"O2-D6-97J69R";"T2-D6-5L0QV2";"-";"Solana (USD)";"72,73 Jednost.";"135,611";"-";"-";"-";"-";"-";"-";"0,00";"-";"-";"-";"-";"-";"-";"-";"-";"-";"-";"-";"-";"-";"-";"-";"-";"-";"-";"-";"-";"-";"-";"-";"-";"-"
"09 Wrz 2024 23:34:20";" Transakcja Kupna";"O2-D6-97J69R";"T2-D6-5L0QV2";"-";"Solana (USD)";"72,73 Jednost.";"135,611";"-";"132,859";"-";"-";"3,894713";"38 413,50";"0,00";"-";"-";"-";"-";"-";"-";"-";"-";"-";"-";"-";"-";"-";"-";"-";"-";"-";"-";"-";"-";"-";"-";"-";"-";"-"
"09 Wrz 2024 23:02:12";"Koszty Utrzymania Pozycji";"1371853703";"-";"-";"Rachunek";"-";"-";"-";"-";"-";"-";"-";"-";"-53,34";"39 433,51";"-";"-";"-";"-";"-";"-53,34";"-";"-";"-";"-";"-";"-";"-";"-";"-";"-";"-";"-";"-";"-";"-";"-";"-";"-"
"09 Wrz 2024 23:02:12";"Koszty Utrzymania Pozycji";"O2-D5-97BZ7D";"-";"-";"Solana (USD)";"-";"-";"-";"-";"-";"-";"-";"-";"-";"-";"-";"-";"4 040,55";"-10,00000%";"4,27";"0,00";"-";"-";"-";"-";"-";"-";"-";"-";"-";"-";"-";"-";"-";"-";"-";"-";"-";"-"
"09 Wrz 2024 23:02:12";"Koszty Utrzymania Pozycji";"O2-D5-977ENK";"-";"-";"Solana (USD)";"-";"-";"-";"-";"-";"-";"-";"-";"-";"-";"-";"-";"4 040,55";"-10,00000%";"4,27";"0,00";"-";"-";"-";"-";"-";"-";"-";"-";"-";"-";"-";"-";"-";"-";"-";"-";"-";"-"
"09 Wrz 2024 23:02:12";"Koszty Utrzymania Pozycji";"O2-D4-95TL4Z";"-";"-";"Solana (USD)";"-";"-";"-";"-";"-";"-";"-";"-";"-";"-";"-";"-";"3 030,41";"-27,50000%";"-8,89";"0,00";"-";"-";"-";"-";"-";"-";"-";"-";"-";"-";"-";"-";"-";"-";"-";"-";"-";"-"
"09 Wrz 2024 23:02:12";"Koszty Utrzymania Pozycji";"O2-D5-97FGFP";"-";"-";"Solana (USD)";"-";"-";"-";"-";"-";"-";"-";"-";"-";"-";"-";"-";"6 734,25";"-10,00000%";"7,11";"0,00";"-";"-";"-";"-";"-";"-";"-";"-";"-";"-";"-";"-";"-";"-";"-";"-";"-";"-"
"09 Wrz 2024 23:02:12";"Koszty Utrzymania Pozycji";"O2-D5-96SWM1";"-";"-";"Solana (USD)";"-";"-";"-";"-";"-";"-";"-";"-";"-";"-";"-";"-";"11 313,54";"-27,50000%";"-33,19";"0,00";"-";"-";"-";"-";"-";"-";"-";"-";"-";"-";"-";"-";"-";"-";"-";"-";"-";"-"
"09 Wrz 2024 23:02:12";"Koszty Utrzymania Pozycji";"O2-D4-95EL0T";"-";"-";"Solana (USD)";"-";"-";"-";"-";"-";"-";"-";"-";"-";"-";"-";"-";"4 040,55";"-27,50000%";"-11,85";"0,00";"-";"-";"-";"-";"-";"-";"-";"-";"-";"-";"-";"-";"-";"-";"-";"-";"-";"-"
"09 Wrz 2024 23:02:12";"Koszty Utrzymania Pozycji";"O2-D4-96156D";"-";"-";"Solana (USD)";"-";"-";"-";"-";"-";"-";"-";"-";"-";"-";"-";"-";"3 299,78";"-27,50000%";"-9,68";"0,00";"-";"-";"-";"-";"-";"-";"-";"-";"-";"-";"-";"-";"-";"-";"-";"-";"-";"-"
"09 Wrz 2024 23:02:12";"Koszty Utrzymania Pozycji";"O2-D5-97FD8D";"-";"-";"Solana (USD)";"-";"-";"-";"-";"-";"-";"-";"-";"-";"-";"-";"-";"6 734,25";"-10,00000%";"7,11";"0,00";"-";"-";"-";"-";"-";"-";"-";"-";"-";"-";"-";"-";"-";"-";"-";"-";"-";"-"
"09 Wrz 2024 23:02:12";"Koszty Utrzymania Pozycji";"O2-D4-95K8MW";"-";"-";"Solana (USD)";"-";"-";"-";"-";"-";"-";"-";"-";"-";"-";"-";"-";"6 734,25";"-10,00000%";"7,11";"0,00";"-";"-";"-";"-";"-";"-";"-";"-";"-";"-";"-";"-";"-";"-";"-";"-";"-";"-"
"09 Wrz 2024 23:02:12";"Koszty Utrzymania Pozycji";"O2-D5-96WE65";"-";"-";"Solana (USD)";"-";"-";"-";"-";"-";"-";"-";"-";"-";"-";"-";"-";"6 464,88";"-27,50000%";"-18,97";"0,00";"-";"-";"-";"-";"-";"-";"-";"-";"-";"-";"-";"-";"-";"-";"-";"-";"-";"-"
"09 Wrz 2024 23:02:12";"Koszty Utrzymania Pozycji";"O2-D3-94JY88";"-";"-";"Solana (USD)";"-";"-";"-";"-";"-";"-";"-";"-";"-";"-";"-";"-";"3 367,12";"-27,50000%";"-9,88";"0,00";"-";"-";"-";"-";"-";"-";"-";"-";"-";"-";"-";"-";"-";"-";"-";"-";"-";"-"
"09 Wrz 2024 23:02:12";"Koszty Utrzymania Pozycji";"O2-D5-977RC9";"-";"-";"Solana (USD)";"-";"-";"-";"-";"-";"-";"-";"-";"-";"-";"-";"-";"8 754,52";"-10,00000%";"9,25";"0,00";"-";"-";"-";"-";"-";"-";"-";"-";"-";"-";"-";"-";"-";"-";"-";"-";"-";"-"
"09 Wrz 2024 18:13:26";" Zamknięcie Transakcji";"O2-D6-97HLYJ";"T2-D6-5L0DN5";"O2-D5-97C0HJ";"Solana (USD)";"10 Jednost.";"130,257";"-";"-";"-";"-";"3,85284";"5 069,02";"2,58";"39 486,85";"-";"-";"-";"-";"-";"-";"-";"-";"-";"-";"-";"-";"-";"-";"-";"-";"-";"-";"-";"-";"-";"-";"-";"-"
"09 Wrz 2024 18:11:22";"Take Profit";"O2-D6-97HETC";"T2-D6-5L0DJN";"-";"Solana (USD)";"85 Jednost.";"129,300";"-";"-";"-";"-";"3,85302";"42 772,25";"324,56";"39 484,27";"-";"-";"-";"-";"-";"-";"-";"-";"-";"-";"-";"-";"-";"-";"-";"-";"-";"-";"-";"-";"-";"-";"-";"-"
"09 Wrz 2024 18:06:26";" Zmodyfikowano Transakcję Kupna";"O2-D6-97HETC";"T2-D6-5L07RG";"-";"Solana (USD)";"85 Jednost.";"128,309";"-";"125,600";"129,300";"-";"-";"-";"0,00";"-";"-";"-";"-";"-";"-";"-";"-";"-";"-";"-";"-";"-";"-";"-";"-";"-";"-";"-";"-";"-";"-";"-";"-";"-"
"09 Wrz 2024 17:49:19";" Zmodyfikowano Transakcję Kupna";"O2-D6-97HETC";"T2-D6-5L07RG";"-";"Solana (USD)";"85 Jednost.";"128,309";"-";"-";"129,300";"-";"-";"-";"0,00";"-";"-";"-";"-";"-";"-";"-";"-";"-";"-";"-";"-";"-";"-";"-";"-";"-";"-";"-";"-";"-";"-";"-";"-";"-"
"09 Wrz 2024 17:15:08";" Zamknięcie Transakcji";"O2-D6-97HFS4";"T2-D6-5L08F6";"O2-D5-977RC9";"Solana (USD)";"5 Jednost.";"127,537";"-";"-";"-";"-";"3,85504";"2 483,01";"13,94";"39 159,71";"-";"-";"-";"-";"-";"-";"-";"-";"-";"-";"-";"-";"-";"-";"-";"-";"-";"-";"-";"-";"-";"-";"-";"-"
"09 Wrz 2024 17:11:53";" Zamknięcie Transakcji";"O2-D6-97HF7W";"T2-D6-5L0849";"O2-D5-977RC9";"Solana (USD)";"10 Jednost.";"128,021";"-";"-";"-";"-";"3,854";"4 983,52";"9,21";"39 145,77";"-";"-";"-";"-";"-";"-";"-";"-";"-";"-";"-";"-";"-";"-";"-";"-";"-";"-";"-";"-";"-";"-";"-";"-"
"09 Wrz 2024 17:07:19";" Zmodyfikowano Transakcję Kupna";"O2-D6-97HETC";"T2-D6-5L07RG";"-";"Solana (USD)";"85 Jednost.";"128,309";"-";"-";"-";"-";"-";"-";"0,00";"-";"-";"-";"-";"-";"-";"-";"-";"-";"-";"-";"-";"-";"-";"-";"-";"-";"-";"-";"-";"-";"-";"-";"-";"-"
"09 Wrz 2024 17:07:06";" Transakcja Kupna";"O2-D6-97HETC";"T2-D6-5L07RG";"-";"Solana (USD)";"85 Jednost.";"128,309";"-";"125,724";"-";"-";"3,893281";"42 461,15";"0,00";"-";"-";"-";"-";"-";"-";"-";"-";"-";"-";"-";"-";"-";"-";"-";"-";"-";"-";"-";"-";"-";"-";"-";"-";"-"
"09 Wrz 2024 00:05:09";" Zamknięcie Transakcji";"O2-D6-97FL2Q";"T2-D6-5KZ1N5";"O2-D5-97EW82";"Solana (USD)";"7 Jednost.";"129,304";"-";"-";"-";"-";"3,84189";"3 512,35";"38,78";"39 136,56";"-";"-";"-";"-";"-";"-";"-";"-";"-";"-";"-";"-";"-";"-";"-";"-";"-";"-";"-";"-";"-";"-";"-";"-"
"06 Wrz 2024 23:00:46";"Koszty Utrzymania Pozycji";"1371386006";"-";"-";"Rachunek";"-";"-";"-";"-";"-";"-";"-";"-";"-160,87";"39 097,78";"-";"-";"-";"-";"-";"-160,87";"-";"-";"-";"-";"-";"-";"-";"-";"-";"-";"-";"-";"-";"-";"-";"-";"-";"-"
"06 Wrz 2024 23:00:46";"Koszty Utrzymania Pozycji";"O2-D5-97C0HJ";"-";"-";"Solana (USD)";"-";"-";"-";"-";"-";"-";"-";"-";"-";"-";"-";"-";"1 250,50";"-27,50000%";"-10,97";"-10,97";"-";"-";"-";"-";"-";"-";"-";"-";"-";"-";"-";"-";"-";"-";"-";"-";"-";"-"
"06 Wrz 2024 23:00:46";"Koszty Utrzymania Pozycji";"O2-D5-97BZ7D";"-";"-";"Solana (USD)";"-";"-";"-";"-";"-";"-";"-";"-";"-";"-";"-";"-";"3 751,50";"-10,00000%";"11,85";"11,85";"-";"-";"-";"-";"-";"-";"-";"-";"-";"-";"-";"-";"-";"-";"-";"-";"-";"-"
"06 Wrz 2024 23:00:46";"Koszty Utrzymania Pozycji";"O2-D5-977ENK";"-";"-";"Solana (USD)";"-";"-";"-";"-";"-";"-";"-";"-";"-";"-";"-";"-";"3 751,50";"-10,00000%";"11,85";"11,85";"-";"-";"-";"-";"-";"-";"-";"-";"-";"-";"-";"-";"-";"-";"-";"-";"-";"-"
"06 Wrz 2024 23:00:46";"Koszty Utrzymania Pozycji";"O2-D4-95K8MW";"-";"-";"Solana (USD)";"-";"-";"-";"-";"-";"-";"-";"-";"-";"-";"-";"-";"6 252,50";"-10,00000%";"19,75";"19,75";"-";"-";"-";"-";"-";"-";"-";"-";"-";"-";"-";"-";"-";"-";"-";"-";"-";"-"
"06 Wrz 2024 23:00:46";"Koszty Utrzymania Pozycji";"O2-D5-96SWM1";"-";"-";"Solana (USD)";"-";"-";"-";"-";"-";"-";"-";"-";"-";"-";"-";"-";"10 504,20";"-27,50000%";"-92,18";"-92,18";"-";"-";"-";"-";"-";"-";"-";"-";"-";"-";"-";"-";"-";"-";"-";"-";"-";"-"
"06 Wrz 2024 23:00:46";"Koszty Utrzymania Pozycji";"O2-D5-977RC9";"-";"-";"Solana (USD)";"-";"-";"-";"-";"-";"-";"-";"-";"-";"-";"-";"-";"10 004,00";"-10,00000%";"31,60";"31,60";"-";"-";"-";"-";"-";"-";"-";"-";"-";"-";"-";"-";"-";"-";"-";"-";"-";"-"
"06 Wrz 2024 23:00:46";"Koszty Utrzymania Pozycji";"O2-D4-95TL4Z";"-";"-";"Solana (USD)";"-";"-";"-";"-";"-";"-";"-";"-";"-";"-";"-";"-";"2 813,62";"-27,50000%";"-24,69";"-24,69";"-";"-";"-";"-";"-";"-";"-";"-";"-";"-";"-";"-";"-";"-";"-";"-";"-";"-"
"06 Wrz 2024 23:00:46";"Koszty Utrzymania Pozycji";"O2-D3-94JY88";"-";"-";"Solana (USD)";"-";"-";"-";"-";"-";"-";"-";"-";"-";"-";"-";"-";"3 126,25";"-27,50000%";"-27,43";"-27,43";"-";"-";"-";"-";"-";"-";"-";"-";"-";"-";"-";"-";"-";"-";"-";"-";"-";"-"
"06 Wrz 2024 23:00:46";"Koszty Utrzymania Pozycji";"O2-D5-97EW82";"-";"-";"Solana (USD)";"-";"-";"-";"-";"-";"-";"-";"-";"-";"-";"-";"-";"875,35";"-27,50000%";"-7,68";"-7,68";"-";"-";"-";"-";"-";"-";"-";"-";"-";"-";"-";"-";"-";"-";"-";"-";"-";"-"
"06 Wrz 2024 23:00:46";"Koszty Utrzymania Pozycji";"O2-D5-96WE65";"-";"-";"Solana (USD)";"-";"-";"-";"-";"-";"-";"-";"-";"-";"-";"-";"-";"6 002,40";"-27,50000%";"-52,67";"-52,67";"-";"-";"-";"-";"-";"-";"-";"-";"-";"-";"-";"-";"-";"-";"-";"-";"-";"-"
"06 Wrz 2024 23:00:46";"Koszty Utrzymania Pozycji";"O2-D5-97FD8D";"-";"-";"Solana (USD)";"-";"-";"-";"-";"-";"-";"-";"-";"-";"-";"-";"-";"6 252,50";"-10,00000%";"19,75";"19,75";"-";"-";"-";"-";"-";"-";"-";"-";"-";"-";"-";"-";"-";"-";"-";"-";"-";"-"
"06 Wrz 2024 23:00:46";"Koszty Utrzymania Pozycji";"O2-D4-96156D";"-";"-";"Solana (USD)";"-";"-";"-";"-";"-";"-";"-";"-";"-";"-";"-";"-";"3 063,72";"-27,50000%";"-26,88";"-26,88";"-";"-";"-";"-";"-";"-";"-";"-";"-";"-";"-";"-";"-";"-";"-";"-";"-";"-"
"06 Wrz 2024 23:00:46";"Koszty Utrzymania Pozycji";"O2-D5-97FGFP";"-";"-";"Solana (USD)";"-";"-";"-";"-";"-";"-";"-";"-";"-";"-";"-";"-";"6 252,50";"-10,00000%";"19,75";"19,75";"-";"-";"-";"-";"-";"-";"-";"-";"-";"-";"-";"-";"-";"-";"-";"-";"-";"-"
"06 Wrz 2024 23:00:46";"Koszty Utrzymania Pozycji";"O2-D4-95EL0T";"-";"-";"Solana (USD)";"-";"-";"-";"-";"-";"-";"-";"-";"-";"-";"-";"-";"3 751,50";"-27,50000%";"-32,92";"-32,92";"-";"-";"-";"-";"-";"-";"-";"-";"-";"-";"-";"-";"-";"-";"-";"-";"-";"-"
"06 Wrz 2024 21:59:15";" Zmodyfikowano Transakcję Kupna";"O2-D5-97EW82";"T2-D5-5KYESV";"-";"Solana (USD)";"7 Jednost.";"127,862";"-";"-";"-";"-";"-";"-";"0,00";"-";"-";"-";"-";"-";"-";"-";"-";"-";"-";"-";"-";"-";"-";"-";"-";"-";"-";"-";"-";"-";"-";"-";"-";"-"
"06 Wrz 2024 21:59:08";"Zmodyfikowano Transakcję Sprzedaży";"O2-D5-97FGFP";"T2-D5-5KYZ3Y";"-";"Solana (USD)";"50 Jednost.";"125,091";"-";"-";"-";"-";"-";"-";"0,00";"-";"-";"-";"-";"-";"-";"-";"-";"-";"-";"-";"-";"-";"-";"-";"-";"-";"-";"-";"-";"-";"-";"-";"-";"-"
"06 Wrz 2024 21:58:59";"Transakcja Sprzedaży";"O2-D5-97FGFP";"T2-D5-5KYZ3Y";"-";"Solana (USD)";"50 Jednost.";"125,091";"-";"127,592";"-";"-";"3,881808";"24 278,96";"0,00";"-";"-";"-";"-";"-";"-";"-";"-";"-";"-";"-";"-";"-";"-";"-";"-";"-";"-";"-";"-";"-";"-";"-";"-";"-"
"06 Wrz 2024 21:20:34";" Zamknięcie Transakcji";"O2-D5-97FEKL";"T2-D5-5KYX7V";"O2-D5-97FD0S";"Solana (USD)";"50 Jednost.";"125,000";"-";"-";"-";"-";"3,84394";"24 266,05";"57,66";"39 258,65";"-";"-";"-";"-";"-";"-";"-";"-";"-";"-";"-";"-";"-";"-";"-";"-";"-";"-";"-";"-";"-";"-";"-";"-"
"06 Wrz 2024 20:53:35";"Zmodyfikowano Transakcję Sprzedaży";"O2-D5-97FD8D";"T2-D5-5KYVZM";"-";"Solana (USD)";"50 Jednost.";"125,530";"-";"-";"-";"-";"-";"-";"0,00";"-";"-";"-";"-";"-";"-";"-";"-";"-";"-";"-";"-";"-";"-";"-";"-";"-";"-";"-";"-";"-";"-";"-";"-";"-"
"06 Wrz 2024 20:53:24";"Transakcja Sprzedaży";"O2-D5-97FD8D";"T2-D5-5KYVZM";"-";"Solana (USD)";"50 Jednost.";"125,530";"-";"128,040";"-";"-";"3,88304";"24 371,90";"0,00";"-";"-";"-";"-";"-";"-";"-";"-";"-";"-";"-";"-";"-";"-";"-";"-";"-";"-";"-";"-";"-";"-";"-";"-";"-"
"06 Wrz 2024 20:45:53";"Zmodyfikowano Transakcję Sprzedaży";"O2-D5-97FD0S";"T2-D5-5KYVRV";"-";"Solana (USD)";"50 Jednost.";"125,300";"-";"-";"-";"-";"-";"-";"0,00";"-";"-";"-";"-";"-";"-";"-";"-";"-";"-";"-";"-";"-";"-";"-";"-";"-";"-";"-";"-";"-";"-";"-";"-";"-"
"06 Wrz 2024 20:45:43";"Transakcja Sprzedaży";"O2-D5-97FD0S";"T2-D5-5KYVRV";"-";"Solana (USD)";"50 Jednost.";"125,300";"-";"127,811";"-";"-";"3,88288";"24 326,24";"0,00";"-";"-";"-";"-";"-";"-";"-";"-";"-";"-";"-";"-";"-";"-";"-";"-";"-";"-";"-";"-";"-";"-";"-";"-";"-"
"06 Wrz 2024 20:09:43";" Zmodyfikowano Transakcję Kupna";"O2-D5-97EW82";"T2-D5-5KYESV";"-";"Solana (USD)";"7 Jednost.";"127,862";"-";"-";"128,000";"-";"-";"-";"0,00";"-";"-";"-";"-";"-";"-";"-";"-";"-";"-";"-";"-";"-";"-";"-";"-";"-";"-";"-";"-";"-";"-";"-";"-";"-"
"06 Wrz 2024 19:49:33";" Zamknięcie Transakcji";"O2-D5-97F9L7";"T2-D5-5KYSNL";"O2-D5-977RC9";"Solana (USD)";"9,5 Jednost.";"126,305";"-";"-";"-";"-";"3,84268";"4 657,17";"71,37";"39 200,99";"-";"-";"-";"-";"-";"-";"-";"-";"-";"-";"-";"-";"-";"-";"-";"-";"-";"-";"-";"-";"-";"-";"-";"-"
"06 Wrz 2024 19:37:32";"Stop Loss";"O2-D5-97F6P9";"T2-D5-5KYS1T";"-";"Solana (USD)";"91,64 Jednost.";"125,915";"-";"-";"-";"-";"3,84336";"44 793,67";"144,05";"39 129,62";"-";"-";"-";"-";"-";"-";"-";"-";"-";"-";"-";"-";"-";"-";"-";"-";"-";"-";"-";"-";"-";"-";"-";"-"
"06 Wrz 2024 19:37:13";"Zmodyfikowano Transakcję Sprzedaży";"O2-D5-97F6P9";"T2-D5-5KYQ2Z";"-";"Solana (USD)";"91,64 Jednost.";"126,324";"-";"125,900";"-";"-";"-";"-";"0,00";"-";"-";"-";"-";"-";"-";"-";"-";"-";"-";"-";"-";"-";"-";"-";"-";"-";"-";"-";"-";"-";"-";"-";"-";"-"
"06 Wrz 2024 19:08:07";"Zmodyfikowano Transakcję Sprzedaży";"O2-D5-97F6P9";"T2-D5-5KYQ2Z";"-";"Solana (USD)";"91,64 Jednost.";"126,324";"-";"-";"-";"-";"-";"-";"0,00";"-";"-";"-";"-";"-";"-";"-";"-";"-";"-";"-";"-";"-";"-";"-";"-";"-";"-";"-";"-";"-";"-";"-";"-";"-"
"06 Wrz 2024 19:07:57";"Transakcja Sprzedaży";"O2-D5-97F6P9";"T2-D5-5KYQ2Z";"-";"Solana (USD)";"91,64 Jednost.";"126,324";"-";"128,850";"-";"-";"3,887299";"45 000,66";"0,00";"-";"-";"-";"-";"-";"-";"-";"-";"-";"-";"-";"-";"-";"-";"-";"-";"-";"-";"-";"-";"-";"-";"-";"-";"-"
"06 Wrz 2024 18:41:20";"Take Profit";"O2-D5-97EZGD";"T2-D5-5KYN7N";"-";"Solana (USD)";"92 Jednost.";"127,000";"-";"-";"-";"-";"3,84629";"45 391,80";"136,24";"38 985,57";"-";"-";"-";"-";"-";"-";"-";"-";"-";"-";"-";"-";"-";"-";"-";"-";"-";"-";"-";"-";"-";"-";"-";"-"
"06 Wrz 2024 17:53:23";"Zmodyfikowano Transakcję Sprzedaży";"O2-D5-97EZGD";"T2-D5-5KYHML";"-";"Solana (USD)";"92 Jednost.";"127,385";"-";"-";"127,000";"-";"-";"-";"0,00";"-";"-";"-";"-";"-";"-";"-";"-";"-";"-";"-";"-";"-";"-";"-";"-";"-";"-";"-";"-";"-";"-";"-";"-";"-"
"06 Wrz 2024 17:52:46";"Zmodyfikowano Transakcję Sprzedaży";"O2-D5-97EZGD";"T2-D5-5KYHML";"-";"Solana (USD)";"92 Jednost.";"127,385";"-";"-";"-";"-";"-";"-";"0,00";"-";"-";"-";"-";"-";"-";"-";"-";"-";"-";"-";"-";"-";"-";"-";"-";"-";"-";"-";"-";"-";"-";"-";"-";"-"
"06 Wrz 2024 17:52:35";"Transakcja Sprzedaży";"O2-D5-97EZGD";"T2-D5-5KYHML";"-";"Solana (USD)";"92 Jednost.";"127,385";"-";"129,932";"-";"-";"3,882419";"45 499,69";"0,00";"-";"-";"-";"-";"-";"-";"-";"-";"-";"-";"-";"-";"-";"-";"-";"-";"-";"-";"-";"-";"-";"-";"-";"-";"-"
"06 Wrz 2024 17:30:52";" Zamknięcie Transakcji";"O2-D5-97EWFQ";"T2-D5-5KYEZD";"O2-D5-977RC9";"Solana (USD)";"10 Jednost.";"127,875";"-";"-";"-";"-";"3,83682";"4 955,63";"14,77";"38 849,33";"-";"-";"-";"-";"-";"-";"-";"-";"-";"-";"-";"-";"-";"-";"-";"-";"-";"-";"-";"-";"-";"-";"-";"-"
"06 Wrz 2024 17:29:38";" Zmodyfikowano Transakcję Kupna";"O2-D5-97EW82";"T2-D5-5KYESV";"-";"Solana (USD)";"7 Jednost.";"127,862";"-";"-";"-";"-";"-";"-";"0,00";"-";"-";"-";"-";"-";"-";"-";"-";"-";"-";"-";"-";"-";"-";"-";"-";"-";"-";"-";"-";"-";"-";"-";"-";"-"
"06 Wrz 2024 17:29:28";" Transakcja Kupna";"O2-D5-97EW82";"T2-D5-5KYESV";"-";"Solana (USD)";"7 Jednost.";"127,862";"-";"125,303";"-";"-";"3,873631";"3 467,03";"0,00";"-";"-";"-";"-";"-";"-";"-";"-";"-";"-";"-";"-";"-";"-";"-";"-";"-";"-";"-";"-";"-";"-";"-";"-";"-"
"06 Wrz 2024 17:20:10";" Zamknięcie Transakcji";"O2-D5-97ETQK";"T2-D5-5KYDJ6";"O2-D5-97CH7Z";"Solana (USD)";"80 Jednost.";"127,700";"-";"-";"-";"-";"3,83728";"39 595,64";"151,96";"38 834,56";"-";"-";"-";"-";"-";"-";"-";"-";"-";"-";"-";"-";"-";"-";"-";"-";"-";"-";"-";"-";"-";"-";"-";"-"
"06 Wrz 2024 17:18:10";"Zmodyfikowano Transakcję Sprzedaży";"O2-D5-97CH7Z";"T2-D5-5KWGBR";"-";"Solana (USD)";"80 Jednost.";"128,195";"-";"-";"126,500";"-";"-";"-";"0,00";"-";"-";"-";"-";"-";"-";"-";"-";"-";"-";"-";"-";"-";"-";"-";"-";"-";"-";"-";"-";"-";"-";"-";"-";"-"
"06 Wrz 2024 15:08:58";" Zamknięcie Transakcji";"O2-D5-97DWZB";"T2-D5-5KXJHQ";"O2-D5-97C0HJ";"Solana (USD)";"6 Jednost.";"133,314";"-";"-";"-";"-";"3,82869";"3 093,27";"71,76";"38 682,60";"-";"-";"-";"-";"-";"-";"-";"-";"-";"-";"-";"-";"-";"-";"-";"-";"-";"-";"-";"-";"-";"-";"-";"-"
"06 Wrz 2024 12:33:04";"Stop Loss";"O2-D5-97CX13";"T2-D5-5KX51T";"-";"Solana (USD)";"60 Jednost.";"130,695";"-";"-";"-";"-";"3,82894";"30 327,06";"116,71";"38 610,84";"-";"-";"-";"-";"-";"-";"-";"-";"-";"-";"-";"-";"-";"-";"-";"-";"-";"-";"-";"-";"-";"-";"-";"-"
"06 Wrz 2024 12:32:18";"Zmodyfikowano Stop Loss";"O2-D5-97CX13";"-";"O2-D5-97DEL1";"Solana (USD)";"60 Jednost.";"130,187";"-";"130,700";"-";"-";"-";"-";"-";"-";"-";"-";"-";"-";"-";"-";"-";"-";"-";"-";"-";"-";"-";"-";"-";"-";"-";"-";"-";"-";"-";"-";"-";"-"
"06 Wrz 2024 12:31:36";" Zmodyfikowano Transakcję Kupna";"O2-D5-97CX13";"T2-D5-5KWRT9";"-";"Solana (USD)";"60 Jednost.";"130,187";"-";"130,500";"-";"-";"-";"-";"0,00";"-";"-";"-";"-";"-";"-";"-";"-";"-";"-";"-";"-";"-";"-";"-";"-";"-";"-";"-";"-";"-";"-";"-";"-";"-"
"06 Wrz 2024 11:02:21";"Zmodyfikowano Transakcję Sprzedaży";"O2-D5-97CH7Z";"T2-D5-5KWGBR";"-";"Solana (USD)";"80 Jednost.";"128,195";"-";"-";"-";"-";"-";"-";"0,00";"-";"-";"-";"-";"-";"-";"-";"-";"-";"-";"-";"-";"-";"-";"-";"-";"-";"-";"-";"-";"-";"-";"-";"-";"-"
"06 Wrz 2024 07:48:41";" Transakcja Kupna";"O2-D5-97CX13";"T2-D5-5KWRT9";"-";"Solana (USD)";"60 Jednost.";"130,187";"-";"-";"-";"-";"3,87314";"30 253,94";"0,00";"-";"-";"-";"-";"-";"-";"-";"-";"-";"-";"-";"-";"-";"-";"-";"-";"-";"-";"-";"-";"-";"-";"-";"-";"-"
"05 Wrz 2024 23:28:16";"Zmodyfikowano Take Profit";"O2-D5-97CH7Z";"-";"O2-D5-97CKNC";"Solana (USD)";"80 Jednost.";"128,195";"-";"-";"126,500";"-";"-";"-";"-";"-";"-";"-";"-";"-";"-";"-";"-";"-";"-";"-";"-";"-";"-";"-";"-";"-";"-";"-";"-";"-";"-";"-";"-";"-"
"05 Wrz 2024 23:00:50";"Koszty Utrzymania Pozycji";"1370900642";"-";"-";"Rachunek";"-";"-";"-";"-";"-";"-";"-";"-";"-54,59";"38 494,13";"-";"-";"-";"-";"-";"-54,59";"-";"-";"-";"-";"-";"-";"-";"-";"-";"-";"-";"-";"-";"-";"-";"-";"-";"-"
"05 Wrz 2024 23:00:50";"Koszty Utrzymania Pozycji";"O2-D5-97CH7Z";"-";"-";"Solana (USD)";"-";"-";"-";"-";"-";"-";"-";"-";"-";"-";"-";"-";"10 265,60";"-10,00000%";"10,79";"10,79";"-";"-";"-";"-";"-";"-";"-";"-";"-";"-";"-";"-";"-";"-";"-";"-";"-";"-"
"05 Wrz 2024 23:00:50";"Koszty Utrzymania Pozycji";"O2-D5-97BZ7D";"-";"-";"Solana (USD)";"-";"-";"-";"-";"-";"-";"-";"-";"-";"-";"-";"-";"3 849,60";"-10,00000%";"4,05";"4,05";"-";"-";"-";"-";"-";"-";"-";"-";"-";"-";"-";"-";"-";"-";"-";"-";"-";"-"
"05 Wrz 2024 23:00:50";"Koszty Utrzymania Pozycji";"O2-D5-977ENK";"-";"-";"Solana (USD)";"-";"-";"-";"-";"-";"-";"-";"-";"-";"-";"-";"-";"3 849,60";"-10,00000%";"4,05";"4,05";"-";"-";"-";"-";"-";"-";"-";"-";"-";"-";"-";"-";"-";"-";"-";"-";"-";"-"
"05 Wrz 2024 23:00:50";"Koszty Utrzymania Pozycji";"O2-D4-95K8MW";"-";"-";"Solana (USD)";"-";"-";"-";"-";"-";"-";"-";"-";"-";"-";"-";"-";"6 416,00";"-10,00000%";"6,74";"6,74";"-";"-";"-";"-";"-";"-";"-";"-";"-";"-";"-";"-";"-";"-";"-";"-";"-";"-"
"05 Wrz 2024 23:00:50";"Koszty Utrzymania Pozycji";"O2-D5-96SWM1";"-";"-";"Solana (USD)";"-";"-";"-";"-";"-";"-";"-";"-";"-";"-";"-";"-";"10 778,88";"-27,50000%";"-31,46";"-31,46";"-";"-";"-";"-";"-";"-";"-";"-";"-";"-";"-";"-";"-";"-";"-";"-";"-";"-"
"05 Wrz 2024 23:00:50";"Koszty Utrzymania Pozycji";"O2-D4-95TL4Z";"-";"-";"Solana (USD)";"-";"-";"-";"-";"-";"-";"-";"-";"-";"-";"-";"-";"2 887,20";"-27,50000%";"-8,43";"-8,43";"-";"-";"-";"-";"-";"-";"-";"-";"-";"-";"-";"-";"-";"-";"-";"-";"-";"-"
"05 Wrz 2024 23:00:50";"Koszty Utrzymania Pozycji";"O2-D3-94JY88";"-";"-";"Solana (USD)";"-";"-";"-";"-";"-";"-";"-";"-";"-";"-";"-";"-";"3 208,00";"-27,50000%";"-9,36";"-9,36";"-";"-";"-";"-";"-";"-";"-";"-";"-";"-";"-";"-";"-";"-";"-";"-";"-";"-"
"05 Wrz 2024 23:00:50";"Koszty Utrzymania Pozycji";"O2-D5-97C0HJ";"-";"-";"Solana (USD)";"-";"-";"-";"-";"-";"-";"-";"-";"-";"-";"-";"-";"2 053,12";"-27,50000%";"-5,99";"-5,99";"-";"-";"-";"-";"-";"-";"-";"-";"-";"-";"-";"-";"-";"-";"-";"-";"-";"-"
"05 Wrz 2024 23:00:50";"Koszty Utrzymania Pozycji";"O2-D5-96WE65";"-";"-";"Solana (USD)";"-";"-";"-";"-";"-";"-";"-";"-";"-";"-";"-";"-";"6 159,36";"-27,50000%";"-17,98";"-17,98";"-";"-";"-";"-";"-";"-";"-";"-";"-";"-";"-";"-";"-";"-";"-";"-";"-";"-"
"05 Wrz 2024 23:00:50";"Koszty Utrzymania Pozycji";"O2-D4-96156D";"-";"-";"Solana (USD)";"-";"-";"-";"-";"-";"-";"-";"-";"-";"-";"-";"-";"3 143,84";"-27,50000%";"-9,18";"-9,18";"-";"-";"-";"-";"-";"-";"-";"-";"-";"-";"-";"-";"-";"-";"-";"-";"-";"-"
"05 Wrz 2024 23:00:50";"Koszty Utrzymania Pozycji";"O2-D4-95EL0T";"-";"-";"Solana (USD)";"-";"-";"-";"-";"-";"-";"-";"-";"-";"-";"-";"-";"3 849,60";"-27,50000%";"-11,24";"-11,24";"-";"-";"-";"-";"-";"-";"-";"-";"-";"-";"-";"-";"-";"-";"-";"-";"-";"-"
"05 Wrz 2024 23:00:50";"Koszty Utrzymania Pozycji";"O2-D5-977RC9";"-";"-";"Solana (USD)";"-";"-";"-";"-";"-";"-";"-";"-";"-";"-";"-";"-";"12 767,84";"-10,00000%";"13,42";"13,42";"-";"-";"-";"-";"-";"-";"-";"-";"-";"-";"-";"-";"-";"-";"-";"-";"-";"-"
"05 Wrz 2024 22:43:22";"Zmodyfikowano Transakcję Sprzedaży";"O2-D5-97CH7Z";"T2-D5-5KWGBR";"-";"Solana (USD)";"80 Jednost.";"128,195";"-";"-";"124,000";"-";"-";"-";"0,00";"-";"-";"-";"-";"-";"-";"-";"-";"-";"-";"-";"-";"-";"-";"-";"-";"-";"-";"-";"-";"-";"-";"-";"-";"-"
"05 Wrz 2024 21:40:58";"Transakcja Sprzedaży";"O2-D5-97CH7Z";"T2-D5-5KWGBR";"-";"Solana (USD)";"80 Jednost.";"128,195";"-";"-";"-";"-";"3,875134";"39 741,82";"0,00";"-";"-";"-";"-";"-";"-";"-";"-";"-";"-";"-";"-";"-";"-";"-";"-";"-";"-";"-";"-";"-";"-";"-";"-";"-"
"05 Wrz 2024 19:02:10";" Zmodyfikowano Transakcję Kupna";"O2-D5-97C0HJ";"T2-D5-5KW8EJ";"-";"Solana (USD)";"16 Jednost.";"130,190";"-";"-";"-";"-";"-";"-";"0,00";"-";"-";"-";"-";"-";"-";"-";"-";"-";"-";"-";"-";"-";"-";"-";"-";"-";"-";"-";"-";"-";"-";"-";"-";"-"
"05 Wrz 2024 19:02:00";" Transakcja Kupna";"O2-D5-97C0HJ";"T2-D5-5KW8EJ";"-";"Solana (USD)";"16 Jednost.";"130,190";"-";"127,587";"-";"-";"3,877309";"8 076,58";"0,00";"-";"-";"-";"-";"-";"-";"-";"-";"-";"-";"-";"-";"-";"-";"-";"-";"-";"-";"-";"-";"-";"-";"-";"-";"-"
"05 Wrz 2024 18:50:33";"Take Profit";"O2-D5-977DSS";"T2-D5-5KW7W1";"-";"Solana (USD)";"45 Jednost.";"129,900";"-";"-";"-";"-";"3,83978";"22 671,01";"22,98";"38 548,72";"-";"-";"-";"-";"-";"-";"-";"-";"-";"-";"-";"-";"-";"-";"-";"-";"-";"-";"-";"-";"-";"-";"-";"-"
"05 Wrz 2024 18:39:16";"Zmodyfikowano Transakcję Sprzedaży";"O2-D5-97BZ7D";"T2-D5-5KW7D7";"-";"Solana (USD)";"30 Jednost.";"130,404";"-";"-";"-";"-";"-";"-";"0,00";"-";"-";"-";"-";"-";"-";"-";"-";"-";"-";"-";"-";"-";"-";"-";"-";"-";"-";"-";"-";"-";"-";"-";"-";"-"
"05 Wrz 2024 18:39:06";"Transakcja Sprzedaży";"O2-D5-97BZ7D";"T2-D5-5KW7D7";"-";"Solana (USD)";"30 Jednost.";"130,404";"-";"133,012";"-";"-";"3,876076";"15 163,67";"0,00";"-";"-";"-";"-";"-";"-";"-";"-";"-";"-";"-";"-";"-";"-";"-";"-";"-";"-";"-";"-";"-";"-";"-";"-";"-"
"05 Wrz 2024 18:35:59";"Zmodyfikowano Transakcję Sprzedaży";"O2-D5-977DSS";"T2-D5-5KS7NQ";"-";"Solana (USD)";"45 Jednost.";"130,033";"-";"-";"129,900";"-";"-";"-";"0,00";"-";"-";"-";"-";"-";"-";"-";"-";"-";"-";"-";"-";"-";"-";"-";"-";"-";"-";"-";"-";"-";"-";"-";"-";"-"
"05 Wrz 2024 17:36:40";"Stop Loss";"O2-D5-97BMHD";"T2-D5-5KW319";"-";"Solana (USD)";"49 Jednost.";"130,900";"-";"-";"-";"-";"3,84382";"24 902,41";"109,24";"38 525,74";"-";"-";"-";"-";"-";"-";"-";"-";"-";"-";"-";"-";"-";"-";"-";"-";"-";"-";"-";"-";"-";"-";"-";"-"
"05 Wrz 2024 17:28:47";"Zmodyfikowano Stop Loss";"O2-D5-97BMHD";"-";"O2-D5-97BQD6";"Solana (USD)";"49 Jednost.";"131,480";"-";"130,900";"-";"-";"-";"-";"-";"-";"-";"-";"-";"-";"-";"-";"-";"-";"-";"-";"-";"-";"-";"-";"-";"-";"-";"-";"-";"-";"-";"-";"-";"-"
"05 Wrz 2024 17:25:31";"Zmodyfikowano Transakcję Sprzedaży";"O2-D5-97BMHD";"T2-D5-5KVZ83";"-";"Solana (USD)";"49 Jednost.";"131,480";"-";"131,300";"-";"-";"-";"-";"0,00";"-";"-";"-";"-";"-";"-";"-";"-";"-";"-";"-";"-";"-";"-";"-";"-";"-";"-";"-";"-";"-";"-";"-";"-";"-"
"05 Wrz 2024 17:02:34";"Zmodyfikowano Transakcję Sprzedaży";"O2-D5-97BMHD";"T2-D5-5KVZ83";"-";"Solana (USD)";"49 Jednost.";"131,480";"-";"-";"-";"-";"-";"-";"0,00";"-";"-";"-";"-";"-";"-";"-";"-";"-";"-";"-";"-";"-";"-";"-";"-";"-";"-";"-";"-";"-";"-";"-";"-";"-"
"05 Wrz 2024 17:02:24";"Transakcja Sprzedaży";"O2-D5-97BMHD";"T2-D5-5KVZ83";"-";"Solana (USD)";"49 Jednost.";"131,480";"-";"134,089";"-";"-";"3,88273";"25 014,56";"0,00";"-";"-";"-";"-";"-";"-";"-";"-";"-";"-";"-";"-";"-";"-";"-";"-";"-";"-";"-";"-";"-";"-";"-";"-";"-"
"05 Wrz 2024 16:56:28";"Stop Loss";"O2-D5-97BJ7F";"T2-D5-5KVXWK";"-";"Solana (USD)";"48 Jednost.";"132,510";"-";"-";"-";"-";"3,84493";"24 701,43";"125,50";"38 416,50";"-";"-";"-";"-";"-";"-";"-";"-";"-";"-";"-";"-";"-";"-";"-";"-";"-";"-";"-";"-";"-";"-";"-";"-"
"05 Wrz 2024 16:53:04";"Zmodyfikowano Transakcję Sprzedaży";"O2-D5-97BJ7F";"T2-D5-5KVWDW";"-";"Solana (USD)";"48 Jednost.";"133,190";"-";"132,500";"-";"-";"-";"-";"0,00";"-";"-";"-";"-";"-";"-";"-";"-";"-";"-";"-";"-";"-";"-";"-";"-";"-";"-";"-";"-";"-";"-";"-";"-";"-"
"05 Wrz 2024 16:45:46";"Zmodyfikowano Transakcję Sprzedaży";"O2-D5-97BJ7F";"T2-D5-5KVWDW";"-";"Solana (USD)";"48 Jednost.";"133,190";"-";"-";"-";"-";"-";"-";"0,00";"-";"-";"-";"-";"-";"-";"-";"-";"-";"-";"-";"-";"-";"-";"-";"-";"-";"-";"-";"-";"-";"-";"-";"-";"-"
"05 Wrz 2024 16:45:36";"Transakcja Sprzedaży";"O2-D5-97BJ7F";"T2-D5-5KVWDW";"-";"Solana (USD)";"48 Jednost.";"133,190";"-";"135,853";"-";"-";"3,882339";"24 820,25";"0,00";"-";"-";"-";"-";"-";"-";"-";"-";"-";"-";"-";"-";"-";"-";"-";"-";"-";"-";"-";"-";"-";"-";"-";"-";"-"
"05 Wrz 2024 16:16:06";"Stop Loss";"O2-D5-97BC30";"T2-D5-5KVRWP";"-";"Solana (USD)";"44 Jednost.";"134,105";"-";"-";"-";"-";"3,83599";"22 862,20";"84,73";"38 291,00";"-";"-";"-";"-";"-";"-";"-";"-";"-";"-";"-";"-";"-";"-";"-";"-";"-";"-";"-";"-";"-";"-";"-";"-"
"05 Wrz 2024 16:14:31";"Zmodyfikowano Stop Loss";"O2-D5-97BC30";"-";"O2-D5-97BDMQ";"Solana (USD)";"44 Jednost.";"134,607";"-";"134,100";"-";"-";"-";"-";"-";"-";"-";"-";"-";"-";"-";"-";"-";"-";"-";"-";"-";"-";"-";"-";"-";"-";"-";"-";"-";"-";"-";"-";"-";"-"
"05 Wrz 2024 16:12:12";"Zmodyfikowano Transakcję Sprzedaży";"O2-D5-97BC30";"T2-D5-5KVPNL";"-";"Solana (USD)";"44 Jednost.";"134,607";"-";"134,200";"-";"-";"-";"-";"0,00";"-";"-";"-";"-";"-";"-";"-";"-";"-";"-";"-";"-";"-";"-";"-";"-";"-";"-";"-";"-";"-";"-";"-";"-";"-"
"05 Wrz 2024 16:04:22";"Transakcja Sprzedaży";"O2-D5-97BC30";"T2-D5-5KVPNL";"-";"Solana (USD)";"44 Jednost.";"134,607";"-";"-";"-";"-";"3,877669";"22 966,30";"0,00";"-";"-";"-";"-";"-";"-";"-";"-";"-";"-";"-";"-";"-";"-";"-";"-";"-";"-";"-";"-";"-";"-";"-";"-";"-"
"05 Wrz 2024 15:54:05";"Stop Loss";"O2-D5-97B7SL";"T2-D5-5KVMHZ";"-";"Solana (USD)";"43 Jednost.";"133,810";"-";"-";"-";"-";"3,83376";"22 280,49";"136,00";"38 206,27";"-";"-";"-";"-";"-";"-";"-";"-";"-";"-";"-";"-";"-";"-";"-";"-";"-";"-";"-";"-";"-";"-";"-";"-"
"05 Wrz 2024 15:53:47";"Zmodyfikowano Stop Loss";"O2-D5-97B7SL";"-";"O2-D5-97B84J";"Solana (USD)";"43 Jednost.";"134,635";"-";"133,800";"-";"-";"-";"-";"-";"-";"-";"-";"-";"-";"-";"-";"-";"-";"-";"-";"-";"-";"-";"-";"-";"-";"-";"-";"-";"-";"-";"-";"-";"-"
"05 Wrz 2024 15:47:26";"Zmodyfikowano Transakcję Sprzedaży";"O2-D5-97B7SL";"T2-D5-5KVLL1";"-";"Solana (USD)";"43 Jednost.";"134,635";"-";"134,200";"-";"-";"-";"-";"0,00";"-";"-";"-";"-";"-";"-";"-";"-";"-";"-";"-";"-";"-";"-";"-";"-";"-";"-";"-";"-";"-";"-";"-";"-";"-"
"05 Wrz 2024 15:45:40";"Zmodyfikowano Transakcję Sprzedaży";"O2-D5-97B7SL";"T2-D5-5KVLL1";"-";"Solana (USD)";"43 Jednost.";"134,635";"-";"-";"-";"-";"-";"-";"0,00";"-";"-";"-";"-";"-";"-";"-";"-";"-";"-";"-";"-";"-";"-";"-";"-";"-";"-";"-";"-";"-";"-";"-";"-";"-"
"05 Wrz 2024 15:45:29";"Transakcja Sprzedaży";"O2-D5-97B7SL";"T2-D5-5KVLL1";"-";"Solana (USD)";"43 Jednost.";"134,635";"-";"137,332";"-";"-";"3,871156";"22 411,30";"0,00";"-";"-";"-";"-";"-";"-";"-";"-";"-";"-";"-";"-";"-";"-";"-";"-";"-";"-";"-";"-";"-";"-";"-";"-";"-"
"05 Wrz 2024 15:43:50";"Odrzucono Zlecenie: brak wystarczających środków";"O2-D5-97B7JG";"-";"-";"Solana (USD)";"67 Jednost.";"-";"-";"-";"-";"-";"-";"-";"-";"-";"-";"-";"-";"-";"-";"-";"-";"-";"-";"-";"-";"-";"-";"-";"-";"-";"-";"-";"-";"-";"-";"-";"-";"-"
"05 Wrz 2024 15:38:33";"Take Profit";"O2-D5-978T7V";"T2-D5-5KVKLW";"-";"Solana (USD)";"26,87 Jednost.";"134,000";"-";"-";"-";"-";"3,8319";"13 935,73";"30,48";"38 070,27";"-";"-";"-";"-";"-";"-";"-";"-";"-";"-";"-";"-";"-";"-";"-";"-";"-";"-";"-";"-";"-";"-";"-";"-"
"05 Wrz 2024 15:09:56";" Zmodyfikowano Transakcję Kupna";"O2-D5-978T7V";"T2-D5-5KTG6W";"-";"Solana (USD)";"26,87 Jednost.";"133,704";"-";"-";"134,000";"-";"-";"-";"0,00";"-";"-";"-";"-";"-";"-";"-";"-";"-";"-";"-";"-";"-";"-";"-";"-";"-";"-";"-";"-";"-";"-";"-";"-";"-"
"05 Wrz 2024 14:39:22";" Zamknięcie Transakcji";"O2-D5-979YJD";"T2-D5-5KVE9H";"O2-D5-979T6R";"Solana (USD)";"72 Jednost.";"132,769";"-";"-";"-";"-";"3,82401";"36 922,38";"9,91";"38 039,79";"-";"-";"-";"-";"-";"-";"-";"-";"-";"-";"-";"-";"-";"-";"-";"-";"-";"-";"-";"-";"-";"-";"-";"-"
"05 Wrz 2024 14:33:31";" Zamknięcie Transakcji";"O2-D5-979XTJ";"T2-D5-5KVDPR";"O2-D5-978T7V";"Solana (USD)";"46 Jednost.";"133,790";"-";"-";"-";"-";"3,8223";"23 760,09";"15,12";"38 029,88";"-";"-";"-";"-";"-";"-";"-";"-";"-";"-";"-";"-";"-";"-";"-";"-";"-";"-";"-";"-";"-";"-";"-";"-"
"05 Wrz 2024 14:26:09";" Zamknięcie Transakcji";"O2-D5-979WRW";"T2-D5-5KVCN1";"O2-D5-978F9V";"Solana (USD)";"46,5 Jednost.";"132,385";"-";"-";"-";"-";"3,82217";"23 765,32";"0,00";"38 014,76";"-";"-";"-";"-";"-";"-";"-";"-";"-";"-";"-";"-";"-";"-";"-";"-";"-";"-";"-";"-";"-";"-";"-";"-"
"05 Wrz 2024 13:55:54";"Zmodyfikowano Transakcję Sprzedaży";"O2-D5-979T6R";"T2-D5-5KV94Z";"-";"Solana (USD)";"72 Jednost.";"132,805";"-";"-";"-";"-";"-";"-";"0,00";"-";"-";"-";"-";"-";"-";"-";"-";"-";"-";"-";"-";"-";"-";"-";"-";"-";"-";"-";"-";"-";"-";"-";"-";"-"
"05 Wrz 2024 13:55:44";"Transakcja Sprzedaży";"O2-D5-979T6R";"T2-D5-5KV94Z";"-";"Solana (USD)";"72 Jednost.";"132,805";"-";"135,461";"-";"-";"3,86767";"36 982,50";"0,00";"-";"-";"-";"-";"-";"-";"-";"-";"-";"-";"-";"-";"-";"-";"-";"-";"-";"-";"-";"-";"-";"-";"-";"-";"-"
"05 Wrz 2024 11:28:07";" Zamknięcie Transakcji";"O2-D5-979MCP";"T2-D5-5KV4P0";"O2-D5-978F9V";"Solana (USD)";"35 Jednost.";"132,164";"-";"-";"-";"-";"3,83104";"17 899,49";"29,63";"38 014,76";"-";"-";"-";"-";"-";"-";"-";"-";"-";"-";"-";"-";"-";"-";"-";"-";"-";"-";"-";"-";"-";"-";"-";"-"
"05 Wrz 2024 11:07:05";" Zmodyfikowano Transakcję Kupna";"O2-D5-978T7V";"T2-D5-5KTG6W";"-";"Solana (USD)";"72,87 Jednost.";"133,704";"-";"-";"-";"-";"-";"-";"0,00";"-";"-";"-";"-";"-";"-";"-";"-";"-";"-";"-";"-";"-";"-";"-";"-";"-";"-";"-";"-";"-";"-";"-";"-";"-"
"05 Wrz 2024 10:56:59";" Zamknięcie Transakcji";"O2-D5-979KWE";"T2-D5-5KV3D6";"O2-D5-979HCN";"Solana (USD)";"36 Jednost.";"132,740";"-";"-";"-";"-";"3,83022";"18 487,18";"46,05";"37 985,13";"-";"-";"-";"-";"-";"-";"-";"-";"-";"-";"-";"-";"-";"-";"-";"-";"-";"-";"-";"-";"-";"-";"-";"-"
"05 Wrz 2024 10:12:58";"Zmodyfikowano Transakcję Sprzedaży";"O2-D5-979HCN";"T2-D5-5KV0ZS";"-";"Solana (USD)";"36 Jednost.";"133,074";"-";"-";"-";"-";"-";"-";"0,00";"-";"-";"-";"-";"-";"-";"-";"-";"-";"-";"-";"-";"-";"-";"-";"-";"-";"-";"-";"-";"-";"-";"-";"-";"-"
"05 Wrz 2024 10:12:45";"Transakcja Sprzedaży";"O2-D5-979HCN";"T2-D5-5KV0ZS";"-";"Solana (USD)";"36 Jednost.";"133,074";"-";"135,735";"-";"-";"3,869523";"18 537,58";"0,00";"-";"-";"-";"-";"-";"-";"-";"-";"-";"-";"-";"-";"-";"-";"-";"-";"-";"-";"-";"-";"-";"-";"-";"-";"-"
"05 Wrz 2024 09:15:52";" Zamknięcie Transakcji";"O2-D5-979DYB";"T2-D5-5KTYFG";"O2-D3-94JY88";"Solana (USD)";"25 Jednost.";"132,648";"-";"-";"-";"-";"3,872579";"12 842,24";"-4 808,48";"37 939,08";"-";"-";"-";"-";"-";"-";"-";"-";"-";"-";"-";"-";"-";"-";"-";"-";"-";"-";"-";"-";"-";"-";"-";"-"
"05 Wrz 2024 08:50:42";" Zamknięcie Transakcji";"O2-D5-979BS6";"T2-D5-5KTWQ8";"O2-D4-95K8MW";"Solana (USD)";"25 Jednost.";"131,809";"-";"-";"-";"-";"3,873321";"12 763,46";"-1 406,89";"42 747,56";"-";"-";"-";"-";"-";"-";"-";"-";"-";"-";"-";"-";"-";"-";"-";"-";"-";"-";"-";"-";"-";"-";"-";"-"
"04 Wrz 2024 23:00:48";"Koszty Utrzymania Pozycji";"1370472473";"-";"-";"Rachunek";"-";"-";"-";"-";"-";"-";"-";"-";"-83,18";"44 154,45";"-";"-";"-";"-";"-";"-83,18";"-";"-";"-";"-";"-";"-";"-";"-";"-";"-";"-";"-";"-";"-";"-";"-";"-";"-"
"04 Wrz 2024 23:00:48";"Koszty Utrzymania Pozycji";"O2-D5-977ENK";"-";"-";"Solana (USD)";"-";"-";"-";"-";"-";"-";"-";"-";"-";"-";"-";"-";"4 016,55";"-10,00000%";"4,22";"4,22";"-";"-";"-";"-";"-";"-";"-";"-";"-";"-";"-";"-";"-";"-";"-";"-";"-";"-"
"04 Wrz 2024 23:00:48";"Koszty Utrzymania Pozycji";"O2-D5-978T7V";"-";"-";"Solana (USD)";"-";"-";"-";"-";"-";"-";"-";"-";"-";"-";"-";"-";"9 756,19";"-27,50000%";"-28,50";"-28,50";"-";"-";"-";"-";"-";"-";"-";"-";"-";"-";"-";"-";"-";"-";"-";"-";"-";"-"
"04 Wrz 2024 23:00:48";"Koszty Utrzymania Pozycji";"O2-D5-978F9V";"-";"-";"Solana (USD)";"-";"-";"-";"-";"-";"-";"-";"-";"-";"-";"-";"-";"10 911,62";"-10,00000%";"11,47";"11,47";"-";"-";"-";"-";"-";"-";"-";"-";"-";"-";"-";"-";"-";"-";"-";"-";"-";"-"
"04 Wrz 2024 23:00:48";"Koszty Utrzymania Pozycji";"O2-D5-96SWM1";"-";"-";"Solana (USD)";"-";"-";"-";"-";"-";"-";"-";"-";"-";"-";"-";"-";"11 246,34";"-27,50000%";"-32,85";"-32,85";"-";"-";"-";"-";"-";"-";"-";"-";"-";"-";"-";"-";"-";"-";"-";"-";"-";"-"
"04 Wrz 2024 23:00:48";"Koszty Utrzymania Pozycji";"O2-D4-95TL4Z";"-";"-";"Solana (USD)";"-";"-";"-";"-";"-";"-";"-";"-";"-";"-";"-";"-";"3 012,41";"-27,50000%";"-8,80";"-8,80";"-";"-";"-";"-";"-";"-";"-";"-";"-";"-";"-";"-";"-";"-";"-";"-";"-";"-"
"04 Wrz 2024 23:00:48";"Koszty Utrzymania Pozycji";"O2-D5-96WE65";"-";"-";"Solana (USD)";"-";"-";"-";"-";"-";"-";"-";"-";"-";"-";"-";"-";"6 426,48";"-27,50000%";"-18,77";"-18,77";"-";"-";"-";"-";"-";"-";"-";"-";"-";"-";"-";"-";"-";"-";"-";"-";"-";"-"
"04 Wrz 2024 23:00:48";"Koszty Utrzymania Pozycji";"O2-D4-96156D";"-";"-";"Solana (USD)";"-";"-";"-";"-";"-";"-";"-";"-";"-";"-";"-";"-";"3 280,18";"-27,50000%";"-9,58";"-9,58";"-";"-";"-";"-";"-";"-";"-";"-";"-";"-";"-";"-";"-";"-";"-";"-";"-";"-"
"04 Wrz 2024 23:00:48";"Koszty Utrzymania Pozycji";"O2-D3-94JY88";"-";"-";"Solana (USD)";"-";"-";"-";"-";"-";"-";"-";"-";"-";"-";"-";"-";"6 694,25";"-27,50000%";"-19,55";"-19,55";"-";"-";"-";"-";"-";"-";"-";"-";"-";"-";"-";"-";"-";"-";"-";"-";"-";"-"
"04 Wrz 2024 23:00:48";"Koszty Utrzymania Pozycji";"O2-D4-95EL0T";"-";"-";"Solana (USD)";"-";"-";"-";"-";"-";"-";"-";"-";"-";"-";"-";"-";"4 016,55";"-27,50000%";"-11,73";"-11,73";"-";"-";"-";"-";"-";"-";"-";"-";"-";"-";"-";"-";"-";"-";"-";"-";"-";"-"
"04 Wrz 2024 23:00:48";"Koszty Utrzymania Pozycji";"O2-D5-977DSS";"-";"-";"Solana (USD)";"-";"-";"-";"-";"-";"-";"-";"-";"-";"-";"-";"-";"6 024,82";"-10,00000%";"6,34";"6,34";"-";"-";"-";"-";"-";"-";"-";"-";"-";"-";"-";"-";"-";"-";"-";"-";"-";"-"
"04 Wrz 2024 23:00:48";"Koszty Utrzymania Pozycji";"O2-D5-977RC9";"-";"-";"Solana (USD)";"-";"-";"-";"-";"-";"-";"-";"-";"-";"-";"-";"-";"13 321,55";"-10,00000%";"14,01";"14,01";"-";"-";"-";"-";"-";"-";"-";"-";"-";"-";"-";"-";"-";"-";"-";"-";"-";"-"
"04 Wrz 2024 23:00:48";"Koszty Utrzymania Pozycji";"O2-D4-95K8MW";"-";"-";"Solana (USD)";"-";"-";"-";"-";"-";"-";"-";"-";"-";"-";"-";"-";"10 041,37";"-10,00000%";"10,56";"10,56";"-";"-";"-";"-";"-";"-";"-";"-";"-";"-";"-";"-";"-";"-";"-";"-";"-";"-"
"04 Wrz 2024 22:07:26";" Zamknięcie Transakcji";"O2-D5-978XGP";"T2-D5-5KTK5K";"O2-D3-94S9LM";"Solana (USD)";"35 Jednost.";"133,110";"-";"-";"-";"-";"3,87809";"18 067,43";"-6 260,69";"44 237,63";"-";"-";"-";"-";"-";"-";"-";"-";"-";"-";"-";"-";"-";"-";"-";"-";"-";"-";"-";"-";"-";"-";"-";"-"
"04 Wrz 2024 22:07:03";" Zamknięcie Transakcji";"O2-D5-978XGF";"T2-D5-5KTK5C";"O2-D4-95K8MW";"Solana (USD)";"35 Jednost.";"133,295";"-";"-";"-";"-";"3,87796";"18 091,94";"-2 173,69";"50 498,32";"-";"-";"-";"-";"-";"-";"-";"-";"-";"-";"-";"-";"-";"-";"-";"-";"-";"-";"-";"-";"-";"-";"-";"-"
"04 Wrz 2024 22:06:25";" Zamknięcie Transakcji";"O2-D5-978XFY";"T2-D5-5KTK52";"O2-D3-94S9LM";"Solana (USD)";"35 Jednost.";"133,125";"-";"-";"-";"-";"3,87809";"18 069,47";"-6 258,66";"52 672,01";"-";"-";"-";"-";"-";"-";"-";"-";"-";"-";"-";"-";"-";"-";"-";"-";"-";"-";"-";"-";"-";"-";"-";"-"
"04 Wrz 2024 22:01:47";" Zmodyfikowano Transakcję Kupna";"O2-D5-978T7V";"T2-D5-5KTG6W";"-";"Solana (USD)";"72,87 Jednost.";"133,704";"-";"-";"137,000";"-";"-";"-";"0,00";"-";"-";"-";"-";"-";"-";"-";"-";"-";"-";"-";"-";"-";"-";"-";"-";"-";"-";"-";"-";"-";"-";"-";"-";"-"
"04 Wrz 2024 21:33:05";" Zmodyfikowano Transakcję Kupna";"O2-D5-978T7V";"T2-D5-5KTG6W";"-";"Solana (USD)";"72,87 Jednost.";"133,704";"-";"-";"-";"-";"-";"-";"0,00";"-";"-";"-";"-";"-";"-";"-";"-";"-";"-";"-";"-";"-";"-";"-";"-";"-";"-";"-";"-";"-";"-";"-";"-";"-"
"04 Wrz 2024 21:08:33";" Zmodyfikowano Transakcję Kupna";"O2-D5-978T7V";"T2-D5-5KTG6W";"-";"Solana (USD)";"72,87 Jednost.";"133,704";"-";"-";"134,300";"-";"-";"-";"0,00";"-";"-";"-";"-";"-";"-";"-";"-";"-";"-";"-";"-";"-";"-";"-";"-";"-";"-";"-";"-";"-";"-";"-";"-";"-"
"04 Wrz 2024 21:04:47";" Zmodyfikowano Transakcję Kupna";"O2-D5-978T7V";"T2-D5-5KTG6W";"-";"Solana (USD)";"72,87 Jednost.";"133,704";"-";"-";"-";"-";"-";"-";"0,00";"-";"-";"-";"-";"-";"-";"-";"-";"-";"-";"-";"-";"-";"-";"-";"-";"-";"-";"-";"-";"-";"-";"-";"-";"-"
"04 Wrz 2024 21:04:35";" Transakcja Kupna";"O2-D5-978T7V";"T2-D5-5KTG6W";"-";"Solana (USD)";"72,87 Jednost.";"133,704";"-";"131,030";"-";"-";"3,879603";"37 799,01";"0,00";"-";"-";"-";"-";"-";"-";"-";"-";"-";"-";"-";"-";"-";"-";"-";"-";"-";"-";"-";"-";"-";"-";"-";"-";"-"
"04 Wrz 2024 17:32:01";"Zmodyfikowano Transakcję Sprzedaży";"O2-D5-978F9V";"T2-D5-5KT587";"-";"Solana (USD)";"81,5 Jednost.";"132,385";"-";"-";"-";"-";"-";"-";"0,00";"-";"-";"-";"-";"-";"-";"-";"-";"-";"-";"-";"-";"-";"-";"-";"-";"-";"-";"-";"-";"-";"-";"-";"-";"-"
"04 Wrz 2024 17:31:50";"Transakcja Sprzedaży";"O2-D5-978F9V";"T2-D5-5KT587";"-";"Solana (USD)";"81,5 Jednost.";"132,385";"-";"135,042";"-";"-";"3,878371";"41 845,20";"0,00";"-";"-";"-";"-";"-";"-";"-";"-";"-";"-";"-";"-";"-";"-";"-";"-";"-";"-";"-";"-";"-";"-";"-";"-";"-"
"04 Wrz 2024 17:30:15";" Zamknięcie Transakcji";"O2-D5-978F1V";"T2-D5-5KT4ZG";"O2-D5-973Z4E";"Solana (USD)";"65 Jednost.";"132,739";"-";"-";"-";"-";"3,83984";"33 463,32";"301,01";"58 930,67";"-";"-";"-";"-";"-";"-";"-";"-";"-";"-";"-";"-";"-";"-";"-";"-";"-";"-";"-";"-";"-";"-";"-";"-"
"04 Wrz 2024 17:28:50";" Zamknięcie Transakcji";"O2-D5-978EXL";"T2-D5-5KT4VN";"O2-D5-976MF7";"Solana (USD)";"20 Jednost.";"132,750";"-";"-";"-";"-";"3,83905";"10 295,07";"135,75";"58 629,66";"-";"-";"-";"-";"-";"-";"-";"-";"-";"-";"-";"-";"-";"-";"-";"-";"-";"-";"-";"-";"-";"-";"-";"-"
"04 Wrz 2024 17:26:55";" Zamknięcie Transakcji";"O2-D5-978ERS";"T2-D5-5KT4PY";"O2-D5-973Z4E";"Solana (USD)";"40 Jednost.";"132,850";"-";"-";"-";"-";"3,83974";"20 609,45";"168,18";"58 493,91";"-";"-";"-";"-";"-";"-";"-";"-";"-";"-";"-";"-";"-";"-";"-";"-";"-";"-";"-";"-";"-";"-";"-";"-"
"04 Wrz 2024 17:25:55";" Zamknięcie Transakcji";"O2-D5-978ENS";"T2-D5-5KT4M2";"O2-D4-95P4DE";"Solana (USD)";"15 Jednost.";"133,060";"-";"-";"-";"-";"3,83945";"7 740,16";"336,05";"58 325,73";"-";"-";"-";"-";"-";"-";"-";"-";"-";"-";"-";"-";"-";"-";"-";"-";"-";"-";"-";"-";"-";"-";"-";"-"
"04 Wrz 2024 17:23:54";" Zamknięcie Transakcji";"O2-D5-978EJS";"T2-D5-5KT4HQ";"O2-D5-976MF7";"Solana (USD)";"5 Jednost.";"133,141";"-";"-";"-";"-";"3,83944";"2 581,61";"41,45";"57 989,68";"-";"-";"-";"-";"-";"-";"-";"-";"-";"-";"-";"-";"-";"-";"-";"-";"-";"-";"-";"-";"-";"-";"-";"-"
"04 Wrz 2024 17:21:55";" Zamknięcie Transakcji";"O2-D5-978EEM";"T2-D5-5KT4EJ";"O2-D5-976MF7";"Solana (USD)";"5 Jednost.";"132,865";"-";"-";"-";"-";"3,83838";"2 575,55";"36,14";"57 948,23";"-";"-";"-";"-";"-";"-";"-";"-";"-";"-";"-";"-";"-";"-";"-";"-";"-";"-";"-";"-";"-";"-";"-";"-"
"04 Wrz 2024 17:20:06";" Zamknięcie Transakcji";"O2-D5-978E9K";"T2-D5-5KT49S";"O2-D5-976MF7";"Solana (USD)";"17 Jednost.";"132,680";"-";"-";"-";"-";"3,83899";"8 746,06";"110,82";"57 912,09";"-";"-";"-";"-";"-";"-";"-";"-";"-";"-";"-";"-";"-";"-";"-";"-";"-";"-";"-";"-";"-";"-";"-";"-"
"04 Wrz 2024 17:19:01";" Zamknięcie Transakcji";"O2-D5-978E6R";"T2-D5-5KT47M";"O2-D5-977BB0";"Solana (USD)";"65 Jednost.";"132,400";"-";"-";"-";"-";"3,83958";"33 375,53";"459,21";"57 801,27";"-";"-";"-";"-";"-";"-";"-";"-";"-";"-";"-";"-";"-";"-";"-";"-";"-";"-";"-";"-";"-";"-";"-";"-"
"04 Wrz 2024 17:18:25";" Zamknięcie Transakcji";"O2-D5-978E5C";"T2-D5-5KT46P";"O2-D5-974P0D";"Solana (USD)";"93 Jednost.";"132,595";"-";"-";"-";"-";"3,84063";"47 836,12";"214,31";"57 342,06";"-";"-";"-";"-";"-";"-";"-";"-";"-";"-";"-";"-";"-";"-";"-";"-";"-";"-";"-";"-";"-";"-";"-";"-"
"04 Wrz 2024 17:14:18";" Zamknięcie Transakcji";"O2-D5-978DS2";"T2-D5-5KT3TW";"O2-D5-977BB0";"Solana (USD)";"2 Jednost.";"132,731";"-";"-";"-";"-";"3,84079";"1 029,83";"16,68";"57 127,75";"-";"-";"-";"-";"-";"-";"-";"-";"-";"-";"-";"-";"-";"-";"-";"-";"-";"-";"-";"-";"-";"-";"-";"-"
"04 Wrz 2024 17:13:49";" Zamknięcie Transakcji";"O2-D5-978DR7";"T2-D5-5KT3T2";"O2-D5-977BB0";"Solana (USD)";"3 Jednost.";"132,633";"-";"-";"-";"-";"3,84044";"1 543,46";"23,88";"57 111,07";"-";"-";"-";"-";"-";"-";"-";"-";"-";"-";"-";"-";"-";"-";"-";"-";"-";"-";"-";"-";"-";"-";"-";"-"
"04 Wrz 2024 16:36:45";" Zamknięcie Transakcji";"O2-D5-9787YC";"T2-D5-5KSZDD";"O2-D5-977BB0";"Solana (USD)";"11 Jednost.";"130,748";"-";"-";"-";"-";"3,83879";"5 576,54";"7,94";"57 087,19";"-";"-";"-";"-";"-";"-";"-";"-";"-";"-";"-";"-";"-";"-";"-";"-";"-";"-";"-";"-";"-";"-";"-";"-"
"04 Wrz 2024 14:30:11";" Zmodyfikowano Transakcję Kupna";"O2-D5-977BB0";"T2-D5-5KS5Q5";"-";"Solana (USD)";"81 Jednost.";"130,560";"-";"-";"-";"-";"-";"-";"0,00";"-";"-";"-";"-";"-";"-";"-";"-";"-";"-";"-";"-";"-";"-";"-";"-";"-";"-";"-";"-";"-";"-";"-";"-";"-"
"04 Wrz 2024 14:27:14";"Zmodyfikowano Transakcję Sprzedaży";"O2-D5-977RC9";"T2-D5-5KSJBN";"-";"Solana (USD)";"99,5 Jednost.";"128,260";"-";"-";"-";"-";"-";"-";"0,00";"-";"-";"-";"-";"-";"-";"-";"-";"-";"-";"-";"-";"-";"-";"-";"-";"-";"-";"-";"-";"-";"-";"-";"-";"-"
"04 Wrz 2024 14:27:01";"Transakcja Sprzedaży";"O2-D5-977RC9";"T2-D5-5KSJBN";"-";"Solana (USD)";"99,5 Jednost.";"128,260";"-";"130,825";"-";"-";"3,896156";"49 722,23";"0,00";"-";"-";"-";"-";"-";"-";"-";"-";"-";"-";"-";"-";"-";"-";"-";"-";"-";"-";"-";"-";"-";"-";"-";"-";"-"
"04 Wrz 2024 13:08:44";" Zamknięcie Transakcji";"O2-D5-977MXG";"T2-D5-5KSFMF";"O2-D5-977DSS";"Solana (USD)";"5 Jednost.";"129,140";"-";"-";"-";"-";"3,85585";"2 514,74";"17,22";"57 079,25";"-";"-";"-";"-";"-";"-";"-";"-";"-";"-";"-";"-";"-";"-";"-";"-";"-";"-";"-";"-";"-";"-";"-";"-"
"04 Wrz 2024 12:47:16";" Zmodyfikowano Transakcję Kupna";"O2-D5-977BB0";"T2-D5-5KS5Q5";"-";"Solana (USD)";"81 Jednost.";"130,560";"-";"-";"131,400";"-";"-";"-";"0,00";"-";"-";"-";"-";"-";"-";"-";"-";"-";"-";"-";"-";"-";"-";"-";"-";"-";"-";"-";"-";"-";"-";"-";"-";"-"
"04 Wrz 2024 12:43:20";"Take Profit";"O2-D5-976NBD";"T2-D5-5KSEQH";"-";"Solana (USD)";"41 Jednost.";"129,000";"-";"-";"-";"-";"3,85372";"20 587,10";"66,52";"57 062,03";"-";"-";"-";"-";"-";"-";"-";"-";"-";"-";"-";"-";"-";"-";"-";"-";"-";"-";"-";"-";"-";"-";"-";"-"
"04 Wrz 2024 12:43:20";"Take Profit";"O2-D5-976NB5";"T2-D5-5KSEQG";"-";"Solana (USD)";"53 Jednost.";"129,000";"-";"-";"-";"-";"3,85372";"26 612,60";"117,44";"56 995,51";"-";"-";"-";"-";"-";"-";"-";"-";"-";"-";"-";"-";"-";"-";"-";"-";"-";"-";"-";"-";"-";"-";"-";"-"
"04 Wrz 2024 12:35:17";"Zmodyfikowano Transakcję Sprzedaży";"O2-D5-976NBD";"T2-D5-5KRMEG";"-";"Solana (USD)";"41 Jednost.";"129,421";"-";"-";"129,000";"-";"-";"-";"0,00";"-";"-";"-";"-";"-";"-";"-";"-";"-";"-";"-";"-";"-";"-";"-";"-";"-";"-";"-";"-";"-";"-";"-";"-";"-"
"04 Wrz 2024 12:34:52";"Zmodyfikowano Transakcję Sprzedaży";"O2-D5-976NB5";"T2-D5-5KRMEF";"-";"Solana (USD)";"53 Jednost.";"129,575";"-";"-";"129,000";"-";"-";"-";"0,00";"-";"-";"-";"-";"-";"-";"-";"-";"-";"-";"-";"-";"-";"-";"-";"-";"-";"-";"-";"-";"-";"-";"-";"-";"-"
"04 Wrz 2024 11:34:11";" Zmodyfikowano Transakcję Kupna";"O2-D5-977BB0";"T2-D5-5KS5Q5";"-";"Solana (USD)";"81 Jednost.";"130,560";"-";"-";"-";"-";"-";"-";"0,00";"-";"-";"-";"-";"-";"-";"-";"-";"-";"-";"-";"-";"-";"-";"-";"-";"-";"-";"-";"-";"-";"-";"-";"-";"-"
"04 Wrz 2024 10:37:22";"Zmodyfikowano Transakcję Sprzedaży";"O2-D5-977ENK";"T2-D5-5KS8GJ";"-";"Solana (USD)";"30 Jednost.";"130,169";"-";"-";"-";"-";"-";"-";"0,00";"-";"-";"-";"-";"-";"-";"-";"-";"-";"-";"-";"-";"-";"-";"-";"-";"-";"-";"-";"-";"-";"-";"-";"-";"-"
"04 Wrz 2024 10:37:11";"Transakcja Sprzedaży";"O2-D5-977ENK";"T2-D5-5KS8GJ";"-";"Solana (USD)";"30 Jednost.";"130,169";"-";"132,773";"-";"-";"3,890625";"15 193,16";"0,00";"-";"-";"-";"-";"-";"-";"-";"-";"-";"-";"-";"-";"-";"-";"-";"-";"-";"-";"-";"-";"-";"-";"-";"-";"-"
"04 Wrz 2024 10:23:45";"Zmodyfikowano Transakcję Sprzedaży";"O2-D5-977DSS";"T2-D5-5KS7NQ";"-";"Solana (USD)";"50 Jednost.";"130,033";"-";"-";"-";"-";"-";"-";"0,00";"-";"-";"-";"-";"-";"-";"-";"-";"-";"-";"-";"-";"-";"-";"-";"-";"-";"-";"-";"-";"-";"-";"-";"-";"-"
"04 Wrz 2024 10:23:32";"Transakcja Sprzedaży";"O2-D5-977DSS";"T2-D5-5KS7NQ";"-";"Solana (USD)";"50 Jednost.";"130,033";"-";"132,633";"-";"-";"3,889683";"25 289,35";"0,00";"-";"-";"-";"-";"-";"-";"-";"-";"-";"-";"-";"-";"-";"-";"-";"-";"-";"-";"-";"-";"-";"-";"-";"-";"-"
"04 Wrz 2024 09:56:50";" Zmodyfikowano Transakcję Kupna";"O2-D5-977BB0";"T2-D5-5KS5Q5";"-";"Solana (USD)";"81 Jednost.";"130,560";"-";"-";"131,200";"-";"-";"-";"0,00";"-";"-";"-";"-";"-";"-";"-";"-";"-";"-";"-";"-";"-";"-";"-";"-";"-";"-";"-";"-";"-";"-";"-";"-";"-"
"04 Wrz 2024 09:40:08";" Zmodyfikowano Transakcję Kupna";"O2-D5-977BB0";"T2-D5-5KS5Q5";"-";"Solana (USD)";"81 Jednost.";"130,560";"-";"-";"-";"-";"-";"-";"0,00";"-";"-";"-";"-";"-";"-";"-";"-";"-";"-";"-";"-";"-";"-";"-";"-";"-";"-";"-";"-";"-";"-";"-";"-";"-"
"04 Wrz 2024 09:39:56";" Transakcja Kupna";"O2-D5-977BB0";"T2-D5-5KS5Q5";"-";"Solana (USD)";"81 Jednost.";"130,560";"-";"127,966";"-";"-";"3,885475";"41 090,29";"0,00";"-";"-";"-";"-";"-";"-";"-";"-";"-";"-";"-";"-";"-";"-";"-";"-";"-";"-";"-";"-";"-";"-";"-";"-";"-"
"03 Wrz 2024 23:26:07";"Zmodyfikowano Transakcję Sprzedaży";"O2-D5-976NBD";"T2-D5-5KRMEG";"-";"Solana (USD)";"41 Jednost.";"129,421";"-";"-";"-";"-";"-";"-";"0,00";"-";"-";"-";"-";"-";"-";"-";"-";"-";"-";"-";"-";"-";"-";"-";"-";"-";"-";"-";"-";"-";"-";"-";"-";"-"
"03 Wrz 2024 23:25:57";"Transakcja Sprzedaży";"O2-D5-976NBD";"T2-D5-5KRMEG";"-";"Solana (USD)";"41 Jednost.";"129,421";"-";"132,009";"-";"-";"3,894092";"20 663,06";"0,00";"-";"-";"-";"-";"-";"-";"-";"-";"-";"-";"-";"-";"-";"-";"-";"-";"-";"-";"-";"-";"-";"-";"-";"-";"-"
"03 Wrz 2024 23:24:50";"Transakcja Sprzedaży";"O2-D5-976NB5";"T2-D5-5KRMEF";"-";"Solana (USD)";"53 Jednost.";"129,575";"-";"-";"-";"-";"3,894092";"26 742,57";"0,00";"-";"-";"-";"-";"-";"-";"-";"-";"-";"-";"-";"-";"-";"-";"-";"-";"-";"-";"-";"-";"-";"-";"-";"-";"-"
"03 Wrz 2024 23:00:49";"Koszty Utrzymania Pozycji";"1370007482";"-";"-";"Rachunek";"-";"-";"-";"-";"-";"-";"-";"-";"-99,51";"56 878,07";"-";"-";"-";"-";"-";"-99,51";"-";"-";"-";"-";"-";"-";"-";"-";"-";"-";"-";"-";"-";"-";"-";"-";"-";"-"
"03 Wrz 2024 23:00:49";"Koszty Utrzymania Pozycji";"O2-D5-96SWM1";"-";"-";"Solana (USD)";"-";"-";"-";"-";"-";"-";"-";"-";"-";"-";"-";"-";"10 964,94";"-27,50000%";"-32,18";"-32,18";"-";"-";"-";"-";"-";"-";"-";"-";"-";"-";"-";"-";"-";"-";"-";"-";"-";"-"
"03 Wrz 2024 23:00:49";"Koszty Utrzymania Pozycji";"O2-D4-95TL4Z";"-";"-";"Solana (USD)";"-";"-";"-";"-";"-";"-";"-";"-";"-";"-";"-";"-";"2 937,03";"-27,50000%";"-8,62";"-8,62";"-";"-";"-";"-";"-";"-";"-";"-";"-";"-";"-";"-";"-";"-";"-";"-";"-";"-"
"03 Wrz 2024 23:00:49";"Koszty Utrzymania Pozycji";"O2-D5-96WE65";"-";"-";"Solana (USD)";"-";"-";"-";"-";"-";"-";"-";"-";"-";"-";"-";"-";"6 265,68";"-27,50000%";"-18,39";"-18,39";"-";"-";"-";"-";"-";"-";"-";"-";"-";"-";"-";"-";"-";"-";"-";"-";"-";"-"
"03 Wrz 2024 23:00:49";"Koszty Utrzymania Pozycji";"O2-D5-973Z4E";"-";"-";"Solana (USD)";"-";"-";"-";"-";"-";"-";"-";"-";"-";"-";"-";"-";"13 706,17";"-10,00000%";"14,48";"14,48";"-";"-";"-";"-";"-";"-";"-";"-";"-";"-";"-";"-";"-";"-";"-";"-";"-";"-"
"03 Wrz 2024 23:00:49";"Koszty Utrzymania Pozycji";"O2-D4-96156D";"-";"-";"Solana (USD)";"-";"-";"-";"-";"-";"-";"-";"-";"-";"-";"-";"-";"3 198,10";"-27,50000%";"-9,39";"-9,39";"-";"-";"-";"-";"-";"-";"-";"-";"-";"-";"-";"-";"-";"-";"-";"-";"-";"-"
"03 Wrz 2024 23:00:49";"Koszty Utrzymania Pozycji";"O2-D3-94JY88";"-";"-";"Solana (USD)";"-";"-";"-";"-";"-";"-";"-";"-";"-";"-";"-";"-";"6 526,75";"-27,50000%";"-19,16";"-19,16";"-";"-";"-";"-";"-";"-";"-";"-";"-";"-";"-";"-";"-";"-";"-";"-";"-";"-"
"03 Wrz 2024 23:00:49";"Koszty Utrzymania Pozycji";"O2-D3-94S9LM";"-";"-";"Solana (USD)";"-";"-";"-";"-";"-";"-";"-";"-";"-";"-";"-";"-";"9 137,45";"-27,50000%";"-26,82";"-26,82";"-";"-";"-";"-";"-";"-";"-";"-";"-";"-";"-";"-";"-";"-";"-";"-";"-";"-"
"03 Wrz 2024 23:00:49";"Koszty Utrzymania Pozycji";"O2-D5-974P0D";"-";"-";"Solana (USD)";"-";"-";"-";"-";"-";"-";"-";"-";"-";"-";"-";"-";"12 139,75";"-10,00000%";"12,83";"12,83";"-";"-";"-";"-";"-";"-";"-";"-";"-";"-";"-";"-";"-";"-";"-";"-";"-";"-"
"03 Wrz 2024 23:00:49";"Koszty Utrzymania Pozycji";"O2-D4-95P4DE";"-";"-";"Solana (USD)";"-";"-";"-";"-";"-";"-";"-";"-";"-";"-";"-";"-";"1 958,02";"-10,00000%";"2,07";"2,07";"-";"-";"-";"-";"-";"-";"-";"-";"-";"-";"-";"-";"-";"-";"-";"-";"-";"-"
"03 Wrz 2024 23:00:49";"Koszty Utrzymania Pozycji";"O2-D4-95EL0T";"-";"-";"Solana (USD)";"-";"-";"-";"-";"-";"-";"-";"-";"-";"-";"-";"-";"3 916,05";"-27,50000%";"-11,49";"-11,49";"-";"-";"-";"-";"-";"-";"-";"-";"-";"-";"-";"-";"-";"-";"-";"-";"-";"-"
"03 Wrz 2024 23:00:49";"Koszty Utrzymania Pozycji";"O2-D5-976MF7";"-";"-";"Solana (USD)";"-";"-";"-";"-";"-";"-";"-";"-";"-";"-";"-";"-";"6 135,14";"-27,50000%";"-18,01";"-18,01";"-";"-";"-";"-";"-";"-";"-";"-";"-";"-";"-";"-";"-";"-";"-";"-";"-";"-"
"03 Wrz 2024 23:00:49";"Koszty Utrzymania Pozycji";"O2-D4-95K8MW";"-";"-";"Solana (USD)";"-";"-";"-";"-";"-";"-";"-";"-";"-";"-";"-";"-";"14 358,85";"-10,00000%";"15,17";"15,17";"-";"-";"-";"-";"-";"-";"-";"-";"-";"-";"-";"-";"-";"-";"-";"-";"-";"-"
"03 Wrz 2024 22:55:19";" Zamknięcie Transakcji";"O2-D5-976MZW";"T2-D5-5KRM8E";"O2-D5-974P0D";"Solana (USD)";"10 Jednost.";"130,580";"-";"-";"-";"-";"3,85731";"5 087,49";"100,87";"56 977,58";"-";"-";"-";"-";"-";"-";"-";"-";"-";"-";"-";"-";"-";"-";"-";"-";"-";"-";"-";"-";"-";"-";"-";"-"
"03 Wrz 2024 22:30:47";" Zmodyfikowano Transakcję Kupna";"O2-D5-976MF7";"T2-D5-5KRLX3";"-";"Solana (USD)";"47 Jednost.";"130,982";"-";"-";"-";"-";"-";"-";"0,00";"-";"-";"-";"-";"-";"-";"-";"-";"-";"-";"-";"-";"-";"-";"-";"-";"-";"-";"-";"-";"-";"-";"-";"-";"-"
"03 Wrz 2024 22:30:36";" Transakcja Kupna";"O2-D5-976MF7";"T2-D5-5KRLX3";"-";"Solana (USD)";"47 Jednost.";"130,982";"-";"128,363";"-";"-";"3,896557";"23 987,80";"0,00";"-";"-";"-";"-";"-";"-";"-";"-";"-";"-";"-";"-";"-";"-";"-";"-";"-";"-";"-";"-";"-";"-";"-";"-";"-"
"03 Wrz 2024 22:23:11";" Zamknięcie Transakcji";"O2-D5-976M6M";"T2-D5-5KRLQ2";"O2-D5-973J4B";"Solana (USD)";"40 Jednost.";"131,595";"-";"-";"-";"-";"3,85836";"20 513,70";"18,67";"56 876,71";"-";"-";"-";"-";"-";"-";"-";"-";"-";"-";"-";"-";"-";"-";"-";"-";"-";"-";"-";"-";"-";"-";"-";"-"
"03 Wrz 2024 19:32:08";" Zamknięcie Transakcji";"O2-D5-97684X";"T2-D5-5KR8H2";"O2-D5-9765S4";"Solana (USD)";"85 Jednost.";"130,890";"-";"-";"-";"-";"3,85933";"43 369,11";"109,89";"56 858,04";"-";"-";"-";"-";"-";"-";"-";"-";"-";"-";"-";"-";"-";"-";"-";"-";"-";"-";"-";"-";"-";"-";"-";"-"
"03 Wrz 2024 18:47:17";" Zmodyfikowano Transakcję Kupna";"O2-D5-9765S4";"T2-D5-5KR6KW";"-";"Solana (USD)";"85 Jednost.";"130,555";"-";"-";"-";"-";"-";"-";"0,00";"-";"-";"-";"-";"-";"-";"-";"-";"-";"-";"-";"-";"-";"-";"-";"-";"-";"-";"-";"-";"-";"-";"-";"-";"-"
"03 Wrz 2024 18:47:05";" Transakcja Kupna";"O2-D5-9765S4";"T2-D5-5KR6KW";"-";"Solana (USD)";"85 Jednost.";"130,555";"-";"127,944";"-";"-";"3,896307";"43 238,00";"0,00";"-";"-";"-";"-";"-";"-";"-";"-";"-";"-";"-";"-";"-";"-";"-";"-";"-";"-";"-";"-";"-";"-";"-";"-";"-"
"03 Wrz 2024 15:34:47";"Stop Loss";"O2-D5-97539Y";"T2-D5-5KQG2K";"-";"Solana (USD)";"85 Jednost.";"132,640";"-";"-";"-";"-";"3,885565";"43 807,41";"-903,30";"56 748,15";"-";"-";"-";"-";"-";"-";"-";"-";"-";"-";"-";"-";"-";"-";"-";"-";"-";"-";"-";"-";"-";"-";"-";"-"
"03 Wrz 2024 14:20:49";" Transakcja Kupna";"O2-D5-97539Y";"T2-D5-5KQ9W7";"-";"Solana (USD)";"85 Jednost.";"135,375";"-";"132,670";"-";"-";"3,896156";"44 832,58";"0,00";"-";"-";"-";"-";"-";"-";"-";"-";"-";"-";"-";"-";"-";"-";"-";"-";"-";"-";"-";"-";"-";"-";"-";"-";"-"
"03 Wrz 2024 10:51:48";"Transakcja Sprzedaży";"O2-D5-974P0D";"T2-D5-5KPZKY";"-";"Solana (USD)";"103 Jednost.";"133,195";"-";"-";"-";"-";"3,888601";"53 348,04";"0,00";"-";"-";"-";"-";"-";"-";"-";"-";"-";"-";"-";"-";"-";"-";"-";"-";"-";"-";"-";"-";"-";"-";"-";"-";"-"
"03 Wrz 2024 07:11:24";" Zamknięcie Transakcji";"O2-D5-974CKF";"T2-D5-5KPPSR";"O2-D4-95P4DE";"Solana (USD)";"15 Jednost.";"135,106";"-";"-";"-";"-";"3,84592";"7 872,43";"218,58";"57 651,45";"-";"-";"-";"-";"-";"-";"-";"-";"-";"-";"-";"-";"-";"-";"-";"-";"-";"-";"-";"-";"-";"-";"-";"-"
"03 Wrz 2024 07:10:42";"Zmodyfikowano Transakcję Sprzedaży";"O2-D5-973Z4E";"T2-D5-5KPFZK";"-";"Solana (USD)";"105 Jednost.";"133,945";"-";"-";"-";"-";"-";"-";"0,00";"-";"-";"-";"-";"-";"-";"-";"-";"-";"-";"-";"-";"-";"-";"-";"-";"-";"-";"-";"-";"-";"-";"-";"-";"-"
"03 Wrz 2024 07:10:28";" Zamknięcie Transakcji";"O2-D5-974CJQ";"T2-D5-5KPPS2";"O2-D5-970BTR";"Solana (USD)";"40 Jednost.";"135,085";"-";"-";"-";"-";"3,84603";"20 990,55";"580,75";"57 432,87";"-";"-";"-";"-";"-";"-";"-";"-";"-";"-";"-";"-";"-";"-";"-";"-";"-";"-";"-";"-";"-";"-";"-";"-"
"03 Wrz 2024 07:10:05";" Zamknięcie Transakcji";"O2-D5-974CJG";"T2-D5-5KPPRV";"O2-D5-972JBB";"Solana (USD)";"50 Jednost.";"135,028";"-";"-";"-";"-";"3,84594";"26 226,50";"173,45";"56 852,12";"-";"-";"-";"-";"-";"-";"-";"-";"-";"-";"-";"-";"-";"-";"-";"-";"-";"-";"-";"-";"-";"-";"-";"-"
"03 Wrz 2024 00:00:28";"Zmodyfikowano Transakcję Sprzedaży";"O2-D5-973Z4E";"T2-D5-5KPFZK";"-";"Solana (USD)";"105 Jednost.";"133,945";"-";"-";"128,000";"-";"-";"-";"0,00";"-";"-";"-";"-";"-";"-";"-";"-";"-";"-";"-";"-";"-";"-";"-";"-";"-";"-";"-";"-";"-";"-";"-";"-";"-"
"02 Wrz 2024 23:49:26";"Zmodyfikowano Transakcję Sprzedaży";"O2-D5-973Z4E";"T2-D5-5KPFZK";"-";"Solana (USD)";"105 Jednost.";"133,945";"-";"-";"-";"-";"-";"-";"0,00";"-";"-";"-";"-";"-";"-";"-";"-";"-";"-";"-";"-";"-";"-";"-";"-";"-";"-";"-";"-";"-";"-";"-";"-";"-"
"02 Wrz 2024 23:49:10";"Transakcja Sprzedaży";"O2-D5-973Z4E";"T2-D5-5KPFZK";"-";"Solana (USD)";"105 Jednost.";"133,945";"-";"136,623";"-";"-";"3,875756";"54 509,50";"0,00";"-";"-";"-";"-";"-";"-";"-";"-";"-";"-";"-";"-";"-";"-";"-";"-";"-";"-";"-";"-";"-";"-";"-";"-";"-"
"02 Wrz 2024 23:15:07";" Zamknięcie Transakcji";"O2-D5-973Z0R";"T2-D5-5KPFYG";"O2-D5-972JBB";"Solana (USD)";"20 Jednost.";"134,830";"-";"-";"-";"-";"3,83684";"10 450,41";"84,41";"56 678,67";"-";"-";"-";"-";"-";"-";"-";"-";"-";"-";"-";"-";"-";"-";"-";"-";"-";"-";"-";"-";"-";"-";"-";"-"
"02 Wrz 2024 23:14:30";" Zamknięcie Transakcji";"O2-D5-973Z0Q";"T2-D5-5KPFYF";"O2-D5-971PZ6";"Solana (USD)";"90 Jednost.";"134,845";"-";"-";"-";"-";"3,83689";"47 032,71";"1 015,24";"56 594,26";"-";"-";"-";"-";"-";"-";"-";"-";"-";"-";"-";"-";"-";"-";"-";"-";"-";"-";"-";"-";"-";"-";"-";"-"
"02 Wrz 2024 23:00:44";"Koszty Utrzymania Pozycji";"1369519953";"-";"-";"Rachunek";"-";"-";"-";"-";"-";"-";"-";"-";"-75,54";"55 579,02";"-";"-";"-";"-";"-";"-75,54";"-";"-";"-";"-";"-";"-";"-";"-";"-";"-";"-";"-";"-";"-";"-";"-";"-";"-"
"02 Wrz 2024 23:00:44";"Koszty Utrzymania Pozycji";"O2-D5-970BTR";"-";"-";"Solana (USD)";"-";"-";"-";"-";"-";"-";"-";"-";"-";"-";"-";"-";"5 383,00";"-10,00000%";"5,66";"5,66";"-";"-";"-";"-";"-";"-";"-";"-";"-";"-";"-";"-";"-";"-";"-";"-";"-";"-"
"02 Wrz 2024 23:00:44";"Koszty Utrzymania Pozycji";"O2-D5-96SWM1";"-";"-";"Solana (USD)";"-";"-";"-";"-";"-";"-";"-";"-";"-";"-";"-";"-";"11 304,30";"-27,50000%";"-33,01";"-33,01";"-";"-";"-";"-";"-";"-";"-";"-";"-";"-";"-";"-";"-";"-";"-";"-";"-";"-"
"02 Wrz 2024 23:00:44";"Koszty Utrzymania Pozycji";"O2-D4-95TL4Z";"-";"-";"Solana (USD)";"-";"-";"-";"-";"-";"-";"-";"-";"-";"-";"-";"-";"3 027,93";"-27,50000%";"-8,84";"-8,84";"-";"-";"-";"-";"-";"-";"-";"-";"-";"-";"-";"-";"-";"-";"-";"-";"-";"-"
"02 Wrz 2024 23:00:44";"Koszty Utrzymania Pozycji";"O2-D5-971PZ6";"-";"-";"Solana (USD)";"-";"-";"-";"-";"-";"-";"-";"-";"-";"-";"-";"-";"12 111,75";"-10,00000%";"12,73";"12,73";"-";"-";"-";"-";"-";"-";"-";"-";"-";"-";"-";"-";"-";"-";"-";"-";"-";"-"
"02 Wrz 2024 23:00:44";"Koszty Utrzymania Pozycji";"O2-D5-972JBB";"-";"-";"Solana (USD)";"-";"-";"-";"-";"-";"-";"-";"-";"-";"-";"-";"-";"9 420,25";"-10,00000%";"9,90";"9,90";"-";"-";"-";"-";"-";"-";"-";"-";"-";"-";"-";"-";"-";"-";"-";"-";"-";"-"
"02 Wrz 2024 23:00:44";"Koszty Utrzymania Pozycji";"O2-D5-96WE65";"-";"-";"Solana (USD)";"-";"-";"-";"-";"-";"-";"-";"-";"-";"-";"-";"-";"6 459,60";"-27,50000%";"-18,86";"-18,86";"-";"-";"-";"-";"-";"-";"-";"-";"-";"-";"-";"-";"-";"-";"-";"-";"-";"-"
"02 Wrz 2024 23:00:44";"Koszty Utrzymania Pozycji";"O2-D4-96156D";"-";"-";"Solana (USD)";"-";"-";"-";"-";"-";"-";"-";"-";"-";"-";"-";"-";"3 297,08";"-27,50000%";"-9,63";"-9,63";"-";"-";"-";"-";"-";"-";"-";"-";"-";"-";"-";"-";"-";"-";"-";"-";"-";"-"
"02 Wrz 2024 23:00:44";"Koszty Utrzymania Pozycji";"O2-D3-94JY88";"-";"-";"Solana (USD)";"-";"-";"-";"-";"-";"-";"-";"-";"-";"-";"-";"-";"6 728,75";"-27,50000%";"-19,65";"-19,65";"-";"-";"-";"-";"-";"-";"-";"-";"-";"-";"-";"-";"-";"-";"-";"-";"-";"-"
"02 Wrz 2024 23:00:44";"Koszty Utrzymania Pozycji";"O2-D3-94S9LM";"-";"-";"Solana (USD)";"-";"-";"-";"-";"-";"-";"-";"-";"-";"-";"-";"-";"9 420,25";"-27,50000%";"-27,51";"-27,51";"-";"-";"-";"-";"-";"-";"-";"-";"-";"-";"-";"-";"-";"-";"-";"-";"-";"-"
"02 Wrz 2024 23:00:44";"Koszty Utrzymania Pozycji";"O2-D5-973J4B";"-";"-";"Solana (USD)";"-";"-";"-";"-";"-";"-";"-";"-";"-";"-";"-";"-";"5 383,00";"-10,00000%";"5,66";"5,66";"-";"-";"-";"-";"-";"-";"-";"-";"-";"-";"-";"-";"-";"-";"-";"-";"-";"-"
"02 Wrz 2024 23:00:44";"Koszty Utrzymania Pozycji";"O2-D4-95EL0T";"-";"-";"Solana (USD)";"-";"-";"-";"-";"-";"-";"-";"-";"-";"-";"-";"-";"4 037,25";"-27,50000%";"-11,79";"-11,79";"-";"-";"-";"-";"-";"-";"-";"-";"-";"-";"-";"-";"-";"-";"-";"-";"-";"-"
"02 Wrz 2024 23:00:44";"Koszty Utrzymania Pozycji";"O2-D4-95P4DE";"-";"-";"Solana (USD)";"-";"-";"-";"-";"-";"-";"-";"-";"-";"-";"-";"-";"4 037,25";"-10,00000%";"4,24";"4,24";"-";"-";"-";"-";"-";"-";"-";"-";"-";"-";"-";"-";"-";"-";"-";"-";"-";"-"
"02 Wrz 2024 23:00:44";"Koszty Utrzymania Pozycji";"O2-D4-95K8MW";"-";"-";"Solana (USD)";"-";"-";"-";"-";"-";"-";"-";"-";"-";"-";"-";"-";"14 803,25";"-10,00000%";"15,56";"15,56";"-";"-";"-";"-";"-";"-";"-";"-";"-";"-";"-";"-";"-";"-";"-";"-";"-";"-"
"02 Wrz 2024 16:37:42";" Zamknięcie Transakcji";"O2-D5-973Q1T";"T2-D5-5KPC49";"O2-D5-973PP7";"Solana (USD)";"100 Jednost.";"132,537";"-";"-";"-";"-";"3,83978";"51 402,76";"21,89";"55 654,56";"-";"-";"-";"-";"-";"-";"-";"-";"-";"-";"-";"-";"-";"-";"-";"-";"-";"-";"-";"-";"-";"-";"-";"-"
"02 Wrz 2024 16:31:21";" Transakcja Kupna";"O2-D5-973PP7";"T2-D5-5KPBRF";"-";"Solana (USD)";"100 Jednost.";"132,480";"-";"129,832";"-";"-";"3,881888";"51 427,25";"0,00";"-";"-";"-";"-";"-";"-";"-";"-";"-";"-";"-";"-";"-";"-";"-";"-";"-";"-";"-";"-";"-";"-";"-";"-";"-"
"02 Wrz 2024 13:43:26";"Zmodyfikowano Transakcję Sprzedaży";"O2-D5-973J4B";"T2-D5-5KP65V";"-";"Solana (USD)";"40 Jednost.";"131,716";"-";"-";"-";"-";"-";"-";"0,00";"-";"-";"-";"-";"-";"-";"-";"-";"-";"-";"-";"-";"-";"-";"-";"-";"-";"-";"-";"-";"-";"-";"-";"-";"-"
"02 Wrz 2024 13:43:13";"Transakcja Sprzedaży";"O2-D5-973J4B";"T2-D5-5KP65V";"-";"Solana (USD)";"40 Jednost.";"131,716";"-";"134,351";"-";"-";"3,886166";"20 474,80";"0,00";"-";"-";"-";"-";"-";"-";"-";"-";"-";"-";"-";"-";"-";"-";"-";"-";"-";"-";"-";"-";"-";"-";"-";"-";"-"
"02 Wrz 2024 13:27:03";"Stop Loss";"O2-D5-973GBH";"T2-D5-5KP5TP";"-";"Solana (USD)";"50 Jednost.";"132,220";"-";"-";"-";"-";"3,84577";"25 679,98";"11,73";"55 632,67";"-";"-";"-";"-";"-";"-";"-";"-";"-";"-";"-";"-";"-";"-";"-";"-";"-";"-";"-";"-";"-";"-";"-";"-"
"02 Wrz 2024 13:26:56";" Zmodyfikowano Transakcję Kupna";"O2-D5-973GBH";"T2-D5-5KP54D";"-";"Solana (USD)";"50 Jednost.";"132,159";"-";"132,220";"133,300";"-";"-";"-";"0,00";"-";"-";"-";"-";"-";"-";"-";"-";"-";"-";"-";"-";"-";"-";"-";"-";"-";"-";"-";"-";"-";"-";"-";"-";"-"
"02 Wrz 2024 12:48:22";"Zmodyfikowano Take Profit";"O2-D5-973GBH";"-";"O2-D5-973GCX";"Solana (USD)";"50 Jednost.";"132,159";"-";"-";"133,300";"-";"-";"-";"-";"-";"-";"-";"-";"-";"-";"-";"-";"-";"-";"-";"-";"-";"-";"-";"-";"-";"-";"-";"-";"-";"-";"-";"-";"-"
"02 Wrz 2024 12:46:53";" Zmodyfikowano Transakcję Kupna";"O2-D5-973GBH";"T2-D5-5KP54D";"-";"Solana (USD)";"50 Jednost.";"132,159";"-";"-";"133,000";"-";"-";"-";"0,00";"-";"-";"-";"-";"-";"-";"-";"-";"-";"-";"-";"-";"-";"-";"-";"-";"-";"-";"-";"-";"-";"-";"-";"-";"-"
"02 Wrz 2024 12:46:09";" Zmodyfikowano Transakcję Kupna";"O2-D5-973GBH";"T2-D5-5KP54D";"-";"Solana (USD)";"50 Jednost.";"132,159";"-";"-";"-";"-";"-";"-";"0,00";"-";"-";"-";"-";"-";"-";"-";"-";"-";"-";"-";"-";"-";"-";"-";"-";"-";"-";"-";"-";"-";"-";"-";"-";"-"
"02 Wrz 2024 12:45:58";" Transakcja Kupna";"O2-D5-973GBH";"T2-D5-5KP54D";"-";"Solana (USD)";"50 Jednost.";"132,159";"-";"129,516";"-";"-";"3,883581";"25 662,50";"0,00";"-";"-";"-";"-";"-";"-";"-";"-";"-";"-";"-";"-";"-";"-";"-";"-";"-";"-";"-";"-";"-";"-";"-";"-";"-"
"02 Wrz 2024 12:22:45";" Zamknięcie Transakcji";"O2-D5-973F0Z";"T2-D5-5KP4PE";"O2-D5-972R01";"Solana (USD)";"36 Jednost.";"132,455";"-";"-";"-";"-";"3,84406";"18 514,13";"116,94";"55 620,94";"-";"-";"-";"-";"-";"-";"-";"-";"-";"-";"-";"-";"-";"-";"-";"-";"-";"-";"-";"-";"-";"-";"-";"-"
"02 Wrz 2024 12:18:47";" Zamknięcie Transakcji";"O2-D5-973EVQ";"T2-D5-5KP4MS";"O2-D5-973DKC";"Solana (USD)";"100 Jednost.";"131,935";"-";"-";"-";"-";"3,84419";"51 227,98";"246,80";"55 504,00";"-";"-";"-";"-";"-";"-";"-";"-";"-";"-";"-";"-";"-";"-";"-";"-";"-";"-";"-";"-";"-";"-";"-";"-"
"02 Wrz 2024 11:53:00";" Zmodyfikowano Transakcję Kupna";"O2-D5-973DKC";"T2-D5-5KP45B";"-";"Solana (USD)";"100 Jednost.";"131,293";"-";"-";"-";"-";"-";"-";"0,00";"-";"-";"-";"-";"-";"-";"-";"-";"-";"-";"-";"-";"-";"-";"-";"-";"-";"-";"-";"-";"-";"-";"-";"-";"-"
"02 Wrz 2024 11:52:49";" Transakcja Kupna";"O2-D5-973DKC";"T2-D5-5KP45B";"-";"Solana (USD)";"100 Jednost.";"131,293";"-";"128,674";"-";"-";"3,885756";"51 017,25";"0,00";"-";"-";"-";"-";"-";"-";"-";"-";"-";"-";"-";"-";"-";"-";"-";"-";"-";"-";"-";"-";"-";"-";"-";"-";"-"
"02 Wrz 2024 10:26:45";" Zamknięcie Transakcji";"O2-D5-9739B1";"T2-D5-5KP1JT";"O2-D5-9738XD";"Solana (USD)";"100 Jednost.";"129,643";"-";"-";"-";"-";"3,8457";"50 357,91";"60,76";"55 257,20";"-";"-";"-";"-";"-";"-";"-";"-";"-";"-";"-";"-";"-";"-";"-";"-";"-";"-";"-";"-";"-";"-";"-";"-"
"02 Wrz 2024 10:24:07";" Zmodyfikowano Transakcję Kupna";"O2-D5-9738XD";"T2-D5-5KP16C";"-";"Solana (USD)";"100 Jednost.";"129,485";"-";"-";"130,200";"-";"-";"-";"0,00";"-";"-";"-";"-";"-";"-";"-";"-";"-";"-";"-";"-";"-";"-";"-";"-";"-";"-";"-";"-";"-";"-";"-";"-";"-"
"02 Wrz 2024 10:20:22";" Zmodyfikowano Transakcję Kupna";"O2-D5-9738XD";"T2-D5-5KP16C";"-";"Solana (USD)";"100 Jednost.";"129,485";"-";"-";"-";"-";"-";"-";"0,00";"-";"-";"-";"-";"-";"-";"-";"-";"-";"-";"-";"-";"-";"-";"-";"-";"-";"-";"-";"-";"-";"-";"-";"-";"-"
"02 Wrz 2024 10:20:05";" Transakcja Kupna";"O2-D5-9738XD";"T2-D5-5KP16C";"-";"Solana (USD)";"100 Jednost.";"129,485";"-";"126,886";"-";"-";"3,88292";"50 277,98";"0,00";"-";"-";"-";"-";"-";"-";"-";"-";"-";"-";"-";"-";"-";"-";"-";"-";"-";"-";"-";"-";"-";"-";"-";"-";"-"
"02 Wrz 2024 00:03:22";"Zmodyfikowano Transakcję Sprzedaży";"O2-D5-972R01";"T2-D5-5KNLZC";"-";"Solana (USD)";"36 Jednost.";"133,300";"-";"-";"-";"-";"-";"-";"0,00";"-";"-";"-";"-";"-";"-";"-";"-";"-";"-";"-";"-";"-";"-";"-";"-";"-";"-";"-";"-";"-";"-";"-";"-";"-"
"02 Wrz 2024 00:03:09";"Transakcja Sprzedaży";"O2-D5-972R01";"T2-D5-5KNLZC";"-";"Solana (USD)";"36 Jednost.";"133,300";"-";"135,966";"-";"-";"3,896457";"18 698,31";"0,00";"-";"-";"-";"-";"-";"-";"-";"-";"-";"-";"-";"-";"-";"-";"-";"-";"-";"-";"-";"-";"-";"-";"-";"-";"-"
"30 Sie 2024 23:00:43";"Koszty Utrzymania Pozycji";"1369218138";"-";"-";"Rachunek";"-";"-";"-";"-";"-";"-";"-";"-";"-247,36";"55 196,44";"-";"-";"-";"-";"-";"-247,36";"-";"-";"-";"-";"-";"-";"-";"-";"-";"-";"-";"-";"-";"-";"-";"-";"-";"-"
"30 Sie 2024 23:00:43";"Koszty Utrzymania Pozycji";"O2-D5-970BTR";"-";"-";"Solana (USD)";"-";"-";"-";"-";"-";"-";"-";"-";"-";"-";"-";"-";"5 438,60";"-10,00000%";"17,24";"17,24";"-";"-";"-";"-";"-";"-";"-";"-";"-";"-";"-";"-";"-";"-";"-";"-";"-";"-"
"30 Sie 2024 23:00:43";"Koszty Utrzymania Pozycji";"O2-D5-96SWM1";"-";"-";"Solana (USD)";"-";"-";"-";"-";"-";"-";"-";"-";"-";"-";"-";"-";"11 421,06";"-27,50000%";"-100,57";"-100,57";"-";"-";"-";"-";"-";"-";"-";"-";"-";"-";"-";"-";"-";"-";"-";"-";"-";"-"
"30 Sie 2024 23:00:43";"Koszty Utrzymania Pozycji";"O2-D4-95TL4Z";"-";"-";"Solana (USD)";"-";"-";"-";"-";"-";"-";"-";"-";"-";"-";"-";"-";"3 059,21";"-27,50000%";"-26,94";"-26,94";"-";"-";"-";"-";"-";"-";"-";"-";"-";"-";"-";"-";"-";"-";"-";"-";"-";"-"
"30 Sie 2024 23:00:43";"Koszty Utrzymania Pozycji";"O2-D5-971PZ6";"-";"-";"Solana (USD)";"-";"-";"-";"-";"-";"-";"-";"-";"-";"-";"-";"-";"12 236,85";"-10,00000%";"38,79";"38,79";"-";"-";"-";"-";"-";"-";"-";"-";"-";"-";"-";"-";"-";"-";"-";"-";"-";"-"
"30 Sie 2024 23:00:43";"Koszty Utrzymania Pozycji";"O2-D5-972JBB";"-";"-";"Solana (USD)";"-";"-";"-";"-";"-";"-";"-";"-";"-";"-";"-";"-";"9 517,55";"-10,00000%";"30,17";"30,17";"-";"-";"-";"-";"-";"-";"-";"-";"-";"-";"-";"-";"-";"-";"-";"-";"-";"-"
"30 Sie 2024 23:00:43";"Koszty Utrzymania Pozycji";"O2-D5-96WE65";"-";"-";"Solana (USD)";"-";"-";"-";"-";"-";"-";"-";"-";"-";"-";"-";"-";"6 526,32";"-27,50000%";"-57,47";"-57,47";"-";"-";"-";"-";"-";"-";"-";"-";"-";"-";"-";"-";"-";"-";"-";"-";"-";"-"
"30 Sie 2024 23:00:43";"Koszty Utrzymania Pozycji";"O2-D4-96156D";"-";"-";"Solana (USD)";"-";"-";"-";"-";"-";"-";"-";"-";"-";"-";"-";"-";"3 331,14";"-27,50000%";"-29,33";"-29,33";"-";"-";"-";"-";"-";"-";"-";"-";"-";"-";"-";"-";"-";"-";"-";"-";"-";"-"
"30 Sie 2024 23:00:43";"Koszty Utrzymania Pozycji";"O2-D3-94JY88";"-";"-";"Solana (USD)";"-";"-";"-";"-";"-";"-";"-";"-";"-";"-";"-";"-";"6 798,25";"-27,50000%";"-59,86";"-59,86";"-";"-";"-";"-";"-";"-";"-";"-";"-";"-";"-";"-";"-";"-";"-";"-";"-";"-"
"30 Sie 2024 23:00:43";"Koszty Utrzymania Pozycji";"O2-D3-94S9LM";"-";"-";"Solana (USD)";"-";"-";"-";"-";"-";"-";"-";"-";"-";"-";"-";"-";"9 517,55";"-27,50000%";"-83,81";"-83,81";"-";"-";"-";"-";"-";"-";"-";"-";"-";"-";"-";"-";"-";"-";"-";"-";"-";"-"
"30 Sie 2024 23:00:43";"Koszty Utrzymania Pozycji";"O2-D4-95EL0T";"-";"-";"Solana (USD)";"-";"-";"-";"-";"-";"-";"-";"-";"-";"-";"-";"-";"4 078,95";"-27,50000%";"-35,92";"-35,92";"-";"-";"-";"-";"-";"-";"-";"-";"-";"-";"-";"-";"-";"-";"-";"-";"-";"-"
"30 Sie 2024 23:00:43";"Koszty Utrzymania Pozycji";"O2-D4-95P4DE";"-";"-";"Solana (USD)";"-";"-";"-";"-";"-";"-";"-";"-";"-";"-";"-";"-";"4 078,95";"-10,00000%";"12,93";"12,93";"-";"-";"-";"-";"-";"-";"-";"-";"-";"-";"-";"-";"-";"-";"-";"-";"-";"-"
"30 Sie 2024 23:00:43";"Koszty Utrzymania Pozycji";"O2-D4-95K8MW";"-";"-";"Solana (USD)";"-";"-";"-";"-";"-";"-";"-";"-";"-";"-";"-";"-";"14 956,15";"-10,00000%";"47,41";"47,41";"-";"-";"-";"-";"-";"-";"-";"-";"-";"-";"-";"-";"-";"-";"-";"-";"-";"-"
"30 Sie 2024 21:13:59";"Transakcja Sprzedaży";"O2-D5-972JBB";"T2-D5-5KNFV0";"-";"Solana (USD)";"70 Jednost.";"135,930";"-";"-";"-";"-";"3,894032";"37 052,10";"0,00";"-";"-";"-";"-";"-";"-";"-";"-";"-";"-";"-";"-";"-";"-";"-";"-";"-";"-";"-";"-";"-";"-";"-";"-";"-"
"30 Sie 2024 20:38:33";" Zamknięcie Transakcji";"O2-D5-972FWB";"T2-D5-5KNDVK";"O2-D5-970BTR";"Solana (USD)";"4 Jednost.";"137,735";"-";"-";"-";"-";"3,85478";"2 145,09";"17,35";"55 443,80";"-";"-";"-";"-";"-";"-";"-";"-";"-";"-";"-";"-";"-";"-";"-";"-";"-";"-";"-";"-";"-";"-";"-";"-"
"30 Sie 2024 20:37:43";"Zmodyfikowano Transakcję Sprzedaży";"O2-D5-971PZ6";"T2-D5-5KMT3B";"-";"Solana (USD)";"90 Jednost.";"137,785";"-";"-";"-";"-";"-";"-";"0,00";"-";"-";"-";"-";"-";"-";"-";"-";"-";"-";"-";"-";"-";"-";"-";"-";"-";"-";"-";"-";"-";"-";"-";"-";"-"
"30 Sie 2024 20:37:27";" Zamknięcie Transakcji";"O2-D5-972FQD";"T2-D5-5KNDQV";"O2-D4-95NXX0";"Solana (USD)";"11 Jednost.";"136,860";"-";"-";"-";"-";"3,85496";"5 861,81";"11,24";"55 426,45";"-";"-";"-";"-";"-";"-";"-";"-";"-";"-";"-";"-";"-";"-";"-";"-";"-";"-";"-";"-";"-";"-";"-";"-"
"30 Sie 2024 20:37:16";" Zamknięcie Transakcji";"O2-D5-972FQ6";"T2-D5-5KNDQN";"O2-D4-95NXX0";"Solana (USD)";"90 Jednost.";"136,765";"-";"-";"-";"-";"3,85496";"47 926,98";"124,90";"55 415,21";"-";"-";"-";"-";"-";"-";"-";"-";"-";"-";"-";"-";"-";"-";"-";"-";"-";"-";"-";"-";"-";"-";"-";"-"
"30 Sie 2024 16:52:05";"Zmodyfikowano Transakcję Sprzedaży";"O2-D5-971PZ6";"T2-D5-5KMT3B";"-";"Solana (USD)";"90 Jednost.";"137,785";"-";"137,500";"-";"-";"-";"-";"0,00";"-";"-";"-";"-";"-";"-";"-";"-";"-";"-";"-";"-";"-";"-";"-";"-";"-";"-";"-";"-";"-";"-";"-";"-";"-"
"30 Sie 2024 16:33:37";"Zmodyfikowano Transakcję Sprzedaży";"O2-D5-971PZ6";"T2-D5-5KMT3B";"-";"Solana (USD)";"90 Jednost.";"137,785";"-";"-";"-";"-";"-";"-";"0,00";"-";"-";"-";"-";"-";"-";"-";"-";"-";"-";"-";"-";"-";"-";"-";"-";"-";"-";"-";"-";"-";"-";"-";"-";"-"
"30 Sie 2024 16:33:27";"Transakcja Sprzedaży";"O2-D5-971PZ6";"T2-D5-5KMT3B";"-";"Solana (USD)";"90 Jednost.";"137,785";"-";"140,561";"-";"-";"3,884042";"48 164,64";"0,00";"-";"-";"-";"-";"-";"-";"-";"-";"-";"-";"-";"-";"-";"-";"-";"-";"-";"-";"-";"-";"-";"-";"-";"-";"-"
"30 Sie 2024 16:22:51";" Zamknięcie Transakcji";"O2-D5-971NG7";"T2-D5-5KMRRG";"O2-D5-971JEW";"Solana (USD)";"90 Jednost.";"138,166";"-";"-";"-";"-";"3,84708";"48 318,89";"48,47";"55 290,31";"-";"-";"-";"-";"-";"-";"-";"-";"-";"-";"-";"-";"-";"-";"-";"-";"-";"-";"-";"-";"-";"-";"-";"-"
"30 Sie 2024 15:56:34";"Zmodyfikowano Transakcję Sprzedaży";"O2-D5-971JEW";"T2-D5-5KMN68";"-";"Solana (USD)";"90 Jednost.";"138,306";"-";"-";"-";"-";"-";"-";"0,00";"-";"-";"-";"-";"-";"-";"-";"-";"-";"-";"-";"-";"-";"-";"-";"-";"-";"-";"-";"-";"-";"-";"-";"-";"-"
"30 Sie 2024 15:53:25";"Zmodyfikowano Transakcję Sprzedaży";"O2-D5-971JEW";"T2-D5-5KMN68";"-";"Solana (USD)";"90 Jednost.";"138,306";"-";"-";"136,923";"-";"-";"-";"0,00";"-";"-";"-";"-";"-";"-";"-";"-";"-";"-";"-";"-";"-";"-";"-";"-";"-";"-";"-";"-";"-";"-";"-";"-";"-"
"30 Sie 2024 15:52:47";"Transakcja Sprzedaży";"O2-D5-971JEW";"T2-D5-5KMN68";"-";"Solana (USD)";"90 Jednost.";"138,306";"-";"141,072";"-";"-";"3,884834";"48 356,62";"0,00";"-";"-";"-";"-";"-";"-";"-";"-";"-";"-";"-";"-";"-";"-";"-";"-";"-";"-";"-";"-";"-";"-";"-";"-";"-"
"30 Sie 2024 13:12:47";" Zamknięcie Transakcji";"O2-D5-9713KJ";"T2-D5-5KMBNN";"O2-D5-9710M1";"Solana (USD)";"92 Jednost.";"139,505";"-";"-";"-";"-";"3,83877";"49 763,68";"5,30";"55 241,84";"-";"-";"-";"-";"-";"-";"-";"-";"-";"-";"-";"-";"-";"-";"-";"-";"-";"-";"-";"-";"-";"-";"-";"-"
"30 Sie 2024 12:36:06";"Zmodyfikowano Transakcję Sprzedaży";"O2-D5-9710M1";"T2-D5-5KM9H4";"-";"Solana (USD)";"92 Jednost.";"139,520";"-";"-";"-";"-";"-";"-";"0,00";"-";"-";"-";"-";"-";"-";"-";"-";"-";"-";"-";"-";"-";"-";"-";"-";"-";"-";"-";"-";"-";"-";"-";"-";"-"
"30 Sie 2024 12:35:51";"Transakcja Sprzedaży";"O2-D5-9710M1";"T2-D5-5KM9H4";"-";"Solana (USD)";"92 Jednost.";"139,520";"-";"142,310";"-";"-";"3,880706";"49 812,12";"0,00";"-";"-";"-";"-";"-";"-";"-";"-";"-";"-";"-";"-";"-";"-";"-";"-";"-";"-";"-";"-";"-";"-";"-";"-";"-"
"30 Sie 2024 05:45:59";"Zmodyfikowano Transakcję Sprzedaży";"O2-D5-970BTR";"T2-D5-5KLXYL";"-";"Solana (USD)";"44 Jednost.";"138,860";"-";"-";"-";"-";"-";"-";"0,00";"-";"-";"-";"-";"-";"-";"-";"-";"-";"-";"-";"-";"-";"-";"-";"-";"-";"-";"-";"-";"-";"-";"-";"-";"-"
"30 Sie 2024 05:45:43";"Transakcja Sprzedaży";"O2-D5-970BTR";"T2-D5-5KLXYL";"-";"Solana (USD)";"44 Jednost.";"138,860";"-";"141,637";"-";"-";"3,888722";"23 759,46";"0,00";"-";"-";"-";"-";"-";"-";"-";"-";"-";"-";"-";"-";"-";"-";"-";"-";"-";"-";"-";"-";"-";"-";"-";"-";"-"
"30 Sie 2024 05:33:17";" Zamknięcie Transakcji";"O2-D5-970BN8";"T2-D5-5KLXSW";"O2-D5-97051M";"Solana (USD)";"112 Jednost.";"138,655";"-";"-";"-";"-";"3,888";"60 378,15";"-168,52";"55 236,54";"-";"-";"-";"-";"-";"-";"-";"-";"-";"-";"-";"-";"-";"-";"-";"-";"-";"-";"-";"-";"-";"-";"-";"-"
"30 Sie 2024 05:28:30";"Zmodyfikowano Transakcję Sprzedaży";"O2-D5-97051M";"T2-D5-5KLSLW";"-";"Solana (USD)";"112 Jednost.";"138,268";"-";"-";"138,000";"-";"-";"-";"0,00";"-";"-";"-";"-";"-";"-";"-";"-";"-";"-";"-";"-";"-";"-";"-";"-";"-";"-";"-";"-";"-";"-";"-";"-";"-"
"30 Sie 2024 00:41:56";" Zamknięcie Transakcji";"O2-D5-9705S8";"T2-D5-5KLSX8";"O2-D5-963NM0";"Solana (USD)";"22 Jednost.";"139,765";"-";"-";"-";"-";"3,84836";"11 951,98";"219,70";"55 405,06";"-";"-";"-";"-";"-";"-";"-";"-";"-";"-";"-";"-";"-";"-";"-";"-";"-";"-";"-";"-";"-";"-";"-";"-"
"30 Sie 2024 00:17:48";"Zmodyfikowano Transakcję Sprzedaży";"O2-D5-97051M";"T2-D5-5KLSLW";"-";"Solana (USD)";"112 Jednost.";"138,268";"-";"-";"-";"-";"-";"-";"0,00";"-";"-";"-";"-";"-";"-";"-";"-";"-";"-";"-";"-";"-";"-";"-";"-";"-";"-";"-";"-";"-";"-";"-";"-";"-"
"30 Sie 2024 00:07:28";"Transakcja Sprzedaży";"O2-D5-97051M";"T2-D5-5KLSLW";"-";"Solana (USD)";"112 Jednost.";"138,268";"-";"141,060";"-";"-";"3,888421";"60 216,14";"0,00";"-";"-";"-";"-";"-";"-";"-";"-";"-";"-";"-";"-";"-";"-";"-";"-";"-";"-";"-";"-";"-";"-";"-";"-";"-"
"30 Sie 2024 00:01:47";"Stop Loss";"O2-D5-9704MJ";"T2-D5-5KLSG8";"-";"Solana (USD)";"112 Jednost.";"139,110";"-";"-";"-";"-";"3,84992";"60 585,95";"127,63";"55 185,36";"-";"-";"-";"-";"-";"-";"-";"-";"-";"-";"-";"-";"-";"-";"-";"-";"-";"-";"-";"-";"-";"-";"-";"-"
"30 Sie 2024 00:01:00";"Zmodyfikowano Transakcję Sprzedaży";"O2-D5-9704MJ";"T2-D5-5KLSCX";"-";"Solana (USD)";"112 Jednost.";"139,406";"-";"139,100";"-";"-";"-";"-";"0,00";"-";"-";"-";"-";"-";"-";"-";"-";"-";"-";"-";"-";"-";"-";"-";"-";"-";"-";"-";"-";"-";"-";"-";"-";"-"
"29 Sie 2024 23:16:05";"Zmodyfikowano Transakcję Sprzedaży";"O2-D5-9704MJ";"T2-D5-5KLSCX";"-";"Solana (USD)";"112 Jednost.";"139,406";"-";"-";"-";"-";"-";"-";"0,00";"-";"-";"-";"-";"-";"-";"-";"-";"-";"-";"-";"-";"-";"-";"-";"-";"-";"-";"-";"-";"-";"-";"-";"-";"-"
"29 Sie 2024 23:15:47";"Transakcja Sprzedaży";"O2-D5-9704MJ";"T2-D5-5KLSCX";"-";"Solana (USD)";"112 Jednost.";"139,406";"-";"142,182";"-";"-";"3,89299";"60 783,09";"0,00";"-";"-";"-";"-";"-";"-";"-";"-";"-";"-";"-";"-";"-";"-";"-";"-";"-";"-";"-";"-";"-";"-";"-";"-";"-"
"29 Sie 2024 23:00:49";"Koszty Utrzymania Pozycji";"1368781257";"-";"-";"Rachunek";"-";"-";"-";"-";"-";"-";"-";"-";"-96,25";"55 057,73";"-";"-";"-";"-";"-";"-96,25";"-";"-";"-";"-";"-";"-";"-";"-";"-";"-";"-";"-";"-";"-";"-";"-";"-";"-"
"29 Sie 2024 23:00:49";"Koszty Utrzymania Pozycji";"O2-D5-96SWM1";"-";"-";"Solana (USD)";"-";"-";"-";"-";"-";"-";"-";"-";"-";"-";"-";"-";"11 783,10";"-27,50000%";"-34,51";"-34,51";"-";"-";"-";"-";"-";"-";"-";"-";"-";"-";"-";"-";"-";"-";"-";"-";"-";"-"
"29 Sie 2024 23:00:49";"Koszty Utrzymania Pozycji";"O2-D4-95TL4Z";"-";"-";"Solana (USD)";"-";"-";"-";"-";"-";"-";"-";"-";"-";"-";"-";"-";"3 156,18";"-27,50000%";"-9,24";"-9,24";"-";"-";"-";"-";"-";"-";"-";"-";"-";"-";"-";"-";"-";"-";"-";"-";"-";"-"
"29 Sie 2024 23:00:49";"Koszty Utrzymania Pozycji";"O2-D5-963NM0";"-";"-";"Solana (USD)";"-";"-";"-";"-";"-";"-";"-";"-";"-";"-";"-";"-";"3 086,05";"-10,00000%";"3,25";"3,25";"-";"-";"-";"-";"-";"-";"-";"-";"-";"-";"-";"-";"-";"-";"-";"-";"-";"-"
"29 Sie 2024 23:00:49";"Koszty Utrzymania Pozycji";"O2-D5-96WE65";"-";"-";"Solana (USD)";"-";"-";"-";"-";"-";"-";"-";"-";"-";"-";"-";"-";"6 733,20";"-27,50000%";"-19,72";"-19,72";"-";"-";"-";"-";"-";"-";"-";"-";"-";"-";"-";"-";"-";"-";"-";"-";"-";"-"
"29 Sie 2024 23:00:49";"Koszty Utrzymania Pozycji";"O2-D4-96156D";"-";"-";"Solana (USD)";"-";"-";"-";"-";"-";"-";"-";"-";"-";"-";"-";"-";"3 436,73";"-27,50000%";"-10,06";"-10,06";"-";"-";"-";"-";"-";"-";"-";"-";"-";"-";"-";"-";"-";"-";"-";"-";"-";"-"
"29 Sie 2024 23:00:49";"Koszty Utrzymania Pozycji";"O2-D3-94JY88";"-";"-";"Solana (USD)";"-";"-";"-";"-";"-";"-";"-";"-";"-";"-";"-";"-";"7 013,75";"-27,50000%";"-20,54";"-20,54";"-";"-";"-";"-";"-";"-";"-";"-";"-";"-";"-";"-";"-";"-";"-";"-";"-";"-"
"29 Sie 2024 23:00:49";"Koszty Utrzymania Pozycji";"O2-D3-94S9LM";"-";"-";"Solana (USD)";"-";"-";"-";"-";"-";"-";"-";"-";"-";"-";"-";"-";"9 819,25";"-27,50000%";"-28,76";"-28,76";"-";"-";"-";"-";"-";"-";"-";"-";"-";"-";"-";"-";"-";"-";"-";"-";"-";"-"
"29 Sie 2024 23:00:49";"Koszty Utrzymania Pozycji";"O2-D4-95EL0T";"-";"-";"Solana (USD)";"-";"-";"-";"-";"-";"-";"-";"-";"-";"-";"-";"-";"4 208,25";"-27,50000%";"-12,32";"-12,32";"-";"-";"-";"-";"-";"-";"-";"-";"-";"-";"-";"-";"-";"-";"-";"-";"-";"-"
"29 Sie 2024 23:00:49";"Koszty Utrzymania Pozycji";"O2-D4-95P4DE";"-";"-";"Solana (USD)";"-";"-";"-";"-";"-";"-";"-";"-";"-";"-";"-";"-";"4 208,25";"-10,00000%";"4,44";"4,44";"-";"-";"-";"-";"-";"-";"-";"-";"-";"-";"-";"-";"-";"-";"-";"-";"-";"-"
"29 Sie 2024 23:00:49";"Koszty Utrzymania Pozycji";"O2-D4-95NXX0";"-";"-";"Solana (USD)";"-";"-";"-";"-";"-";"-";"-";"-";"-";"-";"-";"-";"14 167,77";"-10,00000%";"14,94";"14,94";"-";"-";"-";"-";"-";"-";"-";"-";"-";"-";"-";"-";"-";"-";"-";"-";"-";"-"
"29 Sie 2024 23:00:49";"Koszty Utrzymania Pozycji";"O2-D4-95K8MW";"-";"-";"Solana (USD)";"-";"-";"-";"-";"-";"-";"-";"-";"-";"-";"-";"-";"15 430,25";"-10,00000%";"16,27";"16,27";"-";"-";"-";"-";"-";"-";"-";"-";"-";"-";"-";"-";"-";"-";"-";"-";"-";"-"
"29 Sie 2024 22:26:43";"Stop Loss";"O2-D5-9703P3";"T2-D5-5KLRZR";"-";"Solana (USD)";"112 Jednost.";"139,700";"-";"-";"-";"-";"3,84799";"60 812,19";"474,07";"55 153,98";"-";"-";"-";"-";"-";"-";"-";"-";"-";"-";"-";"-";"-";"-";"-";"-";"-";"-";"-";"-";"-";"-";"-";"-"
"29 Sie 2024 22:25:24";"Zmodyfikowano Stop Loss";"O2-D5-9703P3";"-";"O2-D5-9703P4";"Solana (USD)";"112 Jednost.";"140,800";"-";"139,700";"-";"-";"-";"-";"-";"-";"-";"-";"-";"-";"-";"-";"-";"-";"-";"-";"-";"-";"-";"-";"-";"-";"-";"-";"-";"-";"-";"-";"-";"-"
"29 Sie 2024 22:25:01";"Zmodyfikowano Stop Loss";"O2-D5-9703P3";"-";"O2-D5-9703P4";"Solana (USD)";"112 Jednost.";"140,800";"-";"139,800";"-";"-";"-";"-";"-";"-";"-";"-";"-";"-";"-";"-";"-";"-";"-";"-";"-";"-";"-";"-";"-";"-";"-";"-";"-";"-";"-";"-";"-";"-"
"29 Sie 2024 22:23:52";"Zmodyfikowano Stop Loss";"O2-D5-9703P3";"-";"O2-D5-9703P4";"Solana (USD)";"112 Jednost.";"140,800";"-";"140,000";"-";"-";"-";"-";"-";"-";"-";"-";"-";"-";"-";"-";"-";"-";"-";"-";"-";"-";"-";"-";"-";"-";"-";"-";"-";"-";"-";"-";"-";"-"
"29 Sie 2024 22:23:20";"Zmodyfikowano Stop Loss";"O2-D5-9703P3";"-";"O2-D5-9703P4";"Solana (USD)";"112 Jednost.";"140,800";"-";"140,100";"-";"-";"-";"-";"-";"-";"-";"-";"-";"-";"-";"-";"-";"-";"-";"-";"-";"-";"-";"-";"-";"-";"-";"-";"-";"-";"-";"-";"-";"-"
"29 Sie 2024 22:22:41";"Zmodyfikowano Stop Loss";"O2-D5-9703P3";"-";"O2-D5-9703P4";"Solana (USD)";"112 Jednost.";"140,800";"-";"140,300";"-";"-";"-";"-";"-";"-";"-";"-";"-";"-";"-";"-";"-";"-";"-";"-";"-";"-";"-";"-";"-";"-";"-";"-";"-";"-";"-";"-";"-";"-"
"29 Sie 2024 22:22:07";"Zmodyfikowano Stop Loss";"O2-D5-9703P3";"-";"O2-D5-9703P4";"Solana (USD)";"112 Jednost.";"140,800";"-";"140,400";"-";"-";"-";"-";"-";"-";"-";"-";"-";"-";"-";"-";"-";"-";"-";"-";"-";"-";"-";"-";"-";"-";"-";"-";"-";"-";"-";"-";"-";"-"
"29 Sie 2024 22:21:39";"Zmodyfikowano Stop Loss";"O2-D5-9703P3";"-";"O2-D5-9703P4";"Solana (USD)";"112 Jednost.";"140,800";"-";"140,500";"-";"-";"-";"-";"-";"-";"-";"-";"-";"-";"-";"-";"-";"-";"-";"-";"-";"-";"-";"-";"-";"-";"-";"-";"-";"-";"-";"-";"-";"-"
"29 Sie 2024 22:10:19";"Transakcja Sprzedaży";"O2-D5-9703P3";"T2-D5-5KLRQ4";"-";"Solana (USD)";"112 Jednost.";"140,800";"-";"143,605";"-";"-";"3,886647";"61 290,86";"0,00";"-";"-";"-";"-";"-";"-";"-";"-";"-";"-";"-";"-";"-";"-";"-";"-";"-";"-";"-";"-";"-";"-";"-";"-";"-"
"29 Sie 2024 21:17:15";" Zamknięcie Transakcji";"O2-D5-96ZZTL";"T2-D5-5KLN7G";"O2-D5-96ZV44";"Solana (USD)";"109,05 Jednost.";"140,535";"-";"-";"-";"-";"3,84714";"59 551,30";"455,19";"54 679,91";"-";"-";"-";"-";"-";"-";"-";"-";"-";"-";"-";"-";"-";"-";"-";"-";"-";"-";"-";"-";"-";"-";"-";"-"
"29 Sie 2024 20:43:52";"Zmodyfikowano Transakcję Sprzedaży";"O2-D5-96ZV44";"T2-D5-5KLHSH";"-";"Solana (USD)";"109,05 Jednost.";"141,620";"-";"141,300";"-";"-";"-";"-";"0,00";"-";"-";"-";"-";"-";"-";"-";"-";"-";"-";"-";"-";"-";"-";"-";"-";"-";"-";"-";"-";"-";"-";"-";"-";"-"
"29 Sie 2024 20:41:29";"Zmodyfikowano Transakcję Sprzedaży";"O2-D5-96ZV44";"T2-D5-5KLHSH";"-";"Solana (USD)";"109,05 Jednost.";"141,620";"-";"-";"-";"-";"-";"-";"0,00";"-";"-";"-";"-";"-";"-";"-";"-";"-";"-";"-";"-";"-";"-";"-";"-";"-";"-";"-";"-";"-";"-";"-";"-";"-"
"29 Sie 2024 20:36:15";"Transakcja Sprzedaży";"O2-D5-96ZV44";"T2-D5-5KLHSH";"-";"Solana (USD)";"109,05 Jednost.";"141,620";"-";"144,452";"-";"-";"3,884934";"59 997,60";"0,00";"-";"-";"-";"-";"-";"-";"-";"-";"-";"-";"-";"-";"-";"-";"-";"-";"-";"-";"-";"-";"-";"-";"-";"-";"-"
"28 Sie 2024 23:00:47";"Koszty Utrzymania Pozycji";"1368332468";"-";"-";"Rachunek";"-";"-";"-";"-";"-";"-";"-";"-";"-98,74";"54 224,72";"-";"-";"-";"-";"-";"-98,74";"-";"-";"-";"-";"-";"-";"-";"-";"-";"-";"-";"-";"-";"-";"-";"-";"-";"-"
"28 Sie 2024 23:00:47";"Koszty Utrzymania Pozycji";"O2-D5-96SWM1";"-";"-";"Solana (USD)";"-";"-";"-";"-";"-";"-";"-";"-";"-";"-";"-";"-";"12 104,90";"-27,50000%";"-35,40";"-35,40";"-";"-";"-";"-";"-";"-";"-";"-";"-";"-";"-";"-";"-";"-";"-";"-";"-";"-"
"28 Sie 2024 23:00:47";"Koszty Utrzymania Pozycji";"O2-D4-95TL4Z";"-";"-";"Solana (USD)";"-";"-";"-";"-";"-";"-";"-";"-";"-";"-";"-";"-";"3 242,38";"-27,50000%";"-9,48";"-9,48";"-";"-";"-";"-";"-";"-";"-";"-";"-";"-";"-";"-";"-";"-";"-";"-";"-";"-"
"28 Sie 2024 23:00:47";"Koszty Utrzymania Pozycji";"O2-D5-963NM0";"-";"-";"Solana (USD)";"-";"-";"-";"-";"-";"-";"-";"-";"-";"-";"-";"-";"3 170,33";"-10,00000%";"3,34";"3,34";"-";"-";"-";"-";"-";"-";"-";"-";"-";"-";"-";"-";"-";"-";"-";"-";"-";"-"
"28 Sie 2024 23:00:47";"Koszty Utrzymania Pozycji";"O2-D5-96WE65";"-";"-";"Solana (USD)";"-";"-";"-";"-";"-";"-";"-";"-";"-";"-";"-";"-";"6 917,08";"-27,50000%";"-20,23";"-20,23";"-";"-";"-";"-";"-";"-";"-";"-";"-";"-";"-";"-";"-";"-";"-";"-";"-";"-"
"28 Sie 2024 23:00:47";"Koszty Utrzymania Pozycji";"O2-D4-96156D";"-";"-";"Solana (USD)";"-";"-";"-";"-";"-";"-";"-";"-";"-";"-";"-";"-";"3 530,59";"-27,50000%";"-10,33";"-10,33";"-";"-";"-";"-";"-";"-";"-";"-";"-";"-";"-";"-";"-";"-";"-";"-";"-";"-"
"28 Sie 2024 23:00:47";"Koszty Utrzymania Pozycji";"O2-D3-94JY88";"-";"-";"Solana (USD)";"-";"-";"-";"-";"-";"-";"-";"-";"-";"-";"-";"-";"7 205,30";"-27,50000%";"-21,07";"-21,07";"-";"-";"-";"-";"-";"-";"-";"-";"-";"-";"-";"-";"-";"-";"-";"-";"-";"-"
"28 Sie 2024 23:00:47";"Koszty Utrzymania Pozycji";"O2-D3-94S9LM";"-";"-";"Solana (USD)";"-";"-";"-";"-";"-";"-";"-";"-";"-";"-";"-";"-";"10 087,42";"-27,50000%";"-29,50";"-29,50";"-";"-";"-";"-";"-";"-";"-";"-";"-";"-";"-";"-";"-";"-";"-";"-";"-";"-"
"28 Sie 2024 23:00:47";"Koszty Utrzymania Pozycji";"O2-D4-95EL0T";"-";"-";"Solana (USD)";"-";"-";"-";"-";"-";"-";"-";"-";"-";"-";"-";"-";"4 323,18";"-27,50000%";"-12,64";"-12,64";"-";"-";"-";"-";"-";"-";"-";"-";"-";"-";"-";"-";"-";"-";"-";"-";"-";"-"
"28 Sie 2024 23:00:47";"Koszty Utrzymania Pozycji";"O2-D4-95P4DE";"-";"-";"Solana (USD)";"-";"-";"-";"-";"-";"-";"-";"-";"-";"-";"-";"-";"4 323,18";"-10,00000%";"4,55";"4,55";"-";"-";"-";"-";"-";"-";"-";"-";"-";"-";"-";"-";"-";"-";"-";"-";"-";"-"
"28 Sie 2024 23:00:47";"Koszty Utrzymania Pozycji";"O2-D4-95NXX0";"-";"-";"Solana (USD)";"-";"-";"-";"-";"-";"-";"-";"-";"-";"-";"-";"-";"14 554,70";"-10,00000%";"15,33";"15,33";"-";"-";"-";"-";"-";"-";"-";"-";"-";"-";"-";"-";"-";"-";"-";"-";"-";"-"
"28 Sie 2024 23:00:47";"Koszty Utrzymania Pozycji";"O2-D4-95K8MW";"-";"-";"Solana (USD)";"-";"-";"-";"-";"-";"-";"-";"-";"-";"-";"-";"-";"15 851,66";"-10,00000%";"16,69";"16,69";"-";"-";"-";"-";"-";"-";"-";"-";"-";"-";"-";"-";"-";"-";"-";"-";"-";"-"
"28 Sie 2024 18:15:02";" Zamknięcie Transakcji";"O2-D5-96X1TV";"T2-D5-5KJ6F8";"O2-D5-963NM0";"Solana (USD)";"2 Jednost.";"142,416";"-";"-";"-";"-";"3,881978";"1 105,71";"-0,43";"54 323,46";"-";"-";"-";"-";"-";"-";"-";"-";"-";"-";"-";"-";"-";"-";"-";"-";"-";"-";"-";"-";"-";"-";"-";"-"
"28 Sie 2024 18:10:23";" Zamknięcie Transakcji";"O2-D5-96X1M9";"T2-D5-5KJ69C";"O2-D5-963NM0";"Solana (USD)";"4 Jednost.";"142,863";"-";"-";"-";"-";"3,881537";"2 218,11";"-7,81";"54 323,89";"-";"-";"-";"-";"-";"-";"-";"-";"-";"-";"-";"-";"-";"-";"-";"-";"-";"-";"-";"-";"-";"-";"-";"-"
"28 Sie 2024 16:52:21";" Zamknięcie Transakcji";"O2-D5-96WTMC";"T2-D5-5KHZSR";"O2-D5-96WF1Q";"Solana (USD)";"48 Jednost.";"144,965";"-";"-";"-";"-";"3,83666";"26 965,05";"534,98";"54 331,70";"-";"-";"-";"-";"-";"-";"-";"-";"-";"-";"-";"-";"-";"-";"-";"-";"-";"-";"-";"-";"-";"-";"-";"-"
"28 Sie 2024 16:50:06";" Zamknięcie Transakcji";"O2-D5-96WTC6";"T2-D5-5KHZKX";"O2-D5-96PNJ6";"Solana (USD)";"12 Jednost.";"144,395";"-";"-";"-";"-";"3,8355";"6 712,70";"17,03";"53 796,72";"-";"-";"-";"-";"-";"-";"-";"-";"-";"-";"-";"-";"-";"-";"-";"-";"-";"-";"-";"-";"-";"-";"-";"-"
"28 Sie 2024 14:54:29";"Zmodyfikowano Transakcję Sprzedaży";"O2-D5-96WF1Q";"T2-D5-5KHMR4";"-";"Solana (USD)";"48 Jednost.";"147,870";"-";"-";"-";"-";"-";"-";"0,00";"-";"-";"-";"-";"-";"-";"-";"-";"-";"-";"-";"-";"-";"-";"-";"-";"-";"-";"-";"-";"-";"-";"-";"-";"-"
"28 Sie 2024 14:54:17";"Transakcja Sprzedaży";"O2-D5-96WF1Q";"T2-D5-5KHMR4";"-";"Solana (USD)";"48 Jednost.";"147,870";"-";"150,827";"-";"-";"3,88807";"27 596,58";"0,00";"-";"-";"-";"-";"-";"-";"-";"-";"-";"-";"-";"-";"-";"-";"-";"-";"-";"-";"-";"-";"-";"-";"-";"-";"-"
"28 Sie 2024 14:37:03";" Zmodyfikowano Transakcję Kupna";"O2-D5-96WE65";"T2-D5-5KHM1Y";"-";"Solana (USD)";"48 Jednost.";"148,326";"-";"-";"-";"-";"-";"-";"0,00";"-";"-";"-";"-";"-";"-";"-";"-";"-";"-";"-";"-";"-";"-";"-";"-";"-";"-";"-";"-";"-";"-";"-";"-";"-"
"28 Sie 2024 14:36:53";" Transakcja Kupna";"O2-D5-96WE65";"T2-D5-5KHM1Y";"-";"Solana (USD)";"48 Jednost.";"148,326";"-";"145,360";"-";"-";"3,893862";"27 722,92";"0,00";"-";"-";"-";"-";"-";"-";"-";"-";"-";"-";"-";"-";"-";"-";"-";"-";"-";"-";"-";"-";"-";"-";"-";"-";"-"
"28 Sie 2024 00:33:26";" Zamknięcie Transakcji";"O2-D5-96VE56";"T2-D5-5KGWY3";"O2-D5-96PNJ6";"Solana (USD)";"50 Jednost.";"146,265";"-";"-";"-";"-";"3,848772";"28 147,03";"-288,66";"53 779,69";"-";"-";"-";"-";"-";"-";"-";"-";"-";"-";"-";"-";"-";"-";"-";"-";"-";"-";"-";"-";"-";"-";"-";"-"
"27 Sie 2024 23:00:44";"Koszty Utrzymania Pozycji";"1367907356";"-";"-";"Rachunek";"-";"-";"-";"-";"-";"-";"-";"-";"-72,28";"54 068,35";"-";"-";"-";"-";"-";"-72,28";"-";"-";"-";"-";"-";"-";"-";"-";"-";"-";"-";"-";"-";"-";"-";"-";"-";"-"
"27 Sie 2024 23:00:44";"Koszty Utrzymania Pozycji";"O2-D5-96SWM1";"-";"-";"Solana (USD)";"-";"-";"-";"-";"-";"-";"-";"-";"-";"-";"-";"-";"12 936,50";"-27,50000%";"-37,51";"-37,51";"-";"-";"-";"-";"-";"-";"-";"-";"-";"-";"-";"-";"-";"-";"-";"-";"-";"-"
"27 Sie 2024 23:00:44";"Koszty Utrzymania Pozycji";"O2-D4-95TL4Z";"-";"-";"Solana (USD)";"-";"-";"-";"-";"-";"-";"-";"-";"-";"-";"-";"-";"3 465,13";"-27,50000%";"-10,05";"-10,05";"-";"-";"-";"-";"-";"-";"-";"-";"-";"-";"-";"-";"-";"-";"-";"-";"-";"-"
"27 Sie 2024 23:00:44";"Koszty Utrzymania Pozycji";"O2-D5-96PNJ6";"-";"-";"Solana (USD)";"-";"-";"-";"-";"-";"-";"-";"-";"-";"-";"-";"-";"9 548,37";"-10,00000%";"9,97";"9,97";"-";"-";"-";"-";"-";"-";"-";"-";"-";"-";"-";"-";"-";"-";"-";"-";"-";"-"
"27 Sie 2024 23:00:44";"Koszty Utrzymania Pozycji";"O2-D4-96156D";"-";"-";"Solana (USD)";"-";"-";"-";"-";"-";"-";"-";"-";"-";"-";"-";"-";"3 773,14";"-27,50000%";"-10,94";"-10,94";"-";"-";"-";"-";"-";"-";"-";"-";"-";"-";"-";"-";"-";"-";"-";"-";"-";"-"
"27 Sie 2024 23:00:44";"Koszty Utrzymania Pozycji";"O2-D3-94JY88";"-";"-";"Solana (USD)";"-";"-";"-";"-";"-";"-";"-";"-";"-";"-";"-";"-";"7 700,30";"-27,50000%";"-22,33";"-22,33";"-";"-";"-";"-";"-";"-";"-";"-";"-";"-";"-";"-";"-";"-";"-";"-";"-";"-"
"27 Sie 2024 23:00:44";"Koszty Utrzymania Pozycji";"O2-D3-94S9LM";"-";"-";"Solana (USD)";"-";"-";"-";"-";"-";"-";"-";"-";"-";"-";"-";"-";"10 780,42";"-27,50000%";"-31,26";"-31,26";"-";"-";"-";"-";"-";"-";"-";"-";"-";"-";"-";"-";"-";"-";"-";"-";"-";"-"
"27 Sie 2024 23:00:44";"Koszty Utrzymania Pozycji";"O2-D5-963NM0";"-";"-";"Solana (USD)";"-";"-";"-";"-";"-";"-";"-";"-";"-";"-";"-";"-";"4 312,16";"-10,00000%";"4,50";"4,50";"-";"-";"-";"-";"-";"-";"-";"-";"-";"-";"-";"-";"-";"-";"-";"-";"-";"-"
"27 Sie 2024 23:00:44";"Koszty Utrzymania Pozycji";"O2-D4-95EL0T";"-";"-";"Solana (USD)";"-";"-";"-";"-";"-";"-";"-";"-";"-";"-";"-";"-";"4 620,18";"-27,50000%";"-13,40";"-13,40";"-";"-";"-";"-";"-";"-";"-";"-";"-";"-";"-";"-";"-";"-";"-";"-";"-";"-"
"27 Sie 2024 23:00:44";"Koszty Utrzymania Pozycji";"O2-D4-95P4DE";"-";"-";"Solana (USD)";"-";"-";"-";"-";"-";"-";"-";"-";"-";"-";"-";"-";"4 620,18";"-10,00000%";"4,82";"4,82";"-";"-";"-";"-";"-";"-";"-";"-";"-";"-";"-";"-";"-";"-";"-";"-";"-";"-"
"27 Sie 2024 23:00:44";"Koszty Utrzymania Pozycji";"O2-D4-95NXX0";"-";"-";"Solana (USD)";"-";"-";"-";"-";"-";"-";"-";"-";"-";"-";"-";"-";"15 554,60";"-10,00000%";"16,24";"16,24";"-";"-";"-";"-";"-";"-";"-";"-";"-";"-";"-";"-";"-";"-";"-";"-";"-";"-"
"27 Sie 2024 23:00:44";"Koszty Utrzymania Pozycji";"O2-D4-95K8MW";"-";"-";"Solana (USD)";"-";"-";"-";"-";"-";"-";"-";"-";"-";"-";"-";"-";"16 940,66";"-10,00000%";"17,68";"17,68";"-";"-";"-";"-";"-";"-";"-";"-";"-";"-";"-";"-";"-";"-";"-";"-";"-";"-"
"27 Sie 2024 16:34:49";"Stop Loss";"O2-D5-96TQCD";"T2-D5-5KGE44";"-";"Solana (USD)";"90 Jednost.";"155,255";"-";"-";"-";"-";"3,8187";"53 894,75";"218,24";"54 140,63";"-";"-";"-";"-";"-";"-";"-";"-";"-";"-";"-";"-";"-";"-";"-";"-";"-";"-";"-";"-";"-";"-";"-";"-"
"27 Sie 2024 16:34:45";"Zmodyfikowano Stop Loss";"O2-D5-96TQCD";"-";"O2-D5-96TRET";"Solana (USD)";"90 Jednost.";"154,620";"-";"155,300";"-";"-";"-";"-";"-";"-";"-";"-";"-";"-";"-";"-";"-";"-";"-";"-";"-";"-";"-";"-";"-";"-";"-";"-";"-";"-";"-";"-";"-";"-"
"27 Sie 2024 16:31:55";"Zmodyfikowano Stop Loss";"O2-D5-96TQCD";"-";"O2-D5-96TRET";"Solana (USD)";"90 Jednost.";"154,620";"-";"155,000";"-";"-";"-";"-";"-";"-";"-";"-";"-";"-";"-";"-";"-";"-";"-";"-";"-";"-";"-";"-";"-";"-";"-";"-";"-";"-";"-";"-";"-";"-"
"27 Sie 2024 16:26:56";" Zmodyfikowano Transakcję Kupna";"O2-D5-96TQCD";"T2-D5-5KGC2E";"-";"Solana (USD)";"90 Jednost.";"154,620";"-";"154,750";"-";"-";"-";"-";"0,00";"-";"-";"-";"-";"-";"-";"-";"-";"-";"-";"-";"-";"-";"-";"-";"-";"-";"-";"-";"-";"-";"-";"-";"-";"-"
"27 Sie 2024 16:19:36";" Zmodyfikowano Transakcję Kupna";"O2-D5-96TQCD";"T2-D5-5KGC2E";"-";"Solana (USD)";"90 Jednost.";"154,620";"-";"-";"-";"-";"-";"-";"0,00";"-";"-";"-";"-";"-";"-";"-";"-";"-";"-";"-";"-";"-";"-";"-";"-";"-";"-";"-";"-";"-";"-";"-";"-";"-"
"27 Sie 2024 16:19:19";" Transakcja Kupna";"O2-D5-96TQCD";"T2-D5-5KGC2E";"-";"Solana (USD)";"90 Jednost.";"154,620";"-";"151,528";"-";"-";"3,858672";"53 696,50";"0,00";"-";"-";"-";"-";"-";"-";"-";"-";"-";"-";"-";"-";"-";"-";"-";"-";"-";"-";"-";"-";"-";"-";"-";"-";"-"
"27 Sie 2024 15:32:28";" Zamknięcie Transakcji";"O2-D5-96TH60";"T2-D5-5KG4V5";"O2-D5-96TDHP";"Solana (USD)";"5 Jednost.";"154,860";"-";"-";"-";"-";"3,82298";"2 989,88";"21,79";"53 922,39";"-";"-";"-";"-";"-";"-";"-";"-";"-";"-";"-";"-";"-";"-";"-";"-";"-";"-";"-";"-";"-";"-";"-";"-"
"27 Sie 2024 15:32:17";" Zamknięcie Transakcji";"O2-D5-96TH55";"T2-D5-5KG4TH";"O2-D5-96T8ZK";"Solana (USD)";"86 Jednost.";"154,860";"-";"-";"-";"-";"3,82342";"51 431,80";"27,62";"53 900,60";"-";"-";"-";"-";"-";"-";"-";"-";"-";"-";"-";"-";"-";"-";"-";"-";"-";"-";"-";"-";"-";"-";"-";"-"
"27 Sie 2024 14:42:13";" Zmodyfikowano Transakcję Kupna";"O2-D5-96TDHP";"T2-D5-5KG1J5";"-";"Solana (USD)";"5 Jednost.";"153,720";"-";"-";"-";"-";"-";"-";"0,00";"-";"-";"-";"-";"-";"-";"-";"-";"-";"-";"-";"-";"-";"-";"-";"-";"-";"-";"-";"-";"-";"-";"-";"-";"-"
"27 Sie 2024 14:42:00";" Transakcja Kupna";"O2-D5-96TDHP";"T2-D5-5KG1J5";"-";"Solana (USD)";"5 Jednost.";"153,720";"-";"150,646";"-";"-";"3,855155";"2 963,07";"0,00";"-";"-";"-";"-";"-";"-";"-";"-";"-";"-";"-";"-";"-";"-";"-";"-";"-";"-";"-";"-";"-";"-";"-";"-";"-"
"27 Sie 2024 13:17:54";" Zmodyfikowano Transakcję Kupna";"O2-D5-96T8ZK";"T2-D5-5KFYEM";"-";"Solana (USD)";"86 Jednost.";"154,776";"-";"-";"-";"-";"-";"-";"0,00";"-";"-";"-";"-";"-";"-";"-";"-";"-";"-";"-";"-";"-";"-";"-";"-";"-";"-";"-";"-";"-";"-";"-";"-";"-"
"27 Sie 2024 13:17:31";" Transakcja Kupna";"O2-D5-96T8ZK";"T2-D5-5KFYEM";"-";"Solana (USD)";"86 Jednost.";"154,776";"-";"151,681";"-";"-";"3,849764";"51 243,19";"0,00";"-";"-";"-";"-";"-";"-";"-";"-";"-";"-";"-";"-";"-";"-";"-";"-";"-";"-";"-";"-";"-";"-";"-";"-";"-"
"27 Sie 2024 13:09:17";"Stop Loss";"O2-D5-96T8LP";"T2-D5-5KFY7S";"-";"Solana (USD)";"84 Jednost.";"154,248";"-";"-";"-";"-";"3,850034";"49 884,24";"-0,65";"53 872,98";"-";"-";"-";"-";"-";"-";"-";"-";"-";"-";"-";"-";"-";"-";"-";"-";"-";"-";"-";"-";"-";"-";"-";"-"
"27 Sie 2024 13:08:02";" Zmodyfikowano Transakcję Kupna";"O2-D5-96T8LP";"T2-D5-5KFY3S";"-";"Solana (USD)";"84 Jednost.";"154,250";"-";"154,270";"-";"-";"-";"-";"0,00";"-";"-";"-";"-";"-";"-";"-";"-";"-";"-";"-";"-";"-";"-";"-";"-";"-";"-";"-";"-";"-";"-";"-";"-";"-"
"27 Sie 2024 13:05:21";" Zmodyfikowano Transakcję Kupna";"O2-D5-96T8LP";"T2-D5-5KFY3S";"-";"Solana (USD)";"84 Jednost.";"154,250";"-";"-";"-";"-";"-";"-";"0,00";"-";"-";"-";"-";"-";"-";"-";"-";"-";"-";"-";"-";"-";"-";"-";"-";"-";"-";"-";"-";"-";"-";"-";"-";"-"
"27 Sie 2024 13:05:06";" Transakcja Kupna";"O2-D5-96T8LP";"T2-D5-5KFY3S";"-";"Solana (USD)";"84 Jednost.";"154,250";"-";"151,165";"-";"-";"3,849563";"49 878,78";"0,00";"-";"-";"-";"-";"-";"-";"-";"-";"-";"-";"-";"-";"-";"-";"-";"-";"-";"-";"-";"-";"-";"-";"-";"-";"-"
"27 Sie 2024 12:07:08";" Zamknięcie Transakcji";"O2-D5-96T6BV";"T2-D5-5KFW6H";"O2-D4-95TL4Z";"Solana (USD)";"5,5 Jednost.";"155,900";"-";"-";"-";"-";"3,81169";"3 301,17";"71,49";"53 873,63";"-";"-";"-";"-";"-";"-";"-";"-";"-";"-";"-";"-";"-";"-";"-";"-";"-";"-";"-";"-";"-";"-";"-";"-"
"27 Sie 2024 12:05:39";" Zamknięcie Transakcji";"O2-D5-96T68B";"T2-D5-5KFW46";"O2-D5-96T3V0";"Solana (USD)";"84 Jednost.";"156,070";"-";"-";"-";"-";"3,850104";"50 474,40";"-349,28";"53 802,14";"-";"-";"-";"-";"-";"-";"-";"-";"-";"-";"-";"-";"-";"-";"-";"-";"-";"-";"-";"-";"-";"-";"-";"-"
"27 Sie 2024 11:08:14";" Zmodyfikowano Transakcję Kupna";"O2-D5-96T3V0";"T2-D5-5KFT1K";"-";"Solana (USD)";"84 Jednost.";"157,150";"-";"-";"-";"-";"-";"-";"0,00";"-";"-";"-";"-";"-";"-";"-";"-";"-";"-";"-";"-";"-";"-";"-";"-";"-";"-";"-";"-";"-";"-";"-";"-";"-"
"27 Sie 2024 11:07:57";" Transakcja Kupna";"O2-D5-96T3V0";"T2-D5-5KFT1K";"-";"Solana (USD)";"84 Jednost.";"157,150";"-";"154,007";"-";"-";"3,849002";"50 809,13";"0,00";"-";"-";"-";"-";"-";"-";"-";"-";"-";"-";"-";"-";"-";"-";"-";"-";"-";"-";"-";"-";"-";"-";"-";"-";"-"
"27 Sie 2024 10:18:59";" Zamknięcie Transakcji";"O2-D5-96T1CR";"T2-D5-5KFQZM";"O2-D4-95TFDC";"Solana (USD)";"83 Jednost.";"157,015";"-";"-";"-";"-";"3,81439";"50 209,59";"744,00";"54 151,42";"-";"-";"-";"-";"-";"-";"-";"-";"-";"-";"-";"-";"-";"-";"-";"-";"-";"-";"-";"-";"-";"-";"-";"-"
"27 Sie 2024 08:48:36";" Zmodyfikowano Transakcję Kupna";"O2-D5-96SWM1";"T2-D5-5KFM5Q";"-";"Solana (USD)";"84 Jednost.";"158,000";"-";"-";"-";"-";"-";"-";"0,00";"-";"-";"-";"-";"-";"-";"-";"-";"-";"-";"-";"-";"-";"-";"-";"-";"-";"-";"-";"-";"-";"-";"-";"-";"-"
"27 Sie 2024 08:48:02";" Transakcja Kupna";"O2-D5-96SWM1";"T2-D5-5KFM5Q";"-";"Solana (USD)";"84 Jednost.";"158,000";"-";"154,840";"-";"-";"3,854293";"51 154,17";"0,00";"-";"-";"-";"-";"-";"-";"-";"-";"-";"-";"-";"-";"-";"-";"-";"-";"-";"-";"-";"-";"-";"-";"-";"-";"-"
"27 Sie 2024 08:05:55";" Zamknięcie Transakcji";"O2-D5-96SVD1";"T2-D5-5KFL4Z";"O2-D5-96SKYH";"Solana (USD)";"84 Jednost.";"158,925";"-";"-";"-";"-";"3,81704";"51 468,50";"408,80";"53 407,42";"-";"-";"-";"-";"-";"-";"-";"-";"-";"-";"-";"-";"-";"-";"-";"-";"-";"-";"-";"-";"-";"-";"-";"-"
"26 Sie 2024 23:42:25";" Zmodyfikowano Transakcję Kupna";"O2-D5-96SKYH";"T2-D5-5KFDL2";"-";"Solana (USD)";"84 Jednost.";"157,650";"-";"-";"-";"-";"-";"-";"0,00";"-";"-";"-";"-";"-";"-";"-";"-";"-";"-";"-";"-";"-";"-";"-";"-";"-";"-";"-";"-";"-";"-";"-";"-";"-"
"26 Sie 2024 23:42:13";" Transakcja Kupna";"O2-D5-96SKYH";"T2-D5-5KFDL2";"-";"Solana (USD)";"84 Jednost.";"157,650";"-";"154,497";"-";"-";"3,854804";"51 047,62";"0,00";"-";"-";"-";"-";"-";"-";"-";"-";"-";"-";"-";"-";"-";"-";"-";"-";"-";"-";"-";"-";"-";"-";"-";"-";"-"
"26 Sie 2024 23:00:48";"Koszty Utrzymania Pozycji";"1367526093";"-";"-";"Rachunek";"-";"-";"-";"-";"-";"-";"-";"-";"-76,75";"52 998,62";"-";"-";"-";"-";"-";"-76,75";"-";"-";"-";"-";"-";"-";"-";"-";"-";"-";"-";"-";"-";"-";"-";"-";"-";"-"
"26 Sie 2024 23:00:48";"Koszty Utrzymania Pozycji";"O2-D5-96PNJ6";"-";"-";"Solana (USD)";"-";"-";"-";"-";"-";"-";"-";"-";"-";"-";"-";"-";"9 847,77";"-10,00000%";"10,30";"10,30";"-";"-";"-";"-";"-";"-";"-";"-";"-";"-";"-";"-";"-";"-";"-";"-";"-";"-"
"26 Sie 2024 23:00:48";"Koszty Utrzymania Pozycji";"O2-D4-96156D";"-";"-";"Solana (USD)";"-";"-";"-";"-";"-";"-";"-";"-";"-";"-";"-";"-";"3 891,45";"-27,50000%";"-11,30";"-11,30";"-";"-";"-";"-";"-";"-";"-";"-";"-";"-";"-";"-";"-";"-";"-";"-";"-";"-"
"26 Sie 2024 23:00:48";"Koszty Utrzymania Pozycji";"O2-D4-95TL4Z";"-";"-";"Solana (USD)";"-";"-";"-";"-";"-";"-";"-";"-";"-";"-";"-";"-";"4 447,38";"-27,50000%";"-12,92";"-12,92";"-";"-";"-";"-";"-";"-";"-";"-";"-";"-";"-";"-";"-";"-";"-";"-";"-";"-"
"26 Sie 2024 23:00:48";"Koszty Utrzymania Pozycji";"O2-D3-94JY88";"-";"-";"Solana (USD)";"-";"-";"-";"-";"-";"-";"-";"-";"-";"-";"-";"-";"7 941,75";"-27,50000%";"-23,07";"-23,07";"-";"-";"-";"-";"-";"-";"-";"-";"-";"-";"-";"-";"-";"-";"-";"-";"-";"-"
"26 Sie 2024 23:00:48";"Koszty Utrzymania Pozycji";"O2-D3-94S9LM";"-";"-";"Solana (USD)";"-";"-";"-";"-";"-";"-";"-";"-";"-";"-";"-";"-";"11 118,45";"-27,50000%";"-32,30";"-32,30";"-";"-";"-";"-";"-";"-";"-";"-";"-";"-";"-";"-";"-";"-";"-";"-";"-";"-"
"26 Sie 2024 23:00:48";"Koszty Utrzymania Pozycji";"O2-D5-963NM0";"-";"-";"Solana (USD)";"-";"-";"-";"-";"-";"-";"-";"-";"-";"-";"-";"-";"4 447,38";"-10,00000%";"4,65";"4,65";"-";"-";"-";"-";"-";"-";"-";"-";"-";"-";"-";"-";"-";"-";"-";"-";"-";"-"
"26 Sie 2024 23:00:48";"Koszty Utrzymania Pozycji";"O2-D4-95EL0T";"-";"-";"Solana (USD)";"-";"-";"-";"-";"-";"-";"-";"-";"-";"-";"-";"-";"4 765,05";"-27,50000%";"-13,84";"-13,84";"-";"-";"-";"-";"-";"-";"-";"-";"-";"-";"-";"-";"-";"-";"-";"-";"-";"-"
"26 Sie 2024 23:00:48";"Koszty Utrzymania Pozycji";"O2-D4-95TFDC";"-";"-";"Solana (USD)";"-";"-";"-";"-";"-";"-";"-";"-";"-";"-";"-";"-";"13 183,30";"-27,50000%";"-38,30";"-38,30";"-";"-";"-";"-";"-";"-";"-";"-";"-";"-";"-";"-";"-";"-";"-";"-";"-";"-"
"26 Sie 2024 23:00:48";"Koszty Utrzymania Pozycji";"O2-D4-95P4DE";"-";"-";"Solana (USD)";"-";"-";"-";"-";"-";"-";"-";"-";"-";"-";"-";"-";"4 765,05";"-10,00000%";"4,98";"4,98";"-";"-";"-";"-";"-";"-";"-";"-";"-";"-";"-";"-";"-";"-";"-";"-";"-";"-"
"26 Sie 2024 23:00:48";"Koszty Utrzymania Pozycji";"O2-D4-95NXX0";"-";"-";"Solana (USD)";"-";"-";"-";"-";"-";"-";"-";"-";"-";"-";"-";"-";"16 042,33";"-10,00000%";"16,78";"16,78";"-";"-";"-";"-";"-";"-";"-";"-";"-";"-";"-";"-";"-";"-";"-";"-";"-";"-"
"26 Sie 2024 23:00:48";"Koszty Utrzymania Pozycji";"O2-D4-95K8MW";"-";"-";"Solana (USD)";"-";"-";"-";"-";"-";"-";"-";"-";"-";"-";"-";"-";"17 471,85";"-10,00000%";"18,27";"18,27";"-";"-";"-";"-";"-";"-";"-";"-";"-";"-";"-";"-";"-";"-";"-";"-";"-";"-"
"26 Sie 2024 20:38:03";"Stop Loss";"O2-D5-96SFDX";"T2-D5-5KF98G";"-";"Solana (USD)";"78 Jednost.";"158,935";"-";"-";"-";"-";"3,81849";"47 813,19";"87,86";"53 075,37";"-";"-";"-";"-";"-";"-";"-";"-";"-";"-";"-";"-";"-";"-";"-";"-";"-";"-";"-";"-";"-";"-";"-";"-"
"26 Sie 2024 20:37:34";" Zmodyfikowano Transakcję Kupna";"O2-D5-96SFDX";"T2-D5-5KF912";"-";"Solana (USD)";"78 Jednost.";"158,640";"-";"158,950";"-";"-";"-";"-";"0,00";"-";"-";"-";"-";"-";"-";"-";"-";"-";"-";"-";"-";"-";"-";"-";"-";"-";"-";"-";"-";"-";"-";"-";"-";"-"
"26 Sie 2024 20:33:13";" Zmodyfikowano Transakcję Kupna";"O2-D5-96SFDX";"T2-D5-5KF912";"-";"Solana (USD)";"78 Jednost.";"158,640";"-";"-";"-";"-";"-";"-";"0,00";"-";"-";"-";"-";"-";"-";"-";"-";"-";"-";"-";"-";"-";"-";"-";"-";"-";"-";"-";"-";"-";"-";"-";"-";"-"
"26 Sie 2024 20:32:59";" Transakcja Kupna";"O2-D5-96SFDX";"T2-D5-5KF912";"-";"Solana (USD)";"78 Jednost.";"158,640";"-";"155,453";"-";"-";"3,855054";"47 702,12";"0,00";"-";"-";"-";"-";"-";"-";"-";"-";"-";"-";"-";"-";"-";"-";"-";"-";"-";"-";"-";"-";"-";"-";"-";"-";"-"
"26 Sie 2024 20:19:42";" Zamknięcie Transakcji";"O2-D5-96SERG";"T2-D5-5KF8GW";"O2-D4-95EL0T";"Solana (USD)";"4 Jednost.";"157,595";"-";"-";"-";"-";"3,81694";"2 430,30";"7,48";"52 987,51";"-";"-";"-";"-";"-";"-";"-";"-";"-";"-";"-";"-";"-";"-";"-";"-";"-";"-";"-";"-";"-";"-";"-";"-"
"26 Sie 2024 20:17:17";" Zamknięcie Transakcji";"O2-D5-96SENZ";"T2-D5-5KF8F7";"O2-D4-95EL0T";"Solana (USD)";"1,33 Jednost.";"157,735";"-";"-";"-";"-";"3,81691";"808,78";"3,20";"52 980,03";"-";"-";"-";"-";"-";"-";"-";"-";"-";"-";"-";"-";"-";"-";"-";"-";"-";"-";"-";"-";"-";"-";"-";"-"
"26 Sie 2024 20:15:49";" Zamknięcie Transakcji";"O2-D5-96SELC";"T2-D5-5KF8DC";"O2-D5-96RWQL";"Solana (USD)";"78 Jednost.";"158,140";"-";"-";"-";"-";"3,81704";"47 556,11";"222,40";"52 976,83";"-";"-";"-";"-";"-";"-";"-";"-";"-";"-";"-";"-";"-";"-";"-";"-";"-";"-";"-";"-";"-";"-";"-";"-"
"26 Sie 2024 16:24:54";" Zmodyfikowano Transakcję Kupna";"O2-D5-96RWQL";"T2-D5-5KET3J";"-";"Solana (USD)";"78 Jednost.";"157,393";"-";"-";"-";"-";"-";"-";"0,00";"-";"-";"-";"-";"-";"-";"-";"-";"-";"-";"-";"-";"-";"-";"-";"-";"-";"-";"-";"-";"-";"-";"-";"-";"-"
"26 Sie 2024 16:24:43";" Transakcja Kupna";"O2-D5-96RWQL";"T2-D5-5KET3J";"-";"Solana (USD)";"78 Jednost.";"157,393";"-";"154,203";"-";"-";"3,856106";"47 340,07";"0,00";"-";"-";"-";"-";"-";"-";"-";"-";"-";"-";"-";"-";"-";"-";"-";"-";"-";"-";"-";"-";"-";"-";"-";"-";"-"
"26 Sie 2024 16:05:29";"Stop Loss";"O2-D5-96RS7E";"T2-D5-5KEQSV";"-";"Solana (USD)";"75 Jednost.";"160,895";"-";"-";"-";"-";"3,81854";"46 541,91";"134,60";"52 754,43";"-";"-";"-";"-";"-";"-";"-";"-";"-";"-";"-";"-";"-";"-";"-";"-";"-";"-";"-";"-";"-";"-";"-";"-"
"26 Sie 2024 16:04:44";" Zmodyfikowano Transakcję Kupna";"O2-D5-96RS7E";"T2-D5-5KEQ4C";"-";"Solana (USD)";"75 Jednost.";"160,425";"-";"160,900";"-";"-";"-";"-";"0,00";"-";"-";"-";"-";"-";"-";"-";"-";"-";"-";"-";"-";"-";"-";"-";"-";"-";"-";"-";"-";"-";"-";"-";"-";"-"
"26 Sie 2024 16:00:30";" Zmodyfikowano Transakcję Kupna";"O2-D5-96RS7E";"T2-D5-5KEQ4C";"-";"Solana (USD)";"75 Jednost.";"160,425";"-";"-";"-";"-";"-";"-";"0,00";"-";"-";"-";"-";"-";"-";"-";"-";"-";"-";"-";"-";"-";"-";"-";"-";"-";"-";"-";"-";"-";"-";"-";"-";"-"
"26 Sie 2024 16:00:18";" Transakcja Kupna";"O2-D5-96RS7E";"T2-D5-5KEQ4C";"-";"Solana (USD)";"75 Jednost.";"160,425";"-";"157,217";"-";"-";"3,857389";"46 411,62";"0,00";"-";"-";"-";"-";"-";"-";"-";"-";"-";"-";"-";"-";"-";"-";"-";"-";"-";"-";"-";"-";"-";"-";"-";"-";"-"
"26 Sie 2024 15:30:21";" Zamknięcie Transakcji";"O2-D5-96RLS5";"T2-D5-5KEKTR";"O2-D5-96RJF9";"Solana (USD)";"75 Jednost.";"160,000";"-";"-";"-";"-";"3,81447";"46 233,72";"84,40";"52 619,83";"-";"-";"-";"-";"-";"-";"-";"-";"-";"-";"-";"-";"-";"-";"-";"-";"-";"-";"-";"-";"-";"-";"-";"-"
"26 Sie 2024 14:47:20";" Zmodyfikowano Transakcję Kupna";"O2-D5-96RJF9";"T2-D5-5KEHWZ";"-";"Solana (USD)";"75 Jednost.";"159,705";"-";"-";"-";"-";"-";"-";"0,00";"-";"-";"-";"-";"-";"-";"-";"-";"-";"-";"-";"-";"-";"-";"-";"-";"-";"-";"-";"-";"-";"-";"-";"-";"-"
"26 Sie 2024 14:47:05";" Transakcja Kupna";"O2-D5-96RJF9";"T2-D5-5KEHWZ";"-";"Solana (USD)";"75 Jednost.";"159,705";"-";"156,508";"-";"-";"3,854884";"46 173,31";"0,00";"-";"-";"-";"-";"-";"-";"-";"-";"-";"-";"-";"-";"-";"-";"-";"-";"-";"-";"-";"-";"-";"-";"-";"-";"-"
"26 Sie 2024 13:46:41";" Zamknięcie Transakcji";"O2-D5-96RFR8";"T2-D5-5KEFNS";"O2-D4-95YD2J";"Solana (USD)";"10,05 Jednost.";"160,300";"-";"-";"-";"-";"3,853281";"6 207,69";"-10,46";"52 535,43";"-";"-";"-";"-";"-";"-";"-";"-";"-";"-";"-";"-";"-";"-";"-";"-";"-";"-";"-";"-";"-";"-";"-";"-"
"26 Sie 2024 13:45:55";" Zamknięcie Transakcji";"O2-D5-96RFPY";"T2-D5-5KEFM1";"O2-D4-95YD2J";"Solana (USD)";"30 Jednost.";"160,564";"-";"-";"-";"-";"3,853241";"18 560,75";"-0,69";"52 545,89";"-";"-";"-";"-";"-";"-";"-";"-";"-";"-";"-";"-";"-";"-";"-";"-";"-";"-";"-";"-";"-";"-";"-";"-"
"26 Sie 2024 13:45:30";" Zamknięcie Transakcji";"O2-D5-96RFP1";"T2-D5-5KEFLE";"O2-D4-95YD2J";"Solana (USD)";"35 Jednost.";"160,625";"-";"-";"-";"-";"3,81464";"21 660,91";"7,34";"52 546,58";"-";"-";"-";"-";"-";"-";"-";"-";"-";"-";"-";"-";"-";"-";"-";"-";"-";"-";"-";"-";"-";"-";"-";"-"
"26 Sie 2024 13:37:54";" Zamknięcie Transakcji";"O2-D5-96RFCJ";"T2-D5-5KEF8Q";"O2-D5-96RDDM";"Solana (USD)";"70 Jednost.";"161,015";"-";"-";"-";"-";"3,81319";"43 410,52";"106,77";"52 539,24";"-";"-";"-";"-";"-";"-";"-";"-";"-";"-";"-";"-";"-";"-";"-";"-";"-";"-";"-";"-";"-";"-";"-";"-"
"26 Sie 2024 12:51:47";"Zmodyfikowano Transakcję Sprzedaży";"O2-D5-96RDDM";"T2-D5-5KEDQB";"-";"Solana (USD)";"70 Jednost.";"161,415";"-";"-";"-";"-";"-";"-";"0,00";"-";"-";"-";"-";"-";"-";"-";"-";"-";"-";"-";"-";"-";"-";"-";"-";"-";"-";"-";"-";"-";"-";"-";"-";"-"
"26 Sie 2024 12:51:23";"Transakcja Sprzedaży";"O2-D5-96RDDM";"T2-D5-5KEDQB";"-";"Solana (USD)";"70 Jednost.";"161,415";"-";"164,643";"-";"-";"3,849493";"43 495,61";"0,00";"-";"-";"-";"-";"-";"-";"-";"-";"-";"-";"-";"-";"-";"-";"-";"-";"-";"-";"-";"-";"-";"-";"-";"-";"-"
"23 Sie 2024 23:00:51";"Koszty Utrzymania Pozycji";"1367132769";"-";"-";"Rachunek";"-";"-";"-";"-";"-";"-";"-";"-";"-319,83";"52 432,47";"-";"-";"-";"-";"-";"-319,83";"-";"-";"-";"-";"-";"-";"-";"-";"-";"-";"-";"-";"-";"-";"-";"-";"-";"-"
"23 Sie 2024 23:00:51";"Koszty Utrzymania Pozycji";"O2-D5-963NM0";"-";"-";"Solana (USD)";"-";"-";"-";"-";"-";"-";"-";"-";"-";"-";"-";"-";"4 193,56";"-10,00000%";"13,07";"13,07";"-";"-";"-";"-";"-";"-";"-";"-";"-";"-";"-";"-";"-";"-";"-";"-";"-";"-"
"23 Sie 2024 23:00:51";"Koszty Utrzymania Pozycji";"O2-D4-95EL0T";"-";"-";"Solana (USD)";"-";"-";"-";"-";"-";"-";"-";"-";"-";"-";"-";"-";"5 291,37";"-27,50000%";"-45,80";"-45,80";"-";"-";"-";"-";"-";"-";"-";"-";"-";"-";"-";"-";"-";"-";"-";"-";"-";"-"
"23 Sie 2024 23:00:51";"Koszty Utrzymania Pozycji";"O2-D4-95TFDC";"-";"-";"Solana (USD)";"-";"-";"-";"-";"-";"-";"-";"-";"-";"-";"-";"-";"12 430,91";"-27,50000%";"-107,60";"-107,60";"-";"-";"-";"-";"-";"-";"-";"-";"-";"-";"-";"-";"-";"-";"-";"-";"-";"-"
"23 Sie 2024 23:00:51";"Koszty Utrzymania Pozycji";"O2-D4-95P4DE";"-";"-";"Solana (USD)";"-";"-";"-";"-";"-";"-";"-";"-";"-";"-";"-";"-";"4 493,10";"-10,00000%";"14,00";"14,00";"-";"-";"-";"-";"-";"-";"-";"-";"-";"-";"-";"-";"-";"-";"-";"-";"-";"-"
"23 Sie 2024 23:00:51";"Koszty Utrzymania Pozycji";"O2-D4-95NXX0";"-";"-";"Solana (USD)";"-";"-";"-";"-";"-";"-";"-";"-";"-";"-";"-";"-";"15 126,77";"-10,00000%";"47,14";"47,14";"-";"-";"-";"-";"-";"-";"-";"-";"-";"-";"-";"-";"-";"-";"-";"-";"-";"-"
"23 Sie 2024 23:00:51";"Koszty Utrzymania Pozycji";"O2-D4-95K8MW";"-";"-";"Solana (USD)";"-";"-";"-";"-";"-";"-";"-";"-";"-";"-";"-";"-";"16 474,70";"-10,00000%";"51,34";"51,34";"-";"-";"-";"-";"-";"-";"-";"-";"-";"-";"-";"-";"-";"-";"-";"-";"-";"-"
"23 Sie 2024 23:00:51";"Koszty Utrzymania Pozycji";"O2-D5-96PNJ6";"-";"-";"Solana (USD)";"-";"-";"-";"-";"-";"-";"-";"-";"-";"-";"-";"-";"9 285,74";"-10,00000%";"28,94";"28,94";"-";"-";"-";"-";"-";"-";"-";"-";"-";"-";"-";"-";"-";"-";"-";"-";"-";"-"
"23 Sie 2024 23:00:51";"Koszty Utrzymania Pozycji";"O2-D4-95YD2J";"-";"-";"Solana (USD)";"-";"-";"-";"-";"-";"-";"-";"-";"-";"-";"-";"-";"11 240,23";"-27,50000%";"-97,29";"-97,29";"-";"-";"-";"-";"-";"-";"-";"-";"-";"-";"-";"-";"-";"-";"-";"-";"-";"-"
"23 Sie 2024 23:00:51";"Koszty Utrzymania Pozycji";"O2-D4-96156D";"-";"-";"Solana (USD)";"-";"-";"-";"-";"-";"-";"-";"-";"-";"-";"-";"-";"3 669,36";"-27,50000%";"-31,76";"-31,76";"-";"-";"-";"-";"-";"-";"-";"-";"-";"-";"-";"-";"-";"-";"-";"-";"-";"-"
"23 Sie 2024 23:00:51";"Koszty Utrzymania Pozycji";"O2-D4-95TL4Z";"-";"-";"Solana (USD)";"-";"-";"-";"-";"-";"-";"-";"-";"-";"-";"-";"-";"4 193,56";"-27,50000%";"-36,30";"-36,30";"-";"-";"-";"-";"-";"-";"-";"-";"-";"-";"-";"-";"-";"-";"-";"-";"-";"-"
"23 Sie 2024 23:00:51";"Koszty Utrzymania Pozycji";"O2-D3-94JY88";"-";"-";"Solana (USD)";"-";"-";"-";"-";"-";"-";"-";"-";"-";"-";"-";"-";"7 488,50";"-27,50000%";"-64,82";"-64,82";"-";"-";"-";"-";"-";"-";"-";"-";"-";"-";"-";"-";"-";"-";"-";"-";"-";"-"
"23 Sie 2024 23:00:51";"Koszty Utrzymania Pozycji";"O2-D3-94S9LM";"-";"-";"Solana (USD)";"-";"-";"-";"-";"-";"-";"-";"-";"-";"-";"-";"-";"10 483,90";"-27,50000%";"-90,75";"-90,75";"-";"-";"-";"-";"-";"-";"-";"-";"-";"-";"-";"-";"-";"-";"-";"-";"-";"-"
"23 Sie 2024 16:50:42";" Zamknięcie Transakcji";"O2-D5-96PRH8";"T2-D5-5KD2EV";"O2-D5-96FE5H";"Solana (USD)";"62 Jednost.";"143,515";"-";"-";"-";"-";"3,80194";"34 169,34";"66,00";"52 752,30";"-";"-";"-";"-";"-";"-";"-";"-";"-";"-";"-";"-";"-";"-";"-";"-";"-";"-";"-";"-";"-";"-";"-";"-"
"23 Sie 2024 16:39:04";"Zmodyfikowano Transakcję Sprzedaży";"O2-D5-96PNJ6";"T2-D5-5KCZP7";"-";"Solana (USD)";"62 Jednost.";"144,765";"-";"-";"-";"-";"-";"-";"0,00";"-";"-";"-";"-";"-";"-";"-";"-";"-";"-";"-";"-";"-";"-";"-";"-";"-";"-";"-";"-";"-";"-";"-";"-";"-"
"23 Sie 2024 16:38:39";"Transakcja Sprzedaży";"O2-D5-96PNJ6";"T2-D5-5KCZP7";"-";"Solana (USD)";"62 Jednost.";"144,765";"-";"147,660";"-";"-";"3,839052";"34 457,14";"0,00";"-";"-";"-";"-";"-";"-";"-";"-";"-";"-";"-";"-";"-";"-";"-";"-";"-";"-";"-";"-";"-";"-";"-";"-";"-"
"23 Sie 2024 13:15:24";" Zamknięcie Transakcji";"O2-D5-96P047";"T2-D5-5KCCQC";"O2-D5-96NXWK";"Solana (USD)";"62 Jednost.";"144,115";"-";"-";"-";"-";"3,82618";"34 531,08";"62,86";"52 686,30";"-";"-";"-";"-";"-";"-";"-";"-";"-";"-";"-";"-";"-";"-";"-";"-";"-";"-";"-";"-";"-";"-";"-";"-"
"23 Sie 2024 12:20:59";"Zmodyfikowano Transakcję Sprzedaży";"O2-D5-96NXWK";"T2-D5-5KC9VN";"-";"Solana (USD)";"62 Jednost.";"144,380";"-";"-";"-";"-";"-";"-";"0,00";"-";"-";"-";"-";"-";"-";"-";"-";"-";"-";"-";"-";"-";"-";"-";"-";"-";"-";"-";"-";"-";"-";"-";"-";"-"
"23 Sie 2024 12:20:43";"Transakcja Sprzedaży";"O2-D5-96NXWK";"T2-D5-5KC9VN";"-";"Solana (USD)";"62 Jednost.";"144,380";"-";"147,267";"-";"-";"3,865305";"34 600,50";"0,00";"-";"-";"-";"-";"-";"-";"-";"-";"-";"-";"-";"-";"-";"-";"-";"-";"-";"-";"-";"-";"-";"-";"-";"-";"-"
"22 Sie 2024 23:00:54";"Koszty Utrzymania Pozycji";"1366740111";"-";"-";"Rachunek";"-";"-";"-";"-";"-";"-";"-";"-";"-103,18";"52 623,44";"-";"-";"-";"-";"-";"-103,18";"-";"-";"-";"-";"-";"-";"-";"-";"-";"-";"-";"-";"-";"-";"-";"-";"-";"-"
"22 Sie 2024 23:00:54";"Koszty Utrzymania Pozycji";"O2-D5-96FE5H";"-";"-";"Solana (USD)";"-";"-";"-";"-";"-";"-";"-";"-";"-";"-";"-";"-";"8 889,25";"-10,00000%";"9,34";"9,34";"-";"-";"-";"-";"-";"-";"-";"-";"-";"-";"-";"-";"-";"-";"-";"-";"-";"-"
"22 Sie 2024 23:00:54";"Koszty Utrzymania Pozycji";"O2-D4-95YD2J";"-";"-";"Solana (USD)";"-";"-";"-";"-";"-";"-";"-";"-";"-";"-";"-";"-";"10 760,29";"-27,50000%";"-31,39";"-31,39";"-";"-";"-";"-";"-";"-";"-";"-";"-";"-";"-";"-";"-";"-";"-";"-";"-";"-"
"22 Sie 2024 23:00:54";"Koszty Utrzymania Pozycji";"O2-D4-96156D";"-";"-";"Solana (USD)";"-";"-";"-";"-";"-";"-";"-";"-";"-";"-";"-";"-";"3 512,68";"-27,50000%";"-10,25";"-10,25";"-";"-";"-";"-";"-";"-";"-";"-";"-";"-";"-";"-";"-";"-";"-";"-";"-";"-"
"22 Sie 2024 23:00:54";"Koszty Utrzymania Pozycji";"O2-D4-95TL4Z";"-";"-";"Solana (USD)";"-";"-";"-";"-";"-";"-";"-";"-";"-";"-";"-";"-";"4 014,50";"-27,50000%";"-11,71";"-11,71";"-";"-";"-";"-";"-";"-";"-";"-";"-";"-";"-";"-";"-";"-";"-";"-";"-";"-"
"22 Sie 2024 23:00:54";"Koszty Utrzymania Pozycji";"O2-D3-94JY88";"-";"-";"Solana (USD)";"-";"-";"-";"-";"-";"-";"-";"-";"-";"-";"-";"-";"7 168,75";"-27,50000%";"-20,91";"-20,91";"-";"-";"-";"-";"-";"-";"-";"-";"-";"-";"-";"-";"-";"-";"-";"-";"-";"-"
"22 Sie 2024 23:00:54";"Koszty Utrzymania Pozycji";"O2-D3-94S9LM";"-";"-";"Solana (USD)";"-";"-";"-";"-";"-";"-";"-";"-";"-";"-";"-";"-";"10 036,25";"-27,50000%";"-29,28";"-29,28";"-";"-";"-";"-";"-";"-";"-";"-";"-";"-";"-";"-";"-";"-";"-";"-";"-";"-"
"22 Sie 2024 23:00:54";"Koszty Utrzymania Pozycji";"O2-D5-963NM0";"-";"-";"Solana (USD)";"-";"-";"-";"-";"-";"-";"-";"-";"-";"-";"-";"-";"4 014,50";"-10,00000%";"4,22";"4,22";"-";"-";"-";"-";"-";"-";"-";"-";"-";"-";"-";"-";"-";"-";"-";"-";"-";"-"
"22 Sie 2024 23:00:54";"Koszty Utrzymania Pozycji";"O2-D4-95EL0T";"-";"-";"Solana (USD)";"-";"-";"-";"-";"-";"-";"-";"-";"-";"-";"-";"-";"5 065,43";"-27,50000%";"-14,78";"-14,78";"-";"-";"-";"-";"-";"-";"-";"-";"-";"-";"-";"-";"-";"-";"-";"-";"-";"-"
"22 Sie 2024 23:00:54";"Koszty Utrzymania Pozycji";"O2-D4-95TFDC";"-";"-";"Solana (USD)";"-";"-";"-";"-";"-";"-";"-";"-";"-";"-";"-";"-";"11 900,12";"-27,50000%";"-34,72";"-34,72";"-";"-";"-";"-";"-";"-";"-";"-";"-";"-";"-";"-";"-";"-";"-";"-";"-";"-"
"22 Sie 2024 23:00:54";"Koszty Utrzymania Pozycji";"O2-D4-95P4DE";"-";"-";"Solana (USD)";"-";"-";"-";"-";"-";"-";"-";"-";"-";"-";"-";"-";"4 301,25";"-10,00000%";"4,52";"4,52";"-";"-";"-";"-";"-";"-";"-";"-";"-";"-";"-";"-";"-";"-";"-";"-";"-";"-"
"22 Sie 2024 23:00:54";"Koszty Utrzymania Pozycji";"O2-D4-95NXX0";"-";"-";"Solana (USD)";"-";"-";"-";"-";"-";"-";"-";"-";"-";"-";"-";"-";"14 480,87";"-10,00000%";"15,21";"15,21";"-";"-";"-";"-";"-";"-";"-";"-";"-";"-";"-";"-";"-";"-";"-";"-";"-";"-"
"22 Sie 2024 23:00:54";"Koszty Utrzymania Pozycji";"O2-D4-95K8MW";"-";"-";"Solana (USD)";"-";"-";"-";"-";"-";"-";"-";"-";"-";"-";"-";"-";"15 771,25";"-10,00000%";"16,57";"16,57";"-";"-";"-";"-";"-";"-";"-";"-";"-";"-";"-";"-";"-";"-";"-";"-";"-";"-"
"21 Sie 2024 23:00:47";"Koszty Utrzymania Pozycji";"1366309530";"-";"-";"Rachunek";"-";"-";"-";"-";"-";"-";"-";"-";"-102,66";"52 726,62";"-";"-";"-";"-";"-";"-102,66";"-";"-";"-";"-";"-";"-";"-";"-";"-";"-";"-";"-";"-";"-";"-";"-";"-";"-"
"21 Sie 2024 23:00:47";"Koszty Utrzymania Pozycji";"O2-D5-96FE5H";"-";"-";"Solana (USD)";"-";"-";"-";"-";"-";"-";"-";"-";"-";"-";"-";"-";"8 872,51";"-10,00000%";"9,29";"9,29";"-";"-";"-";"-";"-";"-";"-";"-";"-";"-";"-";"-";"-";"-";"-";"-";"-";"-"
"21 Sie 2024 23:00:47";"Koszty Utrzymania Pozycji";"O2-D4-95YD2J";"-";"-";"Solana (USD)";"-";"-";"-";"-";"-";"-";"-";"-";"-";"-";"-";"-";"10 740,03";"-27,50000%";"-31,23";"-31,23";"-";"-";"-";"-";"-";"-";"-";"-";"-";"-";"-";"-";"-";"-";"-";"-";"-";"-"
"21 Sie 2024 23:00:47";"Koszty Utrzymania Pozycji";"O2-D4-96156D";"-";"-";"Solana (USD)";"-";"-";"-";"-";"-";"-";"-";"-";"-";"-";"-";"-";"3 506,07";"-27,50000%";"-10,19";"-10,19";"-";"-";"-";"-";"-";"-";"-";"-";"-";"-";"-";"-";"-";"-";"-";"-";"-";"-"
"21 Sie 2024 23:00:47";"Koszty Utrzymania Pozycji";"O2-D4-95TL4Z";"-";"-";"Solana (USD)";"-";"-";"-";"-";"-";"-";"-";"-";"-";"-";"-";"-";"4 006,94";"-27,50000%";"-11,65";"-11,65";"-";"-";"-";"-";"-";"-";"-";"-";"-";"-";"-";"-";"-";"-";"-";"-";"-";"-"
"21 Sie 2024 23:00:47";"Koszty Utrzymania Pozycji";"O2-D3-94JY88";"-";"-";"Solana (USD)";"-";"-";"-";"-";"-";"-";"-";"-";"-";"-";"-";"-";"7 155,25";"-27,50000%";"-20,80";"-20,80";"-";"-";"-";"-";"-";"-";"-";"-";"-";"-";"-";"-";"-";"-";"-";"-";"-";"-"
"21 Sie 2024 23:00:47";"Koszty Utrzymania Pozycji";"O2-D3-94S9LM";"-";"-";"Solana (USD)";"-";"-";"-";"-";"-";"-";"-";"-";"-";"-";"-";"-";"10 017,35";"-27,50000%";"-29,13";"-29,13";"-";"-";"-";"-";"-";"-";"-";"-";"-";"-";"-";"-";"-";"-";"-";"-";"-";"-"
"21 Sie 2024 23:00:47";"Koszty Utrzymania Pozycji";"O2-D5-963NM0";"-";"-";"Solana (USD)";"-";"-";"-";"-";"-";"-";"-";"-";"-";"-";"-";"-";"4 006,94";"-10,00000%";"4,19";"4,19";"-";"-";"-";"-";"-";"-";"-";"-";"-";"-";"-";"-";"-";"-";"-";"-";"-";"-"
"21 Sie 2024 23:00:47";"Koszty Utrzymania Pozycji";"O2-D4-95EL0T";"-";"-";"Solana (USD)";"-";"-";"-";"-";"-";"-";"-";"-";"-";"-";"-";"-";"5 055,89";"-27,50000%";"-14,70";"-14,70";"-";"-";"-";"-";"-";"-";"-";"-";"-";"-";"-";"-";"-";"-";"-";"-";"-";"-"
"21 Sie 2024 23:00:47";"Koszty Utrzymania Pozycji";"O2-D4-95TFDC";"-";"-";"Solana (USD)";"-";"-";"-";"-";"-";"-";"-";"-";"-";"-";"-";"-";"11 877,71";"-27,50000%";"-34,54";"-34,54";"-";"-";"-";"-";"-";"-";"-";"-";"-";"-";"-";"-";"-";"-";"-";"-";"-";"-"
"21 Sie 2024 23:00:47";"Koszty Utrzymania Pozycji";"O2-D4-95P4DE";"-";"-";"Solana (USD)";"-";"-";"-";"-";"-";"-";"-";"-";"-";"-";"-";"-";"4 293,15";"-10,00000%";"4,49";"4,49";"-";"-";"-";"-";"-";"-";"-";"-";"-";"-";"-";"-";"-";"-";"-";"-";"-";"-"
"21 Sie 2024 23:00:47";"Koszty Utrzymania Pozycji";"O2-D4-95NXX0";"-";"-";"Solana (USD)";"-";"-";"-";"-";"-";"-";"-";"-";"-";"-";"-";"-";"14 453,60";"-10,00000%";"15,13";"15,13";"-";"-";"-";"-";"-";"-";"-";"-";"-";"-";"-";"-";"-";"-";"-";"-";"-";"-"
"21 Sie 2024 23:00:47";"Koszty Utrzymania Pozycji";"O2-D4-95K8MW";"-";"-";"Solana (USD)";"-";"-";"-";"-";"-";"-";"-";"-";"-";"-";"-";"-";"15 741,55";"-10,00000%";"16,48";"16,48";"-";"-";"-";"-";"-";"-";"-";"-";"-";"-";"-";"-";"-";"-";"-";"-";"-";"-"
"20 Sie 2024 23:00:54";"Koszty Utrzymania Pozycji";"1365952383";"-";"-";"Rachunek";"-";"-";"-";"-";"-";"-";"-";"-";"-103,02";"52 829,28";"-";"-";"-";"-";"-";"-103,02";"-";"-";"-";"-";"-";"-";"-";"-";"-";"-";"-";"-";"-";"-";"-";"-";"-";"-"
"20 Sie 2024 23:00:54";"Koszty Utrzymania Pozycji";"O2-D5-96FE5H";"-";"-";"Solana (USD)";"-";"-";"-";"-";"-";"-";"-";"-";"-";"-";"-";"-";"8 897,74";"-10,00000%";"9,32";"9,32";"-";"-";"-";"-";"-";"-";"-";"-";"-";"-";"-";"-";"-";"-";"-";"-";"-";"-"
"20 Sie 2024 23:00:54";"Koszty Utrzymania Pozycji";"O2-D4-95YD2J";"-";"-";"Solana (USD)";"-";"-";"-";"-";"-";"-";"-";"-";"-";"-";"-";"-";"10 770,57";"-27,50000%";"-31,34";"-31,34";"-";"-";"-";"-";"-";"-";"-";"-";"-";"-";"-";"-";"-";"-";"-";"-";"-";"-"
"20 Sie 2024 23:00:54";"Koszty Utrzymania Pozycji";"O2-D4-96156D";"-";"-";"Solana (USD)";"-";"-";"-";"-";"-";"-";"-";"-";"-";"-";"-";"-";"3 516,04";"-27,50000%";"-10,23";"-10,23";"-";"-";"-";"-";"-";"-";"-";"-";"-";"-";"-";"-";"-";"-";"-";"-";"-";"-"
"20 Sie 2024 23:00:54";"Koszty Utrzymania Pozycji";"O2-D4-95TL4Z";"-";"-";"Solana (USD)";"-";"-";"-";"-";"-";"-";"-";"-";"-";"-";"-";"-";"4 018,33";"-27,50000%";"-11,69";"-11,69";"-";"-";"-";"-";"-";"-";"-";"-";"-";"-";"-";"-";"-";"-";"-";"-";"-";"-"
"20 Sie 2024 23:00:54";"Koszty Utrzymania Pozycji";"O2-D3-94JY88";"-";"-";"Solana (USD)";"-";"-";"-";"-";"-";"-";"-";"-";"-";"-";"-";"-";"7 175,60";"-27,50000%";"-20,88";"-20,88";"-";"-";"-";"-";"-";"-";"-";"-";"-";"-";"-";"-";"-";"-";"-";"-";"-";"-"
"20 Sie 2024 23:00:54";"Koszty Utrzymania Pozycji";"O2-D3-94S9LM";"-";"-";"Solana (USD)";"-";"-";"-";"-";"-";"-";"-";"-";"-";"-";"-";"-";"10 045,84";"-27,50000%";"-29,23";"-29,23";"-";"-";"-";"-";"-";"-";"-";"-";"-";"-";"-";"-";"-";"-";"-";"-";"-";"-"
"20 Sie 2024 23:00:54";"Koszty Utrzymania Pozycji";"O2-D5-963NM0";"-";"-";"Solana (USD)";"-";"-";"-";"-";"-";"-";"-";"-";"-";"-";"-";"-";"4 018,33";"-10,00000%";"4,21";"4,21";"-";"-";"-";"-";"-";"-";"-";"-";"-";"-";"-";"-";"-";"-";"-";"-";"-";"-"
"20 Sie 2024 23:00:54";"Koszty Utrzymania Pozycji";"O2-D4-95EL0T";"-";"-";"Solana (USD)";"-";"-";"-";"-";"-";"-";"-";"-";"-";"-";"-";"-";"5 070,27";"-27,50000%";"-14,75";"-14,75";"-";"-";"-";"-";"-";"-";"-";"-";"-";"-";"-";"-";"-";"-";"-";"-";"-";"-"
"20 Sie 2024 23:00:54";"Koszty Utrzymania Pozycji";"O2-D4-95TFDC";"-";"-";"Solana (USD)";"-";"-";"-";"-";"-";"-";"-";"-";"-";"-";"-";"-";"11 911,49";"-27,50000%";"-34,66";"-34,66";"-";"-";"-";"-";"-";"-";"-";"-";"-";"-";"-";"-";"-";"-";"-";"-";"-";"-"
"20 Sie 2024 23:00:54";"Koszty Utrzymania Pozycji";"O2-D4-95P4DE";"-";"-";"Solana (USD)";"-";"-";"-";"-";"-";"-";"-";"-";"-";"-";"-";"-";"4 305,36";"-10,00000%";"4,51";"4,51";"-";"-";"-";"-";"-";"-";"-";"-";"-";"-";"-";"-";"-";"-";"-";"-";"-";"-"
"20 Sie 2024 23:00:54";"Koszty Utrzymania Pozycji";"O2-D4-95NXX0";"-";"-";"Solana (USD)";"-";"-";"-";"-";"-";"-";"-";"-";"-";"-";"-";"-";"14 494,71";"-10,00000%";"15,18";"15,18";"-";"-";"-";"-";"-";"-";"-";"-";"-";"-";"-";"-";"-";"-";"-";"-";"-";"-"
"20 Sie 2024 23:00:54";"Koszty Utrzymania Pozycji";"O2-D4-95K8MW";"-";"-";"Solana (USD)";"-";"-";"-";"-";"-";"-";"-";"-";"-";"-";"-";"-";"15 786,32";"-10,00000%";"16,54";"16,54";"-";"-";"-";"-";"-";"-";"-";"-";"-";"-";"-";"-";"-";"-";"-";"-";"-";"-"
"20 Sie 2024 17:37:02";"Stop Loss";"O2-D5-96CJY6";"T2-D5-5K6VBY";"-";"Solana (USD)";"62 Jednost.";"142,405";"-";"-";"-";"-";"3,83577";"34 206,91";"204,52";"52 932,30";"-";"-";"-";"-";"-";"-";"-";"-";"-";"-";"-";"-";"-";"-";"-";"-";"-";"-";"-";"-";"-";"-";"-";"-"
"20 Sie 2024 17:35:45";"Zmodyfikowano Stop Loss";"O2-D5-96CJY6";"-";"O2-D5-96HNTL";"Solana (USD)";"62 Jednost.";"143,265";"-";"142,400";"-";"-";"-";"-";"-";"-";"-";"-";"-";"-";"-";"-";"-";"-";"-";"-";"-";"-";"-";"-";"-";"-";"-";"-";"-";"-";"-";"-";"-";"-"
"20 Sie 2024 17:33:56";"Zmodyfikowano Transakcję Sprzedaży";"O2-D5-96CJY6";"T2-D5-5K2KBZ";"-";"Solana (USD)";"62 Jednost.";"143,265";"-";"142,600";"140,000";"-";"-";"-";"0,00";"-";"-";"-";"-";"-";"-";"-";"-";"-";"-";"-";"-";"-";"-";"-";"-";"-";"-";"-";"-";"-";"-";"-";"-";"-"
"19 Sie 2024 23:00:47";"Koszty Utrzymania Pozycji";"1365555550";"-";"-";"Rachunek";"-";"-";"-";"-";"-";"-";"-";"-";"-93,75";"52 727,78";"-";"-";"-";"-";"-";"-93,75";"-";"-";"-";"-";"-";"-";"-";"-";"-";"-";"-";"-";"-";"-";"-";"-";"-";"-"
"19 Sie 2024 23:00:47";"Koszty Utrzymania Pozycji";"O2-D5-96FE5H";"-";"-";"Solana (USD)";"-";"-";"-";"-";"-";"-";"-";"-";"-";"-";"-";"-";"8 892,04";"-10,00000%";"9,33";"9,33";"-";"-";"-";"-";"-";"-";"-";"-";"-";"-";"-";"-";"-";"-";"-";"-";"-";"-"
"19 Sie 2024 23:00:47";"Koszty Utrzymania Pozycji";"O2-D5-96CJY6";"-";"-";"Solana (USD)";"-";"-";"-";"-";"-";"-";"-";"-";"-";"-";"-";"-";"8 892,04";"-10,00000%";"9,33";"9,33";"-";"-";"-";"-";"-";"-";"-";"-";"-";"-";"-";"-";"-";"-";"-";"-";"-";"-"
"19 Sie 2024 23:00:47";"Koszty Utrzymania Pozycji";"O2-D4-95YD2J";"-";"-";"Solana (USD)";"-";"-";"-";"-";"-";"-";"-";"-";"-";"-";"-";"-";"10 763,67";"-27,50000%";"-31,36";"-31,36";"-";"-";"-";"-";"-";"-";"-";"-";"-";"-";"-";"-";"-";"-";"-";"-";"-";"-"
"19 Sie 2024 23:00:47";"Koszty Utrzymania Pozycji";"O2-D4-96156D";"-";"-";"Solana (USD)";"-";"-";"-";"-";"-";"-";"-";"-";"-";"-";"-";"-";"3 513,79";"-27,50000%";"-10,24";"-10,24";"-";"-";"-";"-";"-";"-";"-";"-";"-";"-";"-";"-";"-";"-";"-";"-";"-";"-"
"19 Sie 2024 23:00:47";"Koszty Utrzymania Pozycji";"O2-D4-95TL4Z";"-";"-";"Solana (USD)";"-";"-";"-";"-";"-";"-";"-";"-";"-";"-";"-";"-";"4 015,76";"-27,50000%";"-11,70";"-11,70";"-";"-";"-";"-";"-";"-";"-";"-";"-";"-";"-";"-";"-";"-";"-";"-";"-";"-"
"19 Sie 2024 23:00:47";"Koszty Utrzymania Pozycji";"O2-D3-94JY88";"-";"-";"Solana (USD)";"-";"-";"-";"-";"-";"-";"-";"-";"-";"-";"-";"-";"7 171,00";"-27,50000%";"-20,89";"-20,89";"-";"-";"-";"-";"-";"-";"-";"-";"-";"-";"-";"-";"-";"-";"-";"-";"-";"-"
"19 Sie 2024 23:00:47";"Koszty Utrzymania Pozycji";"O2-D3-94S9LM";"-";"-";"Solana (USD)";"-";"-";"-";"-";"-";"-";"-";"-";"-";"-";"-";"-";"10 039,40";"-27,50000%";"-29,25";"-29,25";"-";"-";"-";"-";"-";"-";"-";"-";"-";"-";"-";"-";"-";"-";"-";"-";"-";"-"
"19 Sie 2024 23:00:47";"Koszty Utrzymania Pozycji";"O2-D5-963NM0";"-";"-";"Solana (USD)";"-";"-";"-";"-";"-";"-";"-";"-";"-";"-";"-";"-";"4 015,76";"-10,00000%";"4,21";"4,21";"-";"-";"-";"-";"-";"-";"-";"-";"-";"-";"-";"-";"-";"-";"-";"-";"-";"-"
"19 Sie 2024 23:00:47";"Koszty Utrzymania Pozycji";"O2-D4-95EL0T";"-";"-";"Solana (USD)";"-";"-";"-";"-";"-";"-";"-";"-";"-";"-";"-";"-";"5 067,02";"-27,50000%";"-14,76";"-14,76";"-";"-";"-";"-";"-";"-";"-";"-";"-";"-";"-";"-";"-";"-";"-";"-";"-";"-"
"19 Sie 2024 23:00:47";"Koszty Utrzymania Pozycji";"O2-D4-95TFDC";"-";"-";"Solana (USD)";"-";"-";"-";"-";"-";"-";"-";"-";"-";"-";"-";"-";"11 903,86";"-27,50000%";"-34,68";"-34,68";"-";"-";"-";"-";"-";"-";"-";"-";"-";"-";"-";"-";"-";"-";"-";"-";"-";"-"
"19 Sie 2024 23:00:47";"Koszty Utrzymania Pozycji";"O2-D4-95P4DE";"-";"-";"Solana (USD)";"-";"-";"-";"-";"-";"-";"-";"-";"-";"-";"-";"-";"4 302,60";"-10,00000%";"4,51";"4,51";"-";"-";"-";"-";"-";"-";"-";"-";"-";"-";"-";"-";"-";"-";"-";"-";"-";"-"
"19 Sie 2024 23:00:47";"Koszty Utrzymania Pozycji";"O2-D4-95NXX0";"-";"-";"Solana (USD)";"-";"-";"-";"-";"-";"-";"-";"-";"-";"-";"-";"-";"14 485,42";"-10,00000%";"15,20";"15,20";"-";"-";"-";"-";"-";"-";"-";"-";"-";"-";"-";"-";"-";"-";"-";"-";"-";"-"
"19 Sie 2024 23:00:47";"Koszty Utrzymania Pozycji";"O2-D4-95K8MW";"-";"-";"Solana (USD)";"-";"-";"-";"-";"-";"-";"-";"-";"-";"-";"-";"-";"15 776,20";"-10,00000%";"16,55";"16,55";"-";"-";"-";"-";"-";"-";"-";"-";"-";"-";"-";"-";"-";"-";"-";"-";"-";"-"
"19 Sie 2024 21:47:41";"Zmodyfikowano Take Profit";"O2-D5-96CJY6";"-";"O2-D5-96FSE9";"Solana (USD)";"62 Jednost.";"143,265";"-";"-";"140,000";"-";"-";"-";"-";"-";"-";"-";"-";"-";"-";"-";"-";"-";"-";"-";"-";"-";"-";"-";"-";"-";"-";"-";"-";"-";"-";"-";"-";"-"
"19 Sie 2024 21:45:36";"Zmodyfikowano Take Profit";"O2-D5-96CJY6";"-";"O2-D5-96FSE9";"Solana (USD)";"62 Jednost.";"143,265";"-";"-";"141,000";"-";"-";"-";"-";"-";"-";"-";"-";"-";"-";"-";"-";"-";"-";"-";"-";"-";"-";"-";"-";"-";"-";"-";"-";"-";"-";"-";"-";"-"
"19 Sie 2024 20:23:20";"Zmodyfikowano Transakcję Sprzedaży";"O2-D5-96CJY6";"T2-D5-5K2KBZ";"-";"Solana (USD)";"62 Jednost.";"143,265";"-";"-";"142,000";"-";"-";"-";"0,00";"-";"-";"-";"-";"-";"-";"-";"-";"-";"-";"-";"-";"-";"-";"-";"-";"-";"-";"-";"-";"-";"-";"-";"-";"-"
"19 Sie 2024 17:02:12";"Zmodyfikowano Transakcję Sprzedaży";"O2-D5-96FE5H";"T2-D5-5K4Y2B";"-";"Solana (USD)";"62 Jednost.";"143,795";"-";"-";"-";"-";"-";"-";"0,00";"-";"-";"-";"-";"-";"-";"-";"-";"-";"-";"-";"-";"-";"-";"-";"-";"-";"-";"-";"-";"-";"-";"-";"-";"-"
"19 Sie 2024 17:01:57";"Transakcja Sprzedaży";"O2-D5-96FE5H";"T2-D5-5K4Y2B";"-";"Solana (USD)";"62 Jednost.";"143,795";"-";"146,681";"-";"-";"3,876467";"34 559,82";"0,00";"-";"-";"-";"-";"-";"-";"-";"-";"-";"-";"-";"-";"-";"-";"-";"-";"-";"-";"-";"-";"-";"-";"-";"-";"-"
"19 Sie 2024 17:01:09";"Odrzucono Zlecenie: brak wystarczających środków";"O2-D5-96FE39";"-";"-";"Solana (USD)";"62 Jednost.";"-";"-";"-";"-";"-";"-";"-";"-";"-";"-";"-";"-";"-";"-";"-";"-";"-";"-";"-";"-";"-";"-";"-";"-";"-";"-";"-";"-";"-";"-";"-";"-";"-"
"16 Sie 2024 23:00:48";"Koszty Utrzymania Pozycji";"1365173513";"-";"-";"Rachunek";"-";"-";"-";"-";"-";"-";"-";"-";"-305,46";"52 821,53";"-";"-";"-";"-";"-";"-305,46";"-";"-";"-";"-";"-";"-";"-";"-";"-";"-";"-";"-";"-";"-";"-";"-";"-";"-"
"16 Sie 2024 23:00:48";"Koszty Utrzymania Pozycji";"O2-D5-96CJY6";"-";"-";"Solana (USD)";"-";"-";"-";"-";"-";"-";"-";"-";"-";"-";"-";"-";"8 740,76";"-10,00000%";"27,64";"27,64";"-";"-";"-";"-";"-";"-";"-";"-";"-";"-";"-";"-";"-";"-";"-";"-";"-";"-"
"16 Sie 2024 23:00:48";"Koszty Utrzymania Pozycji";"O2-D4-95YD2J";"-";"-";"Solana (USD)";"-";"-";"-";"-";"-";"-";"-";"-";"-";"-";"-";"-";"10 580,54";"-27,50000%";"-92,92";"-92,92";"-";"-";"-";"-";"-";"-";"-";"-";"-";"-";"-";"-";"-";"-";"-";"-";"-";"-"
"16 Sie 2024 23:00:48";"Koszty Utrzymania Pozycji";"O2-D4-96156D";"-";"-";"Solana (USD)";"-";"-";"-";"-";"-";"-";"-";"-";"-";"-";"-";"-";"3 454,01";"-27,50000%";"-30,33";"-30,33";"-";"-";"-";"-";"-";"-";"-";"-";"-";"-";"-";"-";"-";"-";"-";"-";"-";"-"
"16 Sie 2024 23:00:48";"Koszty Utrzymania Pozycji";"O2-D4-95TL4Z";"-";"-";"Solana (USD)";"-";"-";"-";"-";"-";"-";"-";"-";"-";"-";"-";"-";"3 947,44";"-27,50000%";"-34,67";"-34,67";"-";"-";"-";"-";"-";"-";"-";"-";"-";"-";"-";"-";"-";"-";"-";"-";"-";"-"
"16 Sie 2024 23:00:48";"Koszty Utrzymania Pozycji";"O2-D3-94JY88";"-";"-";"Solana (USD)";"-";"-";"-";"-";"-";"-";"-";"-";"-";"-";"-";"-";"7 049,00";"-27,50000%";"-61,91";"-61,91";"-";"-";"-";"-";"-";"-";"-";"-";"-";"-";"-";"-";"-";"-";"-";"-";"-";"-"
"16 Sie 2024 23:00:48";"Koszty Utrzymania Pozycji";"O2-D3-94S9LM";"-";"-";"Solana (USD)";"-";"-";"-";"-";"-";"-";"-";"-";"-";"-";"-";"-";"9 868,60";"-27,50000%";"-86,67";"-86,67";"-";"-";"-";"-";"-";"-";"-";"-";"-";"-";"-";"-";"-";"-";"-";"-";"-";"-"
"16 Sie 2024 23:00:48";"Koszty Utrzymania Pozycji";"O2-D5-963NM0";"-";"-";"Solana (USD)";"-";"-";"-";"-";"-";"-";"-";"-";"-";"-";"-";"-";"3 947,44";"-10,00000%";"12,48";"12,48";"-";"-";"-";"-";"-";"-";"-";"-";"-";"-";"-";"-";"-";"-";"-";"-";"-";"-"
"16 Sie 2024 23:00:48";"Koszty Utrzymania Pozycji";"O2-D4-95EL0T";"-";"-";"Solana (USD)";"-";"-";"-";"-";"-";"-";"-";"-";"-";"-";"-";"-";"4 980,82";"-27,50000%";"-43,74";"-43,74";"-";"-";"-";"-";"-";"-";"-";"-";"-";"-";"-";"-";"-";"-";"-";"-";"-";"-"
"16 Sie 2024 23:00:48";"Koszty Utrzymania Pozycji";"O2-D4-95TFDC";"-";"-";"Solana (USD)";"-";"-";"-";"-";"-";"-";"-";"-";"-";"-";"-";"-";"11 701,34";"-27,50000%";"-102,76";"-102,76";"-";"-";"-";"-";"-";"-";"-";"-";"-";"-";"-";"-";"-";"-";"-";"-";"-";"-"
"16 Sie 2024 23:00:48";"Koszty Utrzymania Pozycji";"O2-D4-95P4DE";"-";"-";"Solana (USD)";"-";"-";"-";"-";"-";"-";"-";"-";"-";"-";"-";"-";"4 229,40";"-10,00000%";"13,37";"13,37";"-";"-";"-";"-";"-";"-";"-";"-";"-";"-";"-";"-";"-";"-";"-";"-";"-";"-"
"16 Sie 2024 23:00:48";"Koszty Utrzymania Pozycji";"O2-D4-95NXX0";"-";"-";"Solana (USD)";"-";"-";"-";"-";"-";"-";"-";"-";"-";"-";"-";"-";"14 238,98";"-10,00000%";"45,02";"45,02";"-";"-";"-";"-";"-";"-";"-";"-";"-";"-";"-";"-";"-";"-";"-";"-";"-";"-"
"16 Sie 2024 23:00:48";"Koszty Utrzymania Pozycji";"O2-D4-95K8MW";"-";"-";"Solana (USD)";"-";"-";"-";"-";"-";"-";"-";"-";"-";"-";"-";"-";"15 507,80";"-10,00000%";"49,03";"49,03";"-";"-";"-";"-";"-";"-";"-";"-";"-";"-";"-";"-";"-";"-";"-";"-";"-";"-"
"16 Sie 2024 14:21:10";" Zamknięcie Transakcji";"O2-D5-96CPQB";"T2-D5-5K2P2Z";"O2-D5-963NM0";"Solana (USD)";"32 Jednost.";"140,560";"-";"-";"-";"-";"3,86823";"17 573,81";"222,81";"53 126,99";"-";"-";"-";"-";"-";"-";"-";"-";"-";"-";"-";"-";"-";"-";"-";"-";"-";"-";"-";"-";"-";"-";"-";"-"
"16 Sie 2024 14:20:06";" Zamknięcie Transakcji";"O2-D5-96CPME";"T2-D5-5K2NZS";"O2-D4-95VNWE";"Solana (USD)";"30 Jednost.";"140,797";"-";"-";"-";"-";"3,86815";"16 502,89";"217,93";"52 904,18";"-";"-";"-";"-";"-";"-";"-";"-";"-";"-";"-";"-";"-";"-";"-";"-";"-";"-";"-";"-";"-";"-";"-";"-"
"16 Sie 2024 13:02:42";"Zmodyfikowano Transakcję Sprzedaży";"O2-D5-96CJY6";"T2-D5-5K2KBZ";"-";"Solana (USD)";"62 Jednost.";"143,265";"-";"-";"-";"-";"-";"-";"0,00";"-";"-";"-";"-";"-";"-";"-";"-";"-";"-";"-";"-";"-";"-";"-";"-";"-";"-";"-";"-";"-";"-";"-";"-";"-"
"16 Sie 2024 13:02:31";"Transakcja Sprzedaży";"O2-D5-96CJY6";"T2-D5-5K2KBZ";"-";"Solana (USD)";"62 Jednost.";"143,265";"-";"146,135";"-";"-";"3,905134";"34 687,07";"0,00";"-";"-";"-";"-";"-";"-";"-";"-";"-";"-";"-";"-";"-";"-";"-";"-";"-";"-";"-";"-";"-";"-";"-";"-";"-"
"16 Sie 2024 13:01:06";" Zmodyfikowano Transakcję Kupna";"O2-D4-95TL4Z";"T2-D4-5JMBM6";"-";"Solana (USD)";"28 Jednost.";"152,490";"-";"-";"-";"-";"-";"-";"0,00";"-";"-";"-";"-";"-";"-";"-";"-";"-";"-";"-";"-";"-";"-";"-";"-";"-";"-";"-";"-";"-";"-";"-";"-";"-"
"16 Sie 2024 10:51:02";" Zmodyfikowano Transakcję Kupna";"O2-D4-95TL4Z";"T2-D4-5JMBM6";"-";"Solana (USD)";"28 Jednost.";"152,490";"-";"-";"153,000";"-";"-";"-";"0,00";"-";"-";"-";"-";"-";"-";"-";"-";"-";"-";"-";"-";"-";"-";"-";"-";"-";"-";"-";"-";"-";"-";"-";"-";"-"
"15 Sie 2024 23:00:50";"Koszty Utrzymania Pozycji";"1364787767";"-";"-";"Rachunek";"-";"-";"-";"-";"-";"-";"-";"-";"-102,62";"52 686,25";"-";"-";"-";"-";"-";"-102,62";"-";"-";"-";"-";"-";"-";"-";"-";"-";"-";"-";"-";"-";"-";"-";"-";"-";"-"
"15 Sie 2024 23:00:50";"Koszty Utrzymania Pozycji";"O2-D4-95YD2J";"-";"-";"Solana (USD)";"-";"-";"-";"-";"-";"-";"-";"-";"-";"-";"-";"-";"10 545,87";"-27,50000%";"-31,21";"-31,21";"-";"-";"-";"-";"-";"-";"-";"-";"-";"-";"-";"-";"-";"-";"-";"-";"-";"-"
"15 Sie 2024 23:00:50";"Koszty Utrzymania Pozycji";"O2-D4-96156D";"-";"-";"Solana (USD)";"-";"-";"-";"-";"-";"-";"-";"-";"-";"-";"-";"-";"3 442,69";"-27,50000%";"-10,19";"-10,19";"-";"-";"-";"-";"-";"-";"-";"-";"-";"-";"-";"-";"-";"-";"-";"-";"-";"-"
"15 Sie 2024 23:00:50";"Koszty Utrzymania Pozycji";"O2-D4-95TL4Z";"-";"-";"Solana (USD)";"-";"-";"-";"-";"-";"-";"-";"-";"-";"-";"-";"-";"3 934,50";"-27,50000%";"-11,65";"-11,65";"-";"-";"-";"-";"-";"-";"-";"-";"-";"-";"-";"-";"-";"-";"-";"-";"-";"-"
"15 Sie 2024 23:00:50";"Koszty Utrzymania Pozycji";"O2-D3-94JY88";"-";"-";"Solana (USD)";"-";"-";"-";"-";"-";"-";"-";"-";"-";"-";"-";"-";"7 025,90";"-27,50000%";"-20,80";"-20,80";"-";"-";"-";"-";"-";"-";"-";"-";"-";"-";"-";"-";"-";"-";"-";"-";"-";"-"
"15 Sie 2024 23:00:50";"Koszty Utrzymania Pozycji";"O2-D3-94S9LM";"-";"-";"Solana (USD)";"-";"-";"-";"-";"-";"-";"-";"-";"-";"-";"-";"-";"9 836,26";"-27,50000%";"-29,11";"-29,11";"-";"-";"-";"-";"-";"-";"-";"-";"-";"-";"-";"-";"-";"-";"-";"-";"-";"-"
"15 Sie 2024 23:00:50";"Koszty Utrzymania Pozycji";"O2-D5-963NM0";"-";"-";"Solana (USD)";"-";"-";"-";"-";"-";"-";"-";"-";"-";"-";"-";"-";"8 431,08";"-10,00000%";"8,98";"8,98";"-";"-";"-";"-";"-";"-";"-";"-";"-";"-";"-";"-";"-";"-";"-";"-";"-";"-"
"15 Sie 2024 23:00:50";"Koszty Utrzymania Pozycji";"O2-D4-95VNWE";"-";"-";"Solana (USD)";"-";"-";"-";"-";"-";"-";"-";"-";"-";"-";"-";"-";"4 215,54";"-10,00000%";"4,49";"4,49";"-";"-";"-";"-";"-";"-";"-";"-";"-";"-";"-";"-";"-";"-";"-";"-";"-";"-"
"15 Sie 2024 23:00:50";"Koszty Utrzymania Pozycji";"O2-D4-95EL0T";"-";"-";"Solana (USD)";"-";"-";"-";"-";"-";"-";"-";"-";"-";"-";"-";"-";"4 964,50";"-27,50000%";"-14,69";"-14,69";"-";"-";"-";"-";"-";"-";"-";"-";"-";"-";"-";"-";"-";"-";"-";"-";"-";"-"
"15 Sie 2024 23:00:50";"Koszty Utrzymania Pozycji";"O2-D4-95TFDC";"-";"-";"Solana (USD)";"-";"-";"-";"-";"-";"-";"-";"-";"-";"-";"-";"-";"11 662,99";"-27,50000%";"-34,52";"-34,52";"-";"-";"-";"-";"-";"-";"-";"-";"-";"-";"-";"-";"-";"-";"-";"-";"-";"-"
"15 Sie 2024 23:00:50";"Koszty Utrzymania Pozycji";"O2-D4-95P4DE";"-";"-";"Solana (USD)";"-";"-";"-";"-";"-";"-";"-";"-";"-";"-";"-";"-";"4 215,54";"-10,00000%";"4,49";"4,49";"-";"-";"-";"-";"-";"-";"-";"-";"-";"-";"-";"-";"-";"-";"-";"-";"-";"-"
"15 Sie 2024 23:00:50";"Koszty Utrzymania Pozycji";"O2-D4-95NXX0";"-";"-";"Solana (USD)";"-";"-";"-";"-";"-";"-";"-";"-";"-";"-";"-";"-";"14 192,31";"-10,00000%";"15,12";"15,12";"-";"-";"-";"-";"-";"-";"-";"-";"-";"-";"-";"-";"-";"-";"-";"-";"-";"-"
"15 Sie 2024 23:00:50";"Koszty Utrzymania Pozycji";"O2-D4-95K8MW";"-";"-";"Solana (USD)";"-";"-";"-";"-";"-";"-";"-";"-";"-";"-";"-";"-";"15 456,98";"-10,00000%";"16,47";"16,47";"-";"-";"-";"-";"-";"-";"-";"-";"-";"-";"-";"-";"-";"-";"-";"-";"-";"-"
"15 Sie 2024 12:44:08";"Odrzucono Zlecenie: brak wystarczających środków";"O2-D5-969248";"-";"-";"Solana (USD)";"58 Jednost.";"-";"-";"-";"-";"-";"-";"-";"-";"-";"-";"-";"-";"-";"-";"-";"-";"-";"-";"-";"-";"-";"-";"-";"-";"-";"-";"-";"-";"-";"-";"-";"-";"-"
"15 Sie 2024 12:43:48";"Odrzucono Zlecenie: brak wystarczających środków";"O2-D5-969240";"-";"-";"Solana (USD)";"60 Jednost.";"-";"-";"-";"-";"-";"-";"-";"-";"-";"-";"-";"-";"-";"-";"-";"-";"-";"-";"-";"-";"-";"-";"-";"-";"-";"-";"-";"-";"-";"-";"-";"-";"-"
"15 Sie 2024 12:43:38";"Odrzucono Zlecenie: brak wystarczających środków";"O2-D5-96923T";"-";"-";"Solana (USD)";"62 Jednost.";"-";"-";"-";"-";"-";"-";"-";"-";"-";"-";"-";"-";"-";"-";"-";"-";"-";"-";"-";"-";"-";"-";"-";"-";"-";"-";"-";"-";"-";"-";"-";"-";"-"
"15 Sie 2024 10:06:47";" Zamknięcie Transakcji";"O2-D5-968WSN";"T2-D5-5K09FY";"O2-D4-95VNWE";"Solana (USD)";"3 Jednost.";"142,205";"-";"-";"-";"-";"3,87152";"1 668,24";"5,46";"52 788,87";"-";"-";"-";"-";"-";"-";"-";"-";"-";"-";"-";"-";"-";"-";"-";"-";"-";"-";"-";"-";"-";"-";"-";"-"
"15 Sie 2024 10:06:12";" Zamknięcie Transakcji";"O2-D5-968WS1";"T2-D5-5K09FF";"O2-D5-963NM0";"Solana (USD)";"4 Jednost.";"142,215";"-";"-";"-";"-";"3,87153";"2 224,49";"2,25";"52 783,41";"-";"-";"-";"-";"-";"-";"-";"-";"-";"-";"-";"-";"-";"-";"-";"-";"-";"-";"-";"-";"-";"-";"-";"-"
"15 Sie 2024 09:58:47";" Zamknięcie Transakcji";"O2-D5-968WFB";"T2-D5-5K094Y";"O2-D4-95VNWE";"Solana (USD)";"3 Jednost.";"142,615";"-";"-";"-";"-";"3,8693";"1 672,09";"0,70";"52 781,16";"-";"-";"-";"-";"-";"-";"-";"-";"-";"-";"-";"-";"-";"-";"-";"-";"-";"-";"-";"-";"-";"-";"-";"-"
"15 Sie 2024 09:56:53";" Zamknięcie Transakcji";"O2-D5-968WC6";"T2-D5-5K092M";"O2-D4-95VNWE";"Solana (USD)";"26 Jednost.";"142,655";"-";"-";"-";"-";"3,87015";"14 498,79";"2,01";"52 780,46";"-";"-";"-";"-";"-";"-";"-";"-";"-";"-";"-";"-";"-";"-";"-";"-";"-";"-";"-";"-";"-";"-";"-";"-"
"15 Sie 2024 09:13:15";"Zmodyfikowano Transakcję Sprzedaży";"O2-D4-95P4DE";"T2-D4-5JJ3P4";"-";"Solana (USD)";"30 Jednost.";"138,895";"-";"-";"-";"-";"-";"-";"0,00";"-";"-";"-";"-";"-";"-";"-";"-";"-";"-";"-";"-";"-";"-";"-";"-";"-";"-";"-";"-";"-";"-";"-";"-";"-"
"14 Sie 2024 23:26:15";"Zmodyfikowano Transakcję Sprzedaży";"O2-D4-95P4DE";"T2-D4-5JJ3P4";"-";"Solana (USD)";"30 Jednost.";"138,895";"-";"-";"138,000";"-";"-";"-";"0,00";"-";"-";"-";"-";"-";"-";"-";"-";"-";"-";"-";"-";"-";"-";"-";"-";"-";"-";"-";"-";"-";"-";"-";"-";"-"
"14 Sie 2024 23:00:51";"Koszty Utrzymania Pozycji";"1364333110";"-";"-";"Rachunek";"-";"-";"-";"-";"-";"-";"-";"-";"-99,50";"52 778,45";"-";"-";"-";"-";"-";"-99,50";"-";"-";"-";"-";"-";"-";"-";"-";"-";"-";"-";"-";"-";"-";"-";"-";"-";"-"
"14 Sie 2024 23:00:51";"Koszty Utrzymania Pozycji";"O2-D4-95YD2J";"-";"-";"Solana (USD)";"-";"-";"-";"-";"-";"-";"-";"-";"-";"-";"-";"-";"10 826,71";"-27,50000%";"-31,95";"-31,95";"-";"-";"-";"-";"-";"-";"-";"-";"-";"-";"-";"-";"-";"-";"-";"-";"-";"-"
"14 Sie 2024 23:00:51";"Koszty Utrzymania Pozycji";"O2-D4-96156D";"-";"-";"Solana (USD)";"-";"-";"-";"-";"-";"-";"-";"-";"-";"-";"-";"-";"3 534,37";"-27,50000%";"-10,43";"-10,43";"-";"-";"-";"-";"-";"-";"-";"-";"-";"-";"-";"-";"-";"-";"-";"-";"-";"-"
"14 Sie 2024 23:00:51";"Koszty Utrzymania Pozycji";"O2-D4-95TL4Z";"-";"-";"Solana (USD)";"-";"-";"-";"-";"-";"-";"-";"-";"-";"-";"-";"-";"4 039,28";"-27,50000%";"-11,92";"-11,92";"-";"-";"-";"-";"-";"-";"-";"-";"-";"-";"-";"-";"-";"-";"-";"-";"-";"-"
"14 Sie 2024 23:00:51";"Koszty Utrzymania Pozycji";"O2-D5-963NM0";"-";"-";"Solana (USD)";"-";"-";"-";"-";"-";"-";"-";"-";"-";"-";"-";"-";"9 232,64";"-10,00000%";"9,81";"9,81";"-";"-";"-";"-";"-";"-";"-";"-";"-";"-";"-";"-";"-";"-";"-";"-";"-";"-"
"14 Sie 2024 23:00:51";"Koszty Utrzymania Pozycji";"O2-D3-94JY88";"-";"-";"Solana (USD)";"-";"-";"-";"-";"-";"-";"-";"-";"-";"-";"-";"-";"7 213,00";"-27,50000%";"-21,28";"-21,28";"-";"-";"-";"-";"-";"-";"-";"-";"-";"-";"-";"-";"-";"-";"-";"-";"-";"-"
"14 Sie 2024 23:00:51";"Koszty Utrzymania Pozycji";"O2-D3-94S9LM";"-";"-";"Solana (USD)";"-";"-";"-";"-";"-";"-";"-";"-";"-";"-";"-";"-";"10 098,20";"-27,50000%";"-29,80";"-29,80";"-";"-";"-";"-";"-";"-";"-";"-";"-";"-";"-";"-";"-";"-";"-";"-";"-";"-"
"14 Sie 2024 23:00:51";"Koszty Utrzymania Pozycji";"O2-D4-95EL0T";"-";"-";"Solana (USD)";"-";"-";"-";"-";"-";"-";"-";"-";"-";"-";"-";"-";"5 096,70";"-27,50000%";"-15,04";"-15,04";"-";"-";"-";"-";"-";"-";"-";"-";"-";"-";"-";"-";"-";"-";"-";"-";"-";"-"
"14 Sie 2024 23:00:51";"Koszty Utrzymania Pozycji";"O2-D4-95TFDC";"-";"-";"Solana (USD)";"-";"-";"-";"-";"-";"-";"-";"-";"-";"-";"-";"-";"11 973,58";"-27,50000%";"-35,33";"-35,33";"-";"-";"-";"-";"-";"-";"-";"-";"-";"-";"-";"-";"-";"-";"-";"-";"-";"-"
"14 Sie 2024 23:00:51";"Koszty Utrzymania Pozycji";"O2-D4-95VNWE";"-";"-";"Solana (USD)";"-";"-";"-";"-";"-";"-";"-";"-";"-";"-";"-";"-";"8 944,12";"-10,00000%";"9,50";"9,50";"-";"-";"-";"-";"-";"-";"-";"-";"-";"-";"-";"-";"-";"-";"-";"-";"-";"-"
"14 Sie 2024 23:00:51";"Koszty Utrzymania Pozycji";"O2-D4-95P4DE";"-";"-";"Solana (USD)";"-";"-";"-";"-";"-";"-";"-";"-";"-";"-";"-";"-";"4 327,80";"-10,00000%";"4,60";"4,60";"-";"-";"-";"-";"-";"-";"-";"-";"-";"-";"-";"-";"-";"-";"-";"-";"-";"-"
"14 Sie 2024 23:00:51";"Koszty Utrzymania Pozycji";"O2-D4-95NXX0";"-";"-";"Solana (USD)";"-";"-";"-";"-";"-";"-";"-";"-";"-";"-";"-";"-";"14 570,26";"-10,00000%";"15,48";"15,48";"-";"-";"-";"-";"-";"-";"-";"-";"-";"-";"-";"-";"-";"-";"-";"-";"-";"-"
"14 Sie 2024 23:00:51";"Koszty Utrzymania Pozycji";"O2-D4-95K8MW";"-";"-";"Solana (USD)";"-";"-";"-";"-";"-";"-";"-";"-";"-";"-";"-";"-";"15 868,60";"-10,00000%";"16,86";"16,86";"-";"-";"-";"-";"-";"-";"-";"-";"-";"-";"-";"-";"-";"-";"-";"-";"-";"-"
"14 Sie 2024 14:51:48";" Zamknięcie Transakcji";"O2-D5-96730K";"T2-D5-5JYRYB";"O2-D5-965JKS";"Solana (USD)";"24 Jednost.";"150,300";"-";"-";"-";"-";"3,88037";"14 137,96";"90,80";"52 877,95";"-";"-";"-";"-";"-";"-";"-";"-";"-";"-";"-";"-";"-";"-";"-";"-";"-";"-";"-";"-";"-";"-";"-";"-"
"13 Sie 2024 23:01:43";" Zamknięcie Transakcji";"O2-D5-965X8M";"T2-D5-5JXSBS";"O2-D5-965X34";"Solana (USD)";"26 Jednost.";"146,270";"-";"-";"-";"-";"3,921938";"14 915,20";"-30,59";"52 787,15";"-";"-";"-";"-";"-";"-";"-";"-";"-";"-";"-";"-";"-";"-";"-";"-";"-";"-";"-";"-";"-";"-";"-";"-"
"13 Sie 2024 23:00:46";"Koszty Utrzymania Pozycji";"1363899910";"-";"-";"Rachunek";"-";"-";"-";"-";"-";"-";"-";"-";"-107,15";"52 817,74";"-";"-";"-";"-";"-";"-107,15";"-";"-";"-";"-";"-";"-";"-";"-";"-";"-";"-";"-";"-";"-";"-";"-";"-";"-"
"13 Sie 2024 23:00:46";"Koszty Utrzymania Pozycji";"O2-D5-965JKS";"-";"-";"Solana (USD)";"-";"-";"-";"-";"-";"-";"-";"-";"-";"-";"-";"-";"3 504,00";"-27,50000%";"-10,35";"-10,35";"-";"-";"-";"-";"-";"-";"-";"-";"-";"-";"-";"-";"-";"-";"-";"-";"-";"-"
"13 Sie 2024 23:00:46";"Koszty Utrzymania Pozycji";"O2-D4-95YD2J";"-";"-";"Solana (USD)";"-";"-";"-";"-";"-";"-";"-";"-";"-";"-";"-";"-";"10 957,30";"-27,50000%";"-32,38";"-32,38";"-";"-";"-";"-";"-";"-";"-";"-";"-";"-";"-";"-";"-";"-";"-";"-";"-";"-"
"13 Sie 2024 23:00:46";"Koszty Utrzymania Pozycji";"O2-D4-96156D";"-";"-";"Solana (USD)";"-";"-";"-";"-";"-";"-";"-";"-";"-";"-";"-";"-";"3 577,00";"-27,50000%";"-10,57";"-10,57";"-";"-";"-";"-";"-";"-";"-";"-";"-";"-";"-";"-";"-";"-";"-";"-";"-";"-"
"13 Sie 2024 23:00:46";"Koszty Utrzymania Pozycji";"O2-D4-95TL4Z";"-";"-";"Solana (USD)";"-";"-";"-";"-";"-";"-";"-";"-";"-";"-";"-";"-";"4 088,00";"-27,50000%";"-12,08";"-12,08";"-";"-";"-";"-";"-";"-";"-";"-";"-";"-";"-";"-";"-";"-";"-";"-";"-";"-"
"13 Sie 2024 23:00:46";"Koszty Utrzymania Pozycji";"O2-D5-963NM0";"-";"-";"Solana (USD)";"-";"-";"-";"-";"-";"-";"-";"-";"-";"-";"-";"-";"9 344,00";"-10,00000%";"9,94";"9,94";"-";"-";"-";"-";"-";"-";"-";"-";"-";"-";"-";"-";"-";"-";"-";"-";"-";"-"
"13 Sie 2024 23:00:46";"Koszty Utrzymania Pozycji";"O2-D3-94JY88";"-";"-";"Solana (USD)";"-";"-";"-";"-";"-";"-";"-";"-";"-";"-";"-";"-";"7 300,00";"-27,50000%";"-21,57";"-21,57";"-";"-";"-";"-";"-";"-";"-";"-";"-";"-";"-";"-";"-";"-";"-";"-";"-";"-"
"13 Sie 2024 23:00:46";"Koszty Utrzymania Pozycji";"O2-D3-94S9LM";"-";"-";"Solana (USD)";"-";"-";"-";"-";"-";"-";"-";"-";"-";"-";"-";"-";"10 220,00";"-27,50000%";"-30,20";"-30,20";"-";"-";"-";"-";"-";"-";"-";"-";"-";"-";"-";"-";"-";"-";"-";"-";"-";"-"
"13 Sie 2024 23:00:46";"Koszty Utrzymania Pozycji";"O2-D5-965X34";"-";"-";"Solana (USD)";"-";"-";"-";"-";"-";"-";"-";"-";"-";"-";"-";"-";"3 796,00";"-10,00000%";"4,04";"4,04";"-";"-";"-";"-";"-";"-";"-";"-";"-";"-";"-";"-";"-";"-";"-";"-";"-";"-"
"13 Sie 2024 23:00:46";"Koszty Utrzymania Pozycji";"O2-D4-95EL0T";"-";"-";"Solana (USD)";"-";"-";"-";"-";"-";"-";"-";"-";"-";"-";"-";"-";"5 158,18";"-27,50000%";"-15,24";"-15,24";"-";"-";"-";"-";"-";"-";"-";"-";"-";"-";"-";"-";"-";"-";"-";"-";"-";"-"
"13 Sie 2024 23:00:46";"Koszty Utrzymania Pozycji";"O2-D4-95TFDC";"-";"-";"Solana (USD)";"-";"-";"-";"-";"-";"-";"-";"-";"-";"-";"-";"-";"12 118,00";"-27,50000%";"-35,80";"-35,80";"-";"-";"-";"-";"-";"-";"-";"-";"-";"-";"-";"-";"-";"-";"-";"-";"-";"-"
"13 Sie 2024 23:00:46";"Koszty Utrzymania Pozycji";"O2-D4-95VNWE";"-";"-";"Solana (USD)";"-";"-";"-";"-";"-";"-";"-";"-";"-";"-";"-";"-";"9 052,00";"-10,00000%";"9,63";"9,63";"-";"-";"-";"-";"-";"-";"-";"-";"-";"-";"-";"-";"-";"-";"-";"-";"-";"-"
"13 Sie 2024 23:00:46";"Koszty Utrzymania Pozycji";"O2-D4-95P4DE";"-";"-";"Solana (USD)";"-";"-";"-";"-";"-";"-";"-";"-";"-";"-";"-";"-";"4 380,00";"-10,00000%";"4,66";"4,66";"-";"-";"-";"-";"-";"-";"-";"-";"-";"-";"-";"-";"-";"-";"-";"-";"-";"-"
"13 Sie 2024 23:00:46";"Koszty Utrzymania Pozycji";"O2-D4-95NXX0";"-";"-";"Solana (USD)";"-";"-";"-";"-";"-";"-";"-";"-";"-";"-";"-";"-";"14 746,00";"-10,00000%";"15,69";"15,69";"-";"-";"-";"-";"-";"-";"-";"-";"-";"-";"-";"-";"-";"-";"-";"-";"-";"-"
"13 Sie 2024 23:00:46";"Koszty Utrzymania Pozycji";"O2-D4-95K8MW";"-";"-";"Solana (USD)";"-";"-";"-";"-";"-";"-";"-";"-";"-";"-";"-";"-";"16 060,00";"-10,00000%";"17,08";"17,08";"-";"-";"-";"-";"-";"-";"-";"-";"-";"-";"-";"-";"-";"-";"-";"-";"-";"-"
"13 Sie 2024 22:57:24";"Transakcja Sprzedaży";"O2-D5-965X34";"T2-D5-5JXS5K";"-";"Solana (USD)";"26 Jednost.";"145,970";"-";"148,889";"-";"-";"3,921337";"14 882,33";"0,00";"-";"-";"-";"-";"-";"-";"-";"-";"-";"-";"-";"-";"-";"-";"-";"-";"-";"-";"-";"-";"-";"-";"-";"-";"-"
"13 Sie 2024 21:17:06";"Stop Loss";"O2-D5-965DWC";"T2-D5-5JXNLH";"-";"Solana (USD)";"24 Jednost.";"145,880";"-";"-";"-";"-";"3,88033";"13 722,05";"15,37";"52 924,89";"-";"-";"-";"-";"-";"-";"-";"-";"-";"-";"-";"-";"-";"-";"-";"-";"-";"-";"-";"-";"-";"-";"-";"-"
"13 Sie 2024 21:16:33";"Zmodyfikowano Stop Loss";"O2-D5-965DWC";"-";"O2-D5-965S5E";"Solana (USD)";"24 Jednost.";"146,045";"-";"145,850";"-";"-";"-";"-";"-";"-";"-";"-";"-";"-";"-";"-";"-";"-";"-";"-";"-";"-";"-";"-";"-";"-";"-";"-";"-";"-";"-";"-";"-";"-"
"13 Sie 2024 21:15:32";"Zmodyfikowano Transakcję Sprzedaży";"O2-D5-965DWC";"T2-D5-5JXBT5";"-";"Solana (USD)";"24 Jednost.";"146,045";"-";"145,950";"-";"-";"-";"-";"0,00";"-";"-";"-";"-";"-";"-";"-";"-";"-";"-";"-";"-";"-";"-";"-";"-";"-";"-";"-";"-";"-";"-";"-";"-";"-"
"13 Sie 2024 18:57:53";" Zmodyfikowano Transakcję Kupna";"O2-D5-965JKS";"T2-D5-5JXG0H";"-";"Solana (USD)";"24 Jednost.";"149,325";"-";"-";"-";"-";"-";"-";"0,00";"-";"-";"-";"-";"-";"-";"-";"-";"-";"-";"-";"-";"-";"-";"-";"-";"-";"-";"-";"-";"-";"-";"-";"-";"-"
"13 Sie 2024 18:57:35";" Transakcja Kupna";"O2-D5-965JKS";"T2-D5-5JXG0H";"-";"Solana (USD)";"24 Jednost.";"149,325";"-";"146,319";"-";"-";"3,929473";"14 082,44";"0,00";"-";"-";"-";"-";"-";"-";"-";"-";"-";"-";"-";"-";"-";"-";"-";"-";"-";"-";"-";"-";"-";"-";"-";"-";"-"
"13 Sie 2024 17:51:04";"Zmodyfikowano Transakcję Sprzedaży";"O2-D5-965DWC";"T2-D5-5JXBT5";"-";"Solana (USD)";"24 Jednost.";"146,045";"-";"-";"-";"-";"-";"-";"0,00";"-";"-";"-";"-";"-";"-";"-";"-";"-";"-";"-";"-";"-";"-";"-";"-";"-";"-";"-";"-";"-";"-";"-";"-";"-"
"13 Sie 2024 17:50:52";"Transakcja Sprzedaży";"O2-D5-965DWC";"T2-D5-5JXBT5";"-";"Solana (USD)";"24 Jednost.";"146,045";"-";"148,965";"-";"-";"3,936597";"13 798,08";"0,00";"-";"-";"-";"-";"-";"-";"-";"-";"-";"-";"-";"-";"-";"-";"-";"-";"-";"-";"-";"-";"-";"-";"-";"-";"-"
"13 Sie 2024 17:28:43";"Stop Loss";"O2-D5-965BM6";"T2-D5-5JX9J4";"-";"Solana (USD)";"25 Jednost.";"145,775";"-";"-";"-";"-";"3,898";"14 348,51";"24,95";"52 909,52";"-";"-";"-";"-";"-";"-";"-";"-";"-";"-";"-";"-";"-";"-";"-";"-";"-";"-";"-";"-";"-";"-";"-";"-"
"13 Sie 2024 17:28:37";" Zmodyfikowano Transakcję Kupna";"O2-D5-965BM6";"T2-D5-5JX8Z2";"-";"Solana (USD)";"25 Jednost.";"145,519";"-";"145,800";"-";"-";"-";"-";"0,00";"-";"-";"-";"-";"-";"-";"-";"-";"-";"-";"-";"-";"-";"-";"-";"-";"-";"-";"-";"-";"-";"-";"-";"-";"-"
"13 Sie 2024 17:20:28";" Zmodyfikowano Transakcję Kupna";"O2-D5-965BM6";"T2-D5-5JX8Z2";"-";"Solana (USD)";"25 Jednost.";"145,519";"-";"-";"-";"-";"-";"-";"0,00";"-";"-";"-";"-";"-";"-";"-";"-";"-";"-";"-";"-";"-";"-";"-";"-";"-";"-";"-";"-";"-";"-";"-";"-";"-"
"13 Sie 2024 17:20:16";" Transakcja Kupna";"O2-D5-965BM6";"T2-D5-5JX8Z2";"-";"Solana (USD)";"25 Jednost.";"145,519";"-";"142,609";"-";"-";"3,936086";"14 319,38";"0,00";"-";"-";"-";"-";"-";"-";"-";"-";"-";"-";"-";"-";"-";"-";"-";"-";"-";"-";"-";"-";"-";"-";"-";"-";"-"
"13 Sie 2024 17:10:23";"Stop Loss";"O2-D5-9658V9";"T2-D5-5JX8GH";"-";"Solana (USD)";"24 Jednost.";"145,705";"-";"-";"-";"-";"3,89496";"13 757,23";"59,73";"52 884,57";"-";"-";"-";"-";"-";"-";"-";"-";"-";"-";"-";"-";"-";"-";"-";"-";"-";"-";"-";"-";"-";"-";"-";"-"
"13 Sie 2024 17:10:02";"Zmodyfikowano Stop Loss";"O2-D5-9658V9";"-";"O2-D5-9659SL";"Solana (USD)";"24 Jednost.";"146,344";"-";"145,700";"-";"-";"-";"-";"-";"-";"-";"-";"-";"-";"-";"-";"-";"-";"-";"-";"-";"-";"-";"-";"-";"-";"-";"-";"-";"-";"-";"-";"-";"-"
"13 Sie 2024 17:09:10";"Zmodyfikowano Stop Loss";"O2-D5-9658V9";"-";"O2-D5-9659SL";"Solana (USD)";"24 Jednost.";"146,344";"-";"145,800";"-";"-";"-";"-";"-";"-";"-";"-";"-";"-";"-";"-";"-";"-";"-";"-";"-";"-";"-";"-";"-";"-";"-";"-";"-";"-";"-";"-";"-";"-"
"13 Sie 2024 17:08:42";"Zmodyfikowano Transakcję Sprzedaży";"O2-D5-9658V9";"T2-D5-5JX7GY";"-";"Solana (USD)";"24 Jednost.";"146,344";"-";"145,900";"-";"-";"-";"-";"0,00";"-";"-";"-";"-";"-";"-";"-";"-";"-";"-";"-";"-";"-";"-";"-";"-";"-";"-";"-";"-";"-";"-";"-";"-";"-"
"13 Sie 2024 16:59:08";"Zmodyfikowano Transakcję Sprzedaży";"O2-D5-9658V9";"T2-D5-5JX7GY";"-";"Solana (USD)";"24 Jednost.";"146,344";"-";"-";"-";"-";"-";"-";"0,00";"-";"-";"-";"-";"-";"-";"-";"-";"-";"-";"-";"-";"-";"-";"-";"-";"-";"-";"-";"-";"-";"-";"-";"-";"-"
"13 Sie 2024 16:58:58";"Transakcja Sprzedaży";"O2-D5-9658V9";"T2-D5-5JX7GY";"-";"Solana (USD)";"24 Jednost.";"146,344";"-";"149,270";"-";"-";"3,933601";"13 815,81";"0,00";"-";"-";"-";"-";"-";"-";"-";"-";"-";"-";"-";"-";"-";"-";"-";"-";"-";"-";"-";"-";"-";"-";"-";"-";"-"
"13 Sie 2024 16:33:39";"Stop Loss";"O2-D5-96519Q";"T2-D5-5JX4LL";"-";"Solana (USD)";"24 Jednost.";"145,015";"-";"-";"-";"-";"3,89802";"13 702,83";"194,59";"52 824,84";"-";"-";"-";"-";"-";"-";"-";"-";"-";"-";"-";"-";"-";"-";"-";"-";"-";"-";"-";"-";"-";"-";"-";"-"
"13 Sie 2024 16:33:31";"Zmodyfikowano Stop Loss";"O2-D5-96519Q";"-";"O2-D5-9655EB";"Solana (USD)";"24 Jednost.";"147,095";"-";"145,000";"-";"-";"-";"-";"-";"-";"-";"-";"-";"-";"-";"-";"-";"-";"-";"-";"-";"-";"-";"-";"-";"-";"-";"-";"-";"-";"-";"-";"-";"-"
"13 Sie 2024 16:33:11";"Zmodyfikowano Transakcję Sprzedaży";"O2-D5-96519Q";"T2-D5-5JX14Z";"-";"Solana (USD)";"24 Jednost.";"147,095";"-";"145,700";"-";"-";"-";"-";"0,00";"-";"-";"-";"-";"-";"-";"-";"-";"-";"-";"-";"-";"-";"-";"-";"-";"-";"-";"-";"-";"-";"-";"-";"-";"-"
"13 Sie 2024 16:00:31";"Zmodyfikowano Transakcję Sprzedaży";"O2-D5-96519Q";"T2-D5-5JX14Z";"-";"Solana (USD)";"24 Jednost.";"147,095";"-";"-";"-";"-";"-";"-";"0,00";"-";"-";"-";"-";"-";"-";"-";"-";"-";"-";"-";"-";"-";"-";"-";"-";"-";"-";"-";"-";"-";"-";"-";"-";"-"
"13 Sie 2024 16:00:20";"Transakcja Sprzedaży";"O2-D5-96519Q";"T2-D5-5JX14Z";"-";"Solana (USD)";"24 Jednost.";"147,095";"-";"150,036";"-";"-";"3,934904";"13 891,31";"0,00";"-";"-";"-";"-";"-";"-";"-";"-";"-";"-";"-";"-";"-";"-";"-";"-";"-";"-";"-";"-";"-";"-";"-";"-";"-"
"13 Sie 2024 15:14:14";" Zamknięcie Transakcji";"O2-D5-964SZ0";"T2-D5-5JWTMV";"O2-D5-964R7M";"Solana (USD)";"24 Jednost.";"146,045";"-";"-";"-";"-";"3,90132";"13 811,85";"8,43";"52 630,25";"-";"-";"-";"-";"-";"-";"-";"-";"-";"-";"-";"-";"-";"-";"-";"-";"-";"-";"-";"-";"-";"-";"-";"-"
"13 Sie 2024 14:51:01";" Zmodyfikowano Transakcję Kupna";"O2-D5-964R7M";"T2-D5-5JWS7S";"-";"Solana (USD)";"24 Jednost.";"145,955";"-";"-";"-";"-";"-";"-";"0,00";"-";"-";"-";"-";"-";"-";"-";"-";"-";"-";"-";"-";"-";"-";"-";"-";"-";"-";"-";"-";"-";"-";"-";"-";"-"
"13 Sie 2024 14:50:50";" Transakcja Kupna";"O2-D5-964R7M";"T2-D5-5JWS7S";"-";"Solana (USD)";"24 Jednost.";"145,955";"-";"143,036";"-";"-";"3,937519";"13 792,81";"0,00";"-";"-";"-";"-";"-";"-";"-";"-";"-";"-";"-";"-";"-";"-";"-";"-";"-";"-";"-";"-";"-";"-";"-";"-";"-"
"13 Sie 2024 12:56:56";"Stop Loss";"O2-D5-964GCJ";"T2-D5-5JWKG1";"-";"Solana (USD)";"24 Jednost.";"144,750";"-";"-";"-";"-";"3,90348";"13 696,97";"19,21";"52 621,82";"-";"-";"-";"-";"-";"-";"-";"-";"-";"-";"-";"-";"-";"-";"-";"-";"-";"-";"-";"-";"-";"-";"-";"-"
"13 Sie 2024 12:50:17";" Zmodyfikowano Transakcję Kupna";"O2-D5-964GCJ";"T2-D5-5JWJKP";"-";"Solana (USD)";"24 Jednost.";"144,545";"-";"144,750";"-";"-";"-";"-";"0,00";"-";"-";"-";"-";"-";"-";"-";"-";"-";"-";"-";"-";"-";"-";"-";"-";"-";"-";"-";"-";"-";"-";"-";"-";"-"
"13 Sie 2024 12:36:31";" Zmodyfikowano Transakcję Kupna";"O2-D5-964GCJ";"T2-D5-5JWJKP";"-";"Solana (USD)";"24 Jednost.";"144,545";"-";"-";"-";"-";"-";"-";"0,00";"-";"-";"-";"-";"-";"-";"-";"-";"-";"-";"-";"-";"-";"-";"-";"-";"-";"-";"-";"-";"-";"-";"-";"-";"-"
"13 Sie 2024 12:36:16";" Transakcja Kupna";"O2-D5-964GCJ";"T2-D5-5JWJKP";"-";"Solana (USD)";"24 Jednost.";"144,545";"-";"141,655";"-";"-";"3,943381";"13 679,90";"0,00";"-";"-";"-";"-";"-";"-";"-";"-";"-";"-";"-";"-";"-";"-";"-";"-";"-";"-";"-";"-";"-";"-";"-";"-";"-"
"13 Sie 2024 12:10:49";" Zamknięcie Transakcji";"O2-D5-964ELN";"T2-D5-5JWH2R";"O2-D4-95VRP3";"Solana (USD)";"23 Jednost.";"144,520";"-";"-";"-";"-";"3,945104";"13 113,36";"-92,55";"52 602,61";"-";"-";"-";"-";"-";"-";"-";"-";"-";"-";"-";"-";"-";"-";"-";"-";"-";"-";"-";"-";"-";"-";"-";"-"
"13 Sie 2024 12:06:39";"Zmodyfikowano Transakcję Sprzedaży";"O2-D4-95VRP3";"T2-D4-5JND3Q";"-";"Solana (USD)";"23 Jednost.";"143,500";"-";"-";"143,000";"-";"-";"-";"0,00";"-";"-";"-";"-";"-";"-";"-";"-";"-";"-";"-";"-";"-";"-";"-";"-";"-";"-";"-";"-";"-";"-";"-";"-";"-"
"13 Sie 2024 01:19:42";"Take Profit";"O2-D5-963GCG";"T2-D5-5JVXL9";"-";"Solana (USD)";"50 Jednost.";"147,000";"-";"-";"-";"-";"3,92002";"29 101,75";"109,76";"52 695,16";"-";"-";"-";"-";"-";"-";"-";"-";"-";"-";"-";"-";"-";"-";"-";"-";"-";"-";"-";"-";"-";"-";"-";"-"
"12 Sie 2024 23:38:05";" Zmodyfikowano Transakcję Kupna";"O2-D5-963GCG";"T2-D5-5JVQE4";"-";"Solana (USD)";"50 Jednost.";"146,440";"-";"-";"147,000";"-";"-";"-";"0,00";"-";"-";"-";"-";"-";"-";"-";"-";"-";"-";"-";"-";"-";"-";"-";"-";"-";"-";"-";"-";"-";"-";"-";"-";"-"
"12 Sie 2024 23:32:31";" Zamknięcie Transakcji";"O2-D5-963NQ6";"T2-D5-5JVWSN";"O2-D5-963H4L";"Solana (USD)";"10 Jednost.";"143,570";"-";"-";"-";"-";"3,91928";"5 683,46";"47,82";"52 585,40";"-";"-";"-";"-";"-";"-";"-";"-";"-";"-";"-";"-";"-";"-";"-";"-";"-";"-";"-";"-";"-";"-";"-";"-"
"12 Sie 2024 23:29:58";" Zamknięcie Transakcji";"O2-D5-963NPH";"T2-D5-5JVWS9";"O2-D4-95VRP3";"Solana (USD)";"10,38 Jednost.";"142,855";"-";"-";"-";"-";"3,91953";"5 870,42";"26,24";"52 537,58";"-";"-";"-";"-";"-";"-";"-";"-";"-";"-";"-";"-";"-";"-";"-";"-";"-";"-";"-";"-";"-";"-";"-";"-"
"12 Sie 2024 23:26:00";" Zamknięcie Transakcji";"O2-D5-963NNW";"T2-D5-5JVWRZ";"O2-D5-963F76";"Solana (USD)";"26,5 Jednost.";"142,842";"-";"-";"-";"-";"3,91938";"14 985,18";"267,24";"52 511,34";"-";"-";"-";"-";"-";"-";"-";"-";"-";"-";"-";"-";"-";"-";"-";"-";"-";"-";"-";"-";"-";"-";"-";"-"
"12 Sie 2024 23:07:23";" Zmodyfikowano Transakcję Kupna";"O2-D5-963GCG";"T2-D5-5JVQE4";"-";"Solana (USD)";"50 Jednost.";"146,440";"-";"-";"-";"-";"-";"-";"0,00";"-";"-";"-";"-";"-";"-";"-";"-";"-";"-";"-";"-";"-";"-";"-";"-";"-";"-";"-";"-";"-";"-";"-";"-";"-"
"12 Sie 2024 23:06:46";"Zmodyfikowano Transakcję Sprzedaży";"O2-D5-963NM0";"T2-D5-5JVWQZ";"-";"Solana (USD)";"64 Jednost.";"142,360";"-";"-";"-";"-";"-";"-";"0,00";"-";"-";"-";"-";"-";"-";"-";"-";"-";"-";"-";"-";"-";"-";"-";"-";"-";"-";"-";"-";"-";"-";"-";"-";"-"
"12 Sie 2024 23:06:33";"Transakcja Sprzedaży";"O2-D5-963NM0";"T2-D5-5JVWQZ";"-";"Solana (USD)";"64 Jednost.";"142,360";"-";"145,207";"-";"-";"3,959573";"36 075,82";"0,00";"-";"-";"-";"-";"-";"-";"-";"-";"-";"-";"-";"-";"-";"-";"-";"-";"-";"-";"-";"-";"-";"-";"-";"-";"-"
"12 Sie 2024 23:00:45";"Koszty Utrzymania Pozycji";"1363507603";"-";"-";"Rachunek";"-";"-";"-";"-";"-";"-";"-";"-";"-120,41";"52 244,10";"-";"-";"-";"-";"-";"-120,41";"-";"-";"-";"-";"-";"-";"-";"-";"-";"-";"-";"-";"-";"-";"-";"-";"-";"-"
"12 Sie 2024 23:00:45";"Koszty Utrzymania Pozycji";"O2-D5-963GCG";"-";"-";"Solana (USD)";"-";"-";"-";"-";"-";"-";"-";"-";"-";"-";"-";"-";"7 170,75";"-27,50000%";"-21,38";"-21,38";"-";"-";"-";"-";"-";"-";"-";"-";"-";"-";"-";"-";"-";"-";"-";"-";"-";"-"
"12 Sie 2024 23:00:45";"Koszty Utrzymania Pozycji";"O2-D5-963H4L";"-";"-";"Solana (USD)";"-";"-";"-";"-";"-";"-";"-";"-";"-";"-";"-";"-";"1 434,15";"-10,00000%";"1,54";"1,54";"-";"-";"-";"-";"-";"-";"-";"-";"-";"-";"-";"-";"-";"-";"-";"-";"-";"-"
"12 Sie 2024 23:00:45";"Koszty Utrzymania Pozycji";"O2-D4-95YD2J";"-";"-";"Solana (USD)";"-";"-";"-";"-";"-";"-";"-";"-";"-";"-";"-";"-";"10 763,29";"-27,50000%";"-32,09";"-32,09";"-";"-";"-";"-";"-";"-";"-";"-";"-";"-";"-";"-";"-";"-";"-";"-";"-";"-"
"12 Sie 2024 23:00:45";"Koszty Utrzymania Pozycji";"O2-D4-96156D";"-";"-";"Solana (USD)";"-";"-";"-";"-";"-";"-";"-";"-";"-";"-";"-";"-";"3 513,66";"-27,50000%";"-10,48";"-10,48";"-";"-";"-";"-";"-";"-";"-";"-";"-";"-";"-";"-";"-";"-";"-";"-";"-";"-"
"12 Sie 2024 23:00:45";"Koszty Utrzymania Pozycji";"O2-D4-95TL4Z";"-";"-";"Solana (USD)";"-";"-";"-";"-";"-";"-";"-";"-";"-";"-";"-";"-";"4 015,62";"-27,50000%";"-11,97";"-11,97";"-";"-";"-";"-";"-";"-";"-";"-";"-";"-";"-";"-";"-";"-";"-";"-";"-";"-"
"12 Sie 2024 23:00:45";"Koszty Utrzymania Pozycji";"O2-D3-94JY88";"-";"-";"Solana (USD)";"-";"-";"-";"-";"-";"-";"-";"-";"-";"-";"-";"-";"7 170,75";"-27,50000%";"-21,38";"-21,38";"-";"-";"-";"-";"-";"-";"-";"-";"-";"-";"-";"-";"-";"-";"-";"-";"-";"-"
"12 Sie 2024 23:00:45";"Koszty Utrzymania Pozycji";"O2-D3-94S9LM";"-";"-";"Solana (USD)";"-";"-";"-";"-";"-";"-";"-";"-";"-";"-";"-";"-";"10 039,05";"-27,50000%";"-29,93";"-29,93";"-";"-";"-";"-";"-";"-";"-";"-";"-";"-";"-";"-";"-";"-";"-";"-";"-";"-"
"12 Sie 2024 23:00:45";"Koszty Utrzymania Pozycji";"O2-D5-963F76";"-";"-";"Solana (USD)";"-";"-";"-";"-";"-";"-";"-";"-";"-";"-";"-";"-";"3 800,49";"-10,00000%";"4,08";"4,08";"-";"-";"-";"-";"-";"-";"-";"-";"-";"-";"-";"-";"-";"-";"-";"-";"-";"-"
"12 Sie 2024 23:00:45";"Koszty Utrzymania Pozycji";"O2-D4-95EL0T";"-";"-";"Solana (USD)";"-";"-";"-";"-";"-";"-";"-";"-";"-";"-";"-";"-";"5 066,85";"-27,50000%";"-15,11";"-15,11";"-";"-";"-";"-";"-";"-";"-";"-";"-";"-";"-";"-";"-";"-";"-";"-";"-";"-"
"12 Sie 2024 23:00:45";"Koszty Utrzymania Pozycji";"O2-D4-95TFDC";"-";"-";"Solana (USD)";"-";"-";"-";"-";"-";"-";"-";"-";"-";"-";"-";"-";"11 903,44";"-27,50000%";"-35,49";"-35,49";"-";"-";"-";"-";"-";"-";"-";"-";"-";"-";"-";"-";"-";"-";"-";"-";"-";"-"
"12 Sie 2024 23:00:45";"Koszty Utrzymania Pozycji";"O2-D4-95VRP3";"-";"-";"Solana (USD)";"-";"-";"-";"-";"-";"-";"-";"-";"-";"-";"-";"-";"4 787,19";"-10,00000%";"5,14";"5,14";"-";"-";"-";"-";"-";"-";"-";"-";"-";"-";"-";"-";"-";"-";"-";"-";"-";"-"
"12 Sie 2024 23:00:45";"Koszty Utrzymania Pozycji";"O2-D4-95VNWE";"-";"-";"Solana (USD)";"-";"-";"-";"-";"-";"-";"-";"-";"-";"-";"-";"-";"8 891,73";"-10,00000%";"9,55";"9,55";"-";"-";"-";"-";"-";"-";"-";"-";"-";"-";"-";"-";"-";"-";"-";"-";"-";"-"
"12 Sie 2024 23:00:45";"Koszty Utrzymania Pozycji";"O2-D4-95P4DE";"-";"-";"Solana (USD)";"-";"-";"-";"-";"-";"-";"-";"-";"-";"-";"-";"-";"4 302,45";"-10,00000%";"4,62";"4,62";"-";"-";"-";"-";"-";"-";"-";"-";"-";"-";"-";"-";"-";"-";"-";"-";"-";"-"
"12 Sie 2024 23:00:45";"Koszty Utrzymania Pozycji";"O2-D4-95NXX0";"-";"-";"Solana (USD)";"-";"-";"-";"-";"-";"-";"-";"-";"-";"-";"-";"-";"14 484,91";"-10,00000%";"15,55";"15,55";"-";"-";"-";"-";"-";"-";"-";"-";"-";"-";"-";"-";"-";"-";"-";"-";"-";"-"
"12 Sie 2024 23:00:45";"Koszty Utrzymania Pozycji";"O2-D4-95K8MW";"-";"-";"Solana (USD)";"-";"-";"-";"-";"-";"-";"-";"-";"-";"-";"-";"-";"15 775,65";"-10,00000%";"16,94";"16,94";"-";"-";"-";"-";"-";"-";"-";"-";"-";"-";"-";"-";"-";"-";"-";"-";"-";"-"
"12 Sie 2024 22:50:51";" Zmodyfikowano Transakcję Kupna";"O2-D5-963GCG";"T2-D5-5JVQE4";"-";"Solana (USD)";"50 Jednost.";"146,440";"-";"-";"147,000";"-";"-";"-";"0,00";"-";"-";"-";"-";"-";"-";"-";"-";"-";"-";"-";"-";"-";"-";"-";"-";"-";"-";"-";"-";"-";"-";"-";"-";"-"
"12 Sie 2024 20:29:21";"Zmodyfikowano Transakcję Sprzedaży";"O2-D5-963H4L";"T2-D5-5JVR2D";"-";"Solana (USD)";"10 Jednost.";"144,790";"-";"-";"-";"-";"-";"-";"0,00";"-";"-";"-";"-";"-";"-";"-";"-";"-";"-";"-";"-";"-";"-";"-";"-";"-";"-";"-";"-";"-";"-";"-";"-";"-"
"12 Sie 2024 20:29:05";"Transakcja Sprzedaży";"O2-D5-963H4L";"T2-D5-5JVR2D";"-";"Solana (USD)";"10 Jednost.";"144,790";"-";"147,685";"-";"-";"3,956747";"5 728,97";"0,00";"-";"-";"-";"-";"-";"-";"-";"-";"-";"-";"-";"-";"-";"-";"-";"-";"-";"-";"-";"-";"-";"-";"-";"-";"-"
"12 Sie 2024 20:28:02";" Zamknięcie Transakcji";"O2-D5-963H2N";"T2-D5-5JVR0R";"O2-D5-963F76";"Solana (USD)";"26,5 Jednost.";"145,099";"-";"-";"-";"-";"3,91695";"15 212,48";"32,80";"52 364,51";"-";"-";"-";"-";"-";"-";"-";"-";"-";"-";"-";"-";"-";"-";"-";"-";"-";"-";"-";"-";"-";"-";"-";"-"
"12 Sie 2024 20:14:21";" Zmodyfikowano Transakcję Kupna";"O2-D5-963GCG";"T2-D5-5JVQE4";"-";"Solana (USD)";"50 Jednost.";"146,440";"-";"-";"-";"-";"-";"-";"0,00";"-";"-";"-";"-";"-";"-";"-";"-";"-";"-";"-";"-";"-";"-";"-";"-";"-";"-";"-";"-";"-";"-";"-";"-";"-"
"12 Sie 2024 20:13:57";" Transakcja Kupna";"O2-D5-963GCG";"T2-D5-5JVQE4";"-";"Solana (USD)";"50 Jednost.";"146,440";"-";"143,512";"-";"-";"3,955575";"28 962,72";"0,00";"-";"-";"-";"-";"-";"-";"-";"-";"-";"-";"-";"-";"-";"-";"-";"-";"-";"-";"-";"-";"-";"-";"-";"-";"-"
"12 Sie 2024 19:54:00";"Zmodyfikowano Transakcję Sprzedaży";"O2-D5-963F76";"T2-D5-5JVPGF";"-";"Solana (USD)";"53 Jednost.";"145,415";"-";"-";"-";"-";"-";"-";"0,00";"-";"-";"-";"-";"-";"-";"-";"-";"-";"-";"-";"-";"-";"-";"-";"-";"-";"-";"-";"-";"-";"-";"-";"-";"-"
"12 Sie 2024 19:53:48";"Transakcja Sprzedaży";"O2-D5-963F76";"T2-D5-5JVPGF";"-";"Solana (USD)";"53 Jednost.";"145,415";"-";"148,333";"-";"-";"3,956106";"30 489,68";"0,00";"-";"-";"-";"-";"-";"-";"-";"-";"-";"-";"-";"-";"-";"-";"-";"-";"-";"-";"-";"-";"-";"-";"-";"-";"-"
"12 Sie 2024 18:21:24";" Zamknięcie Transakcji";"O2-D5-9638FG";"T2-D5-5JVJEL";"O2-D5-9636M7";"Solana (USD)";"53 Jednost.";"146,820";"-";"-";"-";"-";"3,91842";"30 797,37";"11,42";"52 331,71";"-";"-";"-";"-";"-";"-";"-";"-";"-";"-";"-";"-";"-";"-";"-";"-";"-";"-";"-";"-";"-";"-";"-";"-"
"12 Sie 2024 18:03:15";"Zmodyfikowano Transakcję Sprzedaży";"O2-D5-9636M7";"T2-D5-5JVGWC";"-";"Solana (USD)";"53 Jednost.";"146,875";"-";"-";"-";"-";"-";"-";"0,00";"-";"-";"-";"-";"-";"-";"-";"-";"-";"-";"-";"-";"-";"-";"-";"-";"-";"-";"-";"-";"-";"-";"-";"-";"-"
"12 Sie 2024 18:01:17";"Transakcja Sprzedaży";"O2-D5-9636M7";"T2-D5-5JVGWC";"-";"Solana (USD)";"53 Jednost.";"146,875";"-";"149,822";"-";"-";"3,957098";"30 803,53";"0,00";"-";"-";"-";"-";"-";"-";"-";"-";"-";"-";"-";"-";"-";"-";"-";"-";"-";"-";"-";"-";"-";"-";"-";"-";"-"
"12 Sie 2024 17:40:19";" Zamknięcie Transakcji";"O2-D5-9634EY";"T2-D5-5JVF10";"O2-D5-962SLQ";"Solana (USD)";"53 Jednost.";"146,450";"-";"-";"-";"-";"3,91779";"30 714,94";"0,00";"52 320,29";"-";"-";"-";"-";"-";"-";"-";"-";"-";"-";"-";"-";"-";"-";"-";"-";"-";"-";"-";"-";"-";"-";"-";"-"
"12 Sie 2024 16:15:36";"Zmodyfikowano Transakcję Sprzedaży";"O2-D5-962SLQ";"T2-D5-5JV4X4";"-";"Solana (USD)";"53 Jednost.";"146,450";"-";"-";"-";"-";"-";"-";"0,00";"-";"-";"-";"-";"-";"-";"-";"-";"-";"-";"-";"-";"-";"-";"-";"-";"-";"-";"-";"-";"-";"-";"-";"-";"-"
"12 Sie 2024 16:15:23";"Transakcja Sprzedaży";"O2-D5-962SLQ";"T2-D5-5JV4X4";"-";"Solana (USD)";"53 Jednost.";"146,450";"-";"149,394";"-";"-";"3,961687";"30 750,02";"0,00";"-";"-";"-";"-";"-";"-";"-";"-";"-";"-";"-";"-";"-";"-";"-";"-";"-";"-";"-";"-";"-";"-";"-";"-";"-"
"12 Sie 2024 16:13:38";" Zamknięcie Transakcji";"O2-D5-962S9E";"T2-D5-5JV4NG";"O2-D5-962D61";"Solana (USD)";"51 Jednost.";"145,785";"-";"-";"-";"-";"3,92258";"29 457,59";"738,19";"52 320,29";"-";"-";"-";"-";"-";"-";"-";"-";"-";"-";"-";"-";"-";"-";"-";"-";"-";"-";"-";"-";"-";"-";"-";"-"
"12 Sie 2024 14:12:27";"Zmodyfikowano Transakcję Sprzedaży";"O2-D5-962D61";"T2-D5-5JTT2B";"-";"Solana (USD)";"51 Jednost.";"149,475";"-";"-";"-";"-";"-";"-";"0,00";"-";"-";"-";"-";"-";"-";"-";"-";"-";"-";"-";"-";"-";"-";"-";"-";"-";"-";"-";"-";"-";"-";"-";"-";"-"
"12 Sie 2024 14:12:13";"Transakcja Sprzedaży";"O2-D5-962D61";"T2-D5-5JTT2B";"-";"Solana (USD)";"51 Jednost.";"149,475";"-";"152,464";"-";"-";"3,960896";"30 194,80";"0,00";"-";"-";"-";"-";"-";"-";"-";"-";"-";"-";"-";"-";"-";"-";"-";"-";"-";"-";"-";"-";"-";"-";"-";"-";"-"
"12 Sie 2024 11:55:29";" Zamknięcie Transakcji";"O2-D5-9626MZ";"T2-D5-5JTNT2";"O2-D4-95TZ9L";"Solana (USD)";"3 Jednost.";"144,410";"-";"-";"-";"-";"3,92203";"1 716,22";"27,89";"51 582,10";"-";"-";"-";"-";"-";"-";"-";"-";"-";"-";"-";"-";"-";"-";"-";"-";"-";"-";"-";"-";"-";"-";"-";"-"
"12 Sie 2024 11:55:06";" Zamknięcie Transakcji";"O2-D5-9626MQ";"T2-D5-5JTNSW";"O2-D4-95TZ9L";"Solana (USD)";"2 Jednost.";"144,395";"-";"-";"-";"-";"3,92194";"1 143,99";"18,71";"51 554,21";"-";"-";"-";"-";"-";"-";"-";"-";"-";"-";"-";"-";"-";"-";"-";"-";"-";"-";"-";"-";"-";"-";"-";"-"
"09 Sie 2024 23:00:44";"Koszty Utrzymania Pozycji";"1363121359";"-";"-";"Rachunek";"-";"-";"-";"-";"-";"-";"-";"-";"-335,60";"51 535,50";"-";"-";"-";"-";"-";"-335,60";"-";"-";"-";"-";"-";"-";"-";"-";"-";"-";"-";"-";"-";"-";"-";"-";"-";"-"
"09 Sie 2024 23:00:44";"Koszty Utrzymania Pozycji";"O2-D4-95EL0T";"-";"-";"Solana (USD)";"-";"-";"-";"-";"-";"-";"-";"-";"-";"-";"-";"-";"5 428,70";"-27,50000%";"-48,80";"-48,80";"-";"-";"-";"-";"-";"-";"-";"-";"-";"-";"-";"-";"-";"-";"-";"-";"-";"-"
"09 Sie 2024 23:00:44";"Koszty Utrzymania Pozycji";"O2-D4-95TZ9L";"-";"-";"Solana (USD)";"-";"-";"-";"-";"-";"-";"-";"-";"-";"-";"-";"-";"768,28";"-10,00000%";"2,49";"2,49";"-";"-";"-";"-";"-";"-";"-";"-";"-";"-";"-";"-";"-";"-";"-";"-";"-";"-"
"09 Sie 2024 23:00:44";"Koszty Utrzymania Pozycji";"O2-D4-96156D";"-";"-";"Solana (USD)";"-";"-";"-";"-";"-";"-";"-";"-";"-";"-";"-";"-";"3 764,59";"-27,50000%";"-33,84";"-33,84";"-";"-";"-";"-";"-";"-";"-";"-";"-";"-";"-";"-";"-";"-";"-";"-";"-";"-"
"09 Sie 2024 23:00:44";"Koszty Utrzymania Pozycji";"O2-D4-95P4DE";"-";"-";"Solana (USD)";"-";"-";"-";"-";"-";"-";"-";"-";"-";"-";"-";"-";"4 609,71";"-10,00000%";"14,92";"14,92";"-";"-";"-";"-";"-";"-";"-";"-";"-";"-";"-";"-";"-";"-";"-";"-";"-";"-"
"09 Sie 2024 23:00:44";"Koszty Utrzymania Pozycji";"O2-D4-95TFDC";"-";"-";"Solana (USD)";"-";"-";"-";"-";"-";"-";"-";"-";"-";"-";"-";"-";"12 753,53";"-27,50000%";"-114,64";"-114,64";"-";"-";"-";"-";"-";"-";"-";"-";"-";"-";"-";"-";"-";"-";"-";"-";"-";"-"
"09 Sie 2024 23:00:44";"Koszty Utrzymania Pozycji";"O2-D4-95K8MW";"-";"-";"Solana (USD)";"-";"-";"-";"-";"-";"-";"-";"-";"-";"-";"-";"-";"16 902,27";"-10,00000%";"54,70";"54,70";"-";"-";"-";"-";"-";"-";"-";"-";"-";"-";"-";"-";"-";"-";"-";"-";"-";"-"
"09 Sie 2024 23:00:44";"Koszty Utrzymania Pozycji";"O2-D4-95YD2J";"-";"-";"Solana (USD)";"-";"-";"-";"-";"-";"-";"-";"-";"-";"-";"-";"-";"11 531,95";"-27,50000%";"-103,66";"-103,66";"-";"-";"-";"-";"-";"-";"-";"-";"-";"-";"-";"-";"-";"-";"-";"-";"-";"-"
"09 Sie 2024 23:00:44";"Koszty Utrzymania Pozycji";"O2-D4-95NXX0";"-";"-";"Solana (USD)";"-";"-";"-";"-";"-";"-";"-";"-";"-";"-";"-";"-";"15 519,35";"-10,00000%";"50,22";"50,22";"-";"-";"-";"-";"-";"-";"-";"-";"-";"-";"-";"-";"-";"-";"-";"-";"-";"-"
"09 Sie 2024 23:00:44";"Koszty Utrzymania Pozycji";"O2-D4-95VNWE";"-";"-";"Solana (USD)";"-";"-";"-";"-";"-";"-";"-";"-";"-";"-";"-";"-";"9 526,73";"-10,00000%";"30,83";"30,83";"-";"-";"-";"-";"-";"-";"-";"-";"-";"-";"-";"-";"-";"-";"-";"-";"-";"-"
"09 Sie 2024 23:00:44";"Koszty Utrzymania Pozycji";"O2-D3-94S9LM";"-";"-";"Solana (USD)";"-";"-";"-";"-";"-";"-";"-";"-";"-";"-";"-";"-";"10 755,99";"-27,50000%";"-96,69";"-96,69";"-";"-";"-";"-";"-";"-";"-";"-";"-";"-";"-";"-";"-";"-";"-";"-";"-";"-"
"09 Sie 2024 23:00:44";"Koszty Utrzymania Pozycji";"O2-D4-95TL4Z";"-";"-";"Solana (USD)";"-";"-";"-";"-";"-";"-";"-";"-";"-";"-";"-";"-";"4 302,39";"-27,50000%";"-38,67";"-38,67";"-";"-";"-";"-";"-";"-";"-";"-";"-";"-";"-";"-";"-";"-";"-";"-";"-";"-"
"09 Sie 2024 23:00:44";"Koszty Utrzymania Pozycji";"O2-D3-94JY88";"-";"-";"Solana (USD)";"-";"-";"-";"-";"-";"-";"-";"-";"-";"-";"-";"-";"7 682,85";"-27,50000%";"-69,06";"-69,06";"-";"-";"-";"-";"-";"-";"-";"-";"-";"-";"-";"-";"-";"-";"-";"-";"-";"-"
"09 Sie 2024 23:00:44";"Koszty Utrzymania Pozycji";"O2-D4-95VRP3";"-";"-";"Solana (USD)";"-";"-";"-";"-";"-";"-";"-";"-";"-";"-";"-";"-";"5 129,07";"-10,00000%";"16,60";"16,60";"-";"-";"-";"-";"-";"-";"-";"-";"-";"-";"-";"-";"-";"-";"-";"-";"-";"-"
"09 Sie 2024 19:34:32";" Zmodyfikowano Transakcję Kupna";"O2-D4-96156D";"T2-D4-5JSTL9";"-";"Solana (USD)";"24,5 Jednost.";"153,885";"-";"-";"-";"-";"-";"-";"0,00";"-";"-";"-";"-";"-";"-";"-";"-";"-";"-";"-";"-";"-";"-";"-";"-";"-";"-";"-";"-";"-";"-";"-";"-";"-"
"09 Sie 2024 19:34:18";" Transakcja Kupna";"O2-D4-96156D";"T2-D4-5JSTL9";"-";"Solana (USD)";"24,5 Jednost.";"153,885";"-";"150,808";"-";"-";"3,973381";"14 980,37";"0,00";"-";"-";"-";"-";"-";"-";"-";"-";"-";"-";"-";"-";"-";"-";"-";"-";"-";"-";"-";"-";"-";"-";"-";"-";"-"
"09 Sie 2024 19:33:58";"Odrzucono Zlecenie: brak wystarczających środków";"O2-D4-961553";"-";"-";"Solana (USD)";"49 Jednost.";"-";"-";"-";"-";"-";"-";"-";"-";"-";"-";"-";"-";"-";"-";"-";"-";"-";"-";"-";"-";"-";"-";"-";"-";"-";"-";"-";"-";"-";"-";"-";"-";"-"
"09 Sie 2024 06:35:30";" Zamknięcie Transakcji";"O2-D4-95ZE7J";"T2-D4-5JRBE7";"O2-D4-95EL0T";"Solana (USD)";"36,17 Jednost.";"157,970";"-";"-";"-";"-";"3,93677";"22 719,83";"123,17";"51 871,10";"-";"-";"-";"-";"-";"-";"-";"-";"-";"-";"-";"-";"-";"-";"-";"-";"-";"-";"-";"-";"-";"-";"-";"-"
"08 Sie 2024 23:00:53";"Koszty Utrzymania Pozycji";"1362721846";"-";"-";"Rachunek";"-";"-";"-";"-";"-";"-";"-";"-";"-118,88";"51 747,93";"-";"-";"-";"-";"-";"-118,88";"-";"-";"-";"-";"-";"-";"-";"-";"-";"-";"-";"-";"-";"-";"-";"-";"-";"-"
"08 Sie 2024 23:00:53";"Koszty Utrzymania Pozycji";"O2-D4-95TL4Z";"-";"-";"Solana (USD)";"-";"-";"-";"-";"-";"-";"-";"-";"-";"-";"-";"-";"4 363,24";"-27,50000%";"-13,07";"-13,07";"-";"-";"-";"-";"-";"-";"-";"-";"-";"-";"-";"-";"-";"-";"-";"-";"-";"-"
"08 Sie 2024 23:00:53";"Koszty Utrzymania Pozycji";"O2-D3-94JY88";"-";"-";"Solana (USD)";"-";"-";"-";"-";"-";"-";"-";"-";"-";"-";"-";"-";"7 791,50";"-27,50000%";"-23,34";"-23,34";"-";"-";"-";"-";"-";"-";"-";"-";"-";"-";"-";"-";"-";"-";"-";"-";"-";"-"
"08 Sie 2024 23:00:53";"Koszty Utrzymania Pozycji";"O2-D4-95VRP3";"-";"-";"Solana (USD)";"-";"-";"-";"-";"-";"-";"-";"-";"-";"-";"-";"-";"5 201,60";"-10,00000%";"5,61";"5,61";"-";"-";"-";"-";"-";"-";"-";"-";"-";"-";"-";"-";"-";"-";"-";"-";"-";"-"
"08 Sie 2024 23:00:53";"Koszty Utrzymania Pozycji";"O2-D4-95EL0T";"-";"-";"Solana (USD)";"-";"-";"-";"-";"-";"-";"-";"-";"-";"-";"-";"-";"11 141,84";"-27,50000%";"-33,38";"-33,38";"-";"-";"-";"-";"-";"-";"-";"-";"-";"-";"-";"-";"-";"-";"-";"-";"-";"-"
"08 Sie 2024 23:00:53";"Koszty Utrzymania Pozycji";"O2-D4-95TZ9L";"-";"-";"Solana (USD)";"-";"-";"-";"-";"-";"-";"-";"-";"-";"-";"-";"-";"779,15";"-10,00000%";"0,84";"0,84";"-";"-";"-";"-";"-";"-";"-";"-";"-";"-";"-";"-";"-";"-";"-";"-";"-";"-"
"08 Sie 2024 23:00:53";"Koszty Utrzymania Pozycji";"O2-D4-95P4DE";"-";"-";"Solana (USD)";"-";"-";"-";"-";"-";"-";"-";"-";"-";"-";"-";"-";"4 674,90";"-10,00000%";"5,04";"5,04";"-";"-";"-";"-";"-";"-";"-";"-";"-";"-";"-";"-";"-";"-";"-";"-";"-";"-"
"08 Sie 2024 23:00:53";"Koszty Utrzymania Pozycji";"O2-D4-95TFDC";"-";"-";"Solana (USD)";"-";"-";"-";"-";"-";"-";"-";"-";"-";"-";"-";"-";"12 933,89";"-27,50000%";"-38,75";"-38,75";"-";"-";"-";"-";"-";"-";"-";"-";"-";"-";"-";"-";"-";"-";"-";"-";"-";"-"
"08 Sie 2024 23:00:53";"Koszty Utrzymania Pozycji";"O2-D4-95K8MW";"-";"-";"Solana (USD)";"-";"-";"-";"-";"-";"-";"-";"-";"-";"-";"-";"-";"17 141,30";"-10,00000%";"18,49";"18,49";"-";"-";"-";"-";"-";"-";"-";"-";"-";"-";"-";"-";"-";"-";"-";"-";"-";"-"
"08 Sie 2024 23:00:53";"Koszty Utrzymania Pozycji";"O2-D4-95YD2J";"-";"-";"Solana (USD)";"-";"-";"-";"-";"-";"-";"-";"-";"-";"-";"-";"-";"11 695,04";"-27,50000%";"-35,04";"-35,04";"-";"-";"-";"-";"-";"-";"-";"-";"-";"-";"-";"-";"-";"-";"-";"-";"-";"-"
"08 Sie 2024 23:00:53";"Koszty Utrzymania Pozycji";"O2-D4-95NXX0";"-";"-";"Solana (USD)";"-";"-";"-";"-";"-";"-";"-";"-";"-";"-";"-";"-";"15 738,83";"-10,00000%";"16,98";"16,98";"-";"-";"-";"-";"-";"-";"-";"-";"-";"-";"-";"-";"-";"-";"-";"-";"-";"-"
"08 Sie 2024 23:00:53";"Koszty Utrzymania Pozycji";"O2-D4-95VNWE";"-";"-";"Solana (USD)";"-";"-";"-";"-";"-";"-";"-";"-";"-";"-";"-";"-";"9 661,46";"-10,00000%";"10,42";"10,42";"-";"-";"-";"-";"-";"-";"-";"-";"-";"-";"-";"-";"-";"-";"-";"-";"-";"-"
"08 Sie 2024 23:00:53";"Koszty Utrzymania Pozycji";"O2-D3-94S9LM";"-";"-";"Solana (USD)";"-";"-";"-";"-";"-";"-";"-";"-";"-";"-";"-";"-";"10 908,10";"-27,50000%";"-32,68";"-32,68";"-";"-";"-";"-";"-";"-";"-";"-";"-";"-";"-";"-";"-";"-";"-";"-";"-";"-"
"08 Sie 2024 20:19:12";"Stop Loss";"O2-D4-95YLTQ";"T2-D4-5JQR83";"-";"Solana (USD)";"71,11 Jednost.";"156,995";"-";"-";"-";"-";"3,94377";"44 470,34";"42,07";"51 866,81";"-";"-";"-";"-";"-";"-";"-";"-";"-";"-";"-";"-";"-";"-";"-";"-";"-";"-";"-";"-";"-";"-";"-";"-"
"08 Sie 2024 20:18:41";"Zmodyfikowano Transakcję Sprzedaży";"O2-D4-95YLTQ";"T2-D4-5JQN6L";"-";"Solana (USD)";"71,11 Jednost.";"157,145";"-";"156,980";"-";"-";"-";"-";"0,00";"-";"-";"-";"-";"-";"-";"-";"-";"-";"-";"-";"-";"-";"-";"-";"-";"-";"-";"-";"-";"-";"-";"-";"-";"-"
"08 Sie 2024 19:34:07";"Zmodyfikowano Transakcję Sprzedaży";"O2-D4-95YLTQ";"T2-D4-5JQN6L";"-";"Solana (USD)";"71,11 Jednost.";"157,145";"-";"-";"-";"-";"-";"-";"0,00";"-";"-";"-";"-";"-";"-";"-";"-";"-";"-";"-";"-";"-";"-";"-";"-";"-";"-";"-";"-";"-";"-";"-";"-";"-"
"08 Sie 2024 19:33:53";"Transakcja Sprzedaży";"O2-D4-95YLTQ";"T2-D4-5JQN6L";"-";"Solana (USD)";"71,11 Jednost.";"157,145";"-";"160,257";"-";"-";"3,982759";"44 505,66";"0,00";"-";"-";"-";"-";"-";"-";"-";"-";"-";"-";"-";"-";"-";"-";"-";"-";"-";"-";"-";"-";"-";"-";"-";"-";"-"
"08 Sie 2024 17:59:00";" Zmodyfikowano Transakcję Kupna";"O2-D4-95YD2J";"T2-D4-5JQFHG";"-";"Solana (USD)";"75,05 Jednost.";"160,570";"-";"-";"-";"-";"-";"-";"0,00";"-";"-";"-";"-";"-";"-";"-";"-";"-";"-";"-";"-";"-";"-";"-";"-";"-";"-";"-";"-";"-";"-";"-";"-";"-"
"08 Sie 2024 17:58:50";" Transakcja Kupna";"O2-D4-95YD2J";"T2-D4-5JQFHG";"-";"Solana (USD)";"75,05 Jednost.";"160,570";"-";"157,374";"-";"-";"3,982589";"47 993,29";"0,00";"-";"-";"-";"-";"-";"-";"-";"-";"-";"-";"-";"-";"-";"-";"-";"-";"-";"-";"-";"-";"-";"-";"-";"-";"-"
"08 Sie 2024 17:43:33";" Zamknięcie Transakcji";"O2-D4-95YBYY";"T2-D4-5JQEMQ";"O2-D4-95TFDC";"Solana (USD)";"2 Jednost.";"159,000";"-";"-";"-";"-";"3,94457";"1 266,97";"34,20";"51 824,74";"-";"-";"-";"-";"-";"-";"-";"-";"-";"-";"-";"-";"-";"-";"-";"-";"-";"-";"-";"-";"-";"-";"-";"-"
"08 Sie 2024 16:39:30";"Stop Loss";"O2-D4-95Y2NB";"T2-D4-5JQ7E1";"-";"Solana (USD)";"62 Jednost.";"159,661";"-";"-";"-";"-";"3,94802";"39 474,06";"103,79";"51 790,54";"-";"-";"-";"-";"-";"-";"-";"-";"-";"-";"-";"-";"-";"-";"-";"-";"-";"-";"-";"-";"-";"-";"-";"-"
"08 Sie 2024 16:39:27";" Zmodyfikowano Transakcję Kupna";"O2-D4-95Y2NB";"T2-D4-5JQ6MF";"-";"Solana (USD)";"62 Jednost.";"159,237";"-";"159,700";"-";"-";"-";"-";"0,00";"-";"-";"-";"-";"-";"-";"-";"-";"-";"-";"-";"-";"-";"-";"-";"-";"-";"-";"-";"-";"-";"-";"-";"-";"-"
"08 Sie 2024 16:34:29";" Zmodyfikowano Transakcję Kupna";"O2-D4-95Y2NB";"T2-D4-5JQ6MF";"-";"Solana (USD)";"62 Jednost.";"159,237";"-";"-";"-";"-";"-";"-";"0,00";"-";"-";"-";"-";"-";"-";"-";"-";"-";"-";"-";"-";"-";"-";"-";"-";"-";"-";"-";"-";"-";"-";"-";"-";"-"
"08 Sie 2024 16:34:12";" Transakcja Kupna";"O2-D4-95Y2NB";"T2-D4-5JQ6MF";"-";"Solana (USD)";"62 Jednost.";"159,237";"-";"156,053";"-";"-";"3,98801";"39 372,40";"0,00";"-";"-";"-";"-";"-";"-";"-";"-";"-";"-";"-";"-";"-";"-";"-";"-";"-";"-";"-";"-";"-";"-";"-";"-";"-"
"08 Sie 2024 06:16:59";" Zamknięcie Transakcji";"O2-D4-95WBVM";"T2-D4-5JNVHK";"O2-D4-95TL4Z";"Solana (USD)";"2,98 Jednost.";"153,800";"-";"-";"-";"-";"3,93502";"1 821,63";"15,36";"51 686,75";"-";"-";"-";"-";"-";"-";"-";"-";"-";"-";"-";"-";"-";"-";"-";"-";"-";"-";"-";"-";"-";"-";"-";"-"
"08 Sie 2024 06:15:49";" Zamknięcie Transakcji";"O2-D4-95WBT4";"T2-D4-5JNVGK";"O2-D4-95V1H4";"Solana (USD)";"33,9 Jednost.";"153,935";"-";"-";"-";"-";"3,93488";"20 740,11";"741,66";"51 671,39";"-";"-";"-";"-";"-";"-";"-";"-";"-";"-";"-";"-";"-";"-";"-";"-";"-";"-";"-";"-";"-";"-";"-";"-"
"07 Sie 2024 23:00:44";"Koszty Utrzymania Pozycji";"1362234800";"-";"-";"Rachunek";"-";"-";"-";"-";"-";"-";"-";"-";"-94,86";"50 929,73";"-";"-";"-";"-";"-";"-94,86";"-";"-";"-";"-";"-";"-";"-";"-";"-";"-";"-";"-";"-";"-";"-";"-";"-";"-"
"07 Sie 2024 23:00:44";"Koszty Utrzymania Pozycji";"O2-D4-95TZ9L";"-";"-";"Solana (USD)";"-";"-";"-";"-";"-";"-";"-";"-";"-";"-";"-";"-";"723,85";"-10,00000%";"0,78";"0,78";"-";"-";"-";"-";"-";"-";"-";"-";"-";"-";"-";"-";"-";"-";"-";"-";"-";"-"
"07 Sie 2024 23:00:44";"Koszty Utrzymania Pozycji";"O2-D4-95V1H4";"-";"-";"Solana (USD)";"-";"-";"-";"-";"-";"-";"-";"-";"-";"-";"-";"-";"4 907,70";"-27,50000%";"-14,72";"-14,72";"-";"-";"-";"-";"-";"-";"-";"-";"-";"-";"-";"-";"-";"-";"-";"-";"-";"-"
"07 Sie 2024 23:00:44";"Koszty Utrzymania Pozycji";"O2-D4-95TFDC";"-";"-";"Solana (USD)";"-";"-";"-";"-";"-";"-";"-";"-";"-";"-";"-";"-";"12 305,45";"-27,50000%";"-36,91";"-36,91";"-";"-";"-";"-";"-";"-";"-";"-";"-";"-";"-";"-";"-";"-";"-";"-";"-";"-"
"07 Sie 2024 23:00:44";"Koszty Utrzymania Pozycji";"O2-D4-95P4DE";"-";"-";"Solana (USD)";"-";"-";"-";"-";"-";"-";"-";"-";"-";"-";"-";"-";"4 343,10";"-10,00000%";"4,69";"4,69";"-";"-";"-";"-";"-";"-";"-";"-";"-";"-";"-";"-";"-";"-";"-";"-";"-";"-"
"07 Sie 2024 23:00:44";"Koszty Utrzymania Pozycji";"O2-D4-95K8MW";"-";"-";"Solana (USD)";"-";"-";"-";"-";"-";"-";"-";"-";"-";"-";"-";"-";"15 924,70";"-10,00000%";"17,19";"17,19";"-";"-";"-";"-";"-";"-";"-";"-";"-";"-";"-";"-";"-";"-";"-";"-";"-";"-"
"07 Sie 2024 23:00:44";"Koszty Utrzymania Pozycji";"O2-D4-95NXX0";"-";"-";"Solana (USD)";"-";"-";"-";"-";"-";"-";"-";"-";"-";"-";"-";"-";"14 621,77";"-10,00000%";"15,79";"15,79";"-";"-";"-";"-";"-";"-";"-";"-";"-";"-";"-";"-";"-";"-";"-";"-";"-";"-"
"07 Sie 2024 23:00:44";"Koszty Utrzymania Pozycji";"O2-D4-95VNWE";"-";"-";"Solana (USD)";"-";"-";"-";"-";"-";"-";"-";"-";"-";"-";"-";"-";"8 975,74";"-10,00000%";"9,69";"9,69";"-";"-";"-";"-";"-";"-";"-";"-";"-";"-";"-";"-";"-";"-";"-";"-";"-";"-"
"07 Sie 2024 23:00:44";"Koszty Utrzymania Pozycji";"O2-D3-94S9LM";"-";"-";"Solana (USD)";"-";"-";"-";"-";"-";"-";"-";"-";"-";"-";"-";"-";"10 133,90";"-27,50000%";"-30,39";"-30,39";"-";"-";"-";"-";"-";"-";"-";"-";"-";"-";"-";"-";"-";"-";"-";"-";"-";"-"
"07 Sie 2024 23:00:44";"Koszty Utrzymania Pozycji";"O2-D4-95TL4Z";"-";"-";"Solana (USD)";"-";"-";"-";"-";"-";"-";"-";"-";"-";"-";"-";"-";"4 484,97";"-27,50000%";"-13,45";"-13,45";"-";"-";"-";"-";"-";"-";"-";"-";"-";"-";"-";"-";"-";"-";"-";"-";"-";"-"
"07 Sie 2024 23:00:44";"Koszty Utrzymania Pozycji";"O2-D3-94JY88";"-";"-";"Solana (USD)";"-";"-";"-";"-";"-";"-";"-";"-";"-";"-";"-";"-";"7 238,50";"-27,50000%";"-21,71";"-21,71";"-";"-";"-";"-";"-";"-";"-";"-";"-";"-";"-";"-";"-";"-";"-";"-";"-";"-"
"07 Sie 2024 23:00:44";"Koszty Utrzymania Pozycji";"O2-D4-95VRP3";"-";"-";"Solana (USD)";"-";"-";"-";"-";"-";"-";"-";"-";"-";"-";"-";"-";"4 832,42";"-10,00000%";"5,22";"5,22";"-";"-";"-";"-";"-";"-";"-";"-";"-";"-";"-";"-";"-";"-";"-";"-";"-";"-"
"07 Sie 2024 23:00:44";"Koszty Utrzymania Pozycji";"O2-D4-95EL0T";"-";"-";"Solana (USD)";"-";"-";"-";"-";"-";"-";"-";"-";"-";"-";"-";"-";"10 351,05";"-27,50000%";"-31,04";"-31,04";"-";"-";"-";"-";"-";"-";"-";"-";"-";"-";"-";"-";"-";"-";"-";"-";"-";"-"
"07 Sie 2024 22:09:21";"Transakcja Sprzedaży";"O2-D4-95VRP3";"T2-D4-5JND3Q";"-";"Solana (USD)";"33,38 Jednost.";"143,500";"-";"-";"-";"-";"3,979222";"19 060,59";"0,00";"-";"-";"-";"-";"-";"-";"-";"-";"-";"-";"-";"-";"-";"-";"-";"-";"-";"-";"-";"-";"-";"-";"-";"-";"-"
"07 Sie 2024 22:08:49";"Odrzucono Zlecenie: brak wystarczających środków";"O2-D4-95VRNL";"-";"-";"Solana (USD)";"33,38 Jednost.";"-";"-";"-";"-";"-";"-";"-";"-";"-";"-";"-";"-";"-";"-";"-";"-";"-";"-";"-";"-";"-";"-";"-";"-";"-";"-";"-";"-";"-";"-";"-";"-";"-"
"07 Sie 2024 22:05:33";" Zamknięcie Transakcji";"O2-D4-95VRJV";"T2-D4-5JNCZV";"O2-D4-95V6M6";"Solana (USD)";"62 Jednost.";"143,725";"-";"-";"-";"-";"3,93938";"35 456,42";"665,56";"51 024,59";"-";"-";"-";"-";"-";"-";"-";"-";"-";"-";"-";"-";"-";"-";"-";"-";"-";"-";"-";"-";"-";"-";"-";"-"
"07 Sie 2024 21:31:53";"Zmodyfikowano Transakcję Sprzedaży";"O2-D4-95VNWE";"T2-D4-5JN9JN";"-";"Solana (USD)";"62 Jednost.";"142,675";"-";"-";"-";"-";"-";"-";"0,00";"-";"-";"-";"-";"-";"-";"-";"-";"-";"-";"-";"-";"-";"-";"-";"-";"-";"-";"-";"-";"-";"-";"-";"-";"-"
"07 Sie 2024 21:31:40";"Transakcja Sprzedaży";"O2-D4-95VNWE";"T2-D4-5JN9JN";"-";"Solana (USD)";"62 Jednost.";"142,675";"-";"145,528";"-";"-";"3,978641";"35 194,46";"0,00";"-";"-";"-";"-";"-";"-";"-";"-";"-";"-";"-";"-";"-";"-";"-";"-";"-";"-";"-";"-";"-";"-";"-";"-";"-"
"07 Sie 2024 20:01:35";" Zamknięcie Transakcji";"O2-D4-95VEG9";"T2-D4-5JN1VF";"O2-D4-95TZ9L";"Solana (USD)";"64 Jednost.";"145,580";"-";"-";"-";"-";"3,93967";"37 075,35";"302,57";"50 359,03";"-";"-";"-";"-";"-";"-";"-";"-";"-";"-";"-";"-";"-";"-";"-";"-";"-";"-";"-";"-";"-";"-";"-";"-"
"07 Sie 2024 18:54:04";"Zmodyfikowano Transakcję Sprzedaży";"O2-D4-95V6M6";"T2-D4-5JMVSN";"-";"Solana (USD)";"62 Jednost.";"146,450";"-";"-";"-";"-";"-";"-";"0,00";"-";"-";"-";"-";"-";"-";"-";"-";"-";"-";"-";"-";"-";"-";"-";"-";"-";"-";"-";"-";"-";"-";"-";"-";"-"
"07 Sie 2024 18:53:50";"Transakcja Sprzedaży";"O2-D4-95V6M6";"T2-D4-5JMVSN";"-";"Solana (USD)";"62 Jednost.";"146,450";"-";"149,368";"-";"-";"3,979072";"36 129,57";"0,00";"-";"-";"-";"-";"-";"-";"-";"-";"-";"-";"-";"-";"-";"-";"-";"-";"-";"-";"-";"-";"-";"-";"-";"-";"-"
"07 Sie 2024 17:56:29";" Zmodyfikowano Transakcję Kupna";"O2-D4-95V1H4";"T2-D4-5JMQ6V";"-";"Solana (USD)";"33,9 Jednost.";"148,375";"-";"-";"-";"-";"-";"-";"0,00";"-";"-";"-";"-";"-";"-";"-";"-";"-";"-";"-";"-";"-";"-";"-";"-";"-";"-";"-";"-";"-";"-";"-";"-";"-"
"07 Sie 2024 17:55:31";" Transakcja Kupna";"O2-D4-95V1H4";"T2-D4-5JMQ6V";"-";"Solana (USD)";"33,9 Jednost.";"148,375";"-";"145,374";"-";"-";"3,977008";"20 004,00";"0,00";"-";"-";"-";"-";"-";"-";"-";"-";"-";"-";"-";"-";"-";"-";"-";"-";"-";"-";"-";"-";"-";"-";"-";"-";"-"
"07 Sie 2024 17:53:27";" Zamknięcie Transakcji";"O2-D4-95V17T";"T2-D4-5JMPZX";"O2-D4-95TJLQ";"Solana (USD)";"30,48 Jednost.";"149,078";"-";"-";"-";"-";"3,93753";"18 071,52";"264,88";"50 056,46";"-";"-";"-";"-";"-";"-";"-";"-";"-";"-";"-";"-";"-";"-";"-";"-";"-";"-";"-";"-";"-";"-";"-";"-"
"07 Sie 2024 17:38:39";"Zmodyfikowano Transakcję Sprzedaży";"O2-D4-95TZ9L";"T2-D4-5JMN7C";"-";"Solana (USD)";"69 Jednost.";"146,780";"-";"-";"-";"-";"-";"-";"0,00";"-";"-";"-";"-";"-";"-";"-";"-";"-";"-";"-";"-";"-";"-";"-";"-";"-";"-";"-";"-";"-";"-";"-";"-";"-"
"07 Sie 2024 17:38:25";"Transakcja Sprzedaży";"O2-D4-95TZ9L";"T2-D4-5JMN7C";"-";"Solana (USD)";"69 Jednost.";"146,780";"-";"149,720";"-";"-";"3,97337";"40 241,57";"0,00";"-";"-";"-";"-";"-";"-";"-";"-";"-";"-";"-";"-";"-";"-";"-";"-";"-";"-";"-";"-";"-";"-";"-";"-";"-"
"07 Sie 2024 16:54:11";" Zamknięcie Transakcji";"O2-D4-95TTLT";"T2-D4-5JMJ5R";"O2-D4-95TJLQ";"Solana (USD)";"6 Jednost.";"147,955";"-";"-";"-";"-";"3,93356";"3 527,03";"78,59";"49 791,58";"-";"-";"-";"-";"-";"-";"-";"-";"-";"-";"-";"-";"-";"-";"-";"-";"-";"-";"-";"-";"-";"-";"-";"-"
"07 Sie 2024 16:48:25";" Zamknięcie Transakcji";"O2-D4-95TSWD";"T2-D4-5JMHKY";"O2-D4-95TJLQ";"Solana (USD)";"30 Jednost.";"148,695";"-";"-";"-";"-";"3,9317";"17 714,99";"305,49";"49 712,99";"-";"-";"-";"-";"-";"-";"-";"-";"-";"-";"-";"-";"-";"-";"-";"-";"-";"-";"-";"-";"-";"-";"-";"-"
"07 Sie 2024 16:02:22";" Zmodyfikowano Transakcję Kupna";"O2-D4-95TL4Z";"T2-D4-5JMBM6";"-";"Solana (USD)";"30,98 Jednost.";"152,490";"-";"-";"-";"-";"-";"-";"0,00";"-";"-";"-";"-";"-";"-";"-";"-";"-";"-";"-";"-";"-";"-";"-";"-";"-";"-";"-";"-";"-";"-";"-";"-";"-"
"07 Sie 2024 16:02:09";" Transakcja Kupna";"O2-D4-95TL4Z";"T2-D4-5JMBM6";"-";"Solana (USD)";"30,98 Jednost.";"152,490";"-";"149,441";"-";"-";"3,97324";"18 770,14";"0,00";"-";"-";"-";"-";"-";"-";"-";"-";"-";"-";"-";"-";"-";"-";"-";"-";"-";"-";"-";"-";"-";"-";"-";"-";"-"
"07 Sie 2024 15:58:18";"Zmodyfikowano Transakcję Sprzedaży";"O2-D4-95TJLQ";"T2-D4-5JM98B";"-";"Solana (USD)";"66,48 Jednost.";"151,285";"-";"-";"-";"-";"-";"-";"0,00";"-";"-";"-";"-";"-";"-";"-";"-";"-";"-";"-";"-";"-";"-";"-";"-";"-";"-";"-";"-";"-";"-";"-";"-";"-"
"07 Sie 2024 15:54:15";"Transakcja Sprzedaży";"O2-D4-95TJLQ";"T2-D4-5JM98B";"-";"Solana (USD)";"66,48 Jednost.";"151,285";"-";"154,310";"-";"-";"3,976908";"39 997,46";"0,00";"-";"-";"-";"-";"-";"-";"-";"-";"-";"-";"-";"-";"-";"-";"-";"-";"-";"-";"-";"-";"-";"-";"-";"-";"-"
"07 Sie 2024 15:54:10";"Odrzucono Zlecenie: brak wystarczających środków";"O2-D4-95TJL5";"-";"-";"Solana (USD)";"66,37 Jednost.";"-";"-";"-";"-";"-";"-";"-";"-";"-";"-";"-";"-";"-";"-";"-";"-";"-";"-";"-";"-";"-";"-";"-";"-";"-";"-";"-";"-";"-";"-";"-";"-";"-"
"07 Sie 2024 15:37:30";" Zmodyfikowano Transakcję Kupna";"O2-D4-95TFDC";"T2-D4-5JM6CM";"-";"Solana (USD)";"85 Jednost.";"154,665";"-";"-";"-";"-";"-";"-";"0,00";"-";"-";"-";"-";"-";"-";"-";"-";"-";"-";"-";"-";"-";"-";"-";"-";"-";"-";"-";"-";"-";"-";"-";"-";"-"
"07 Sie 2024 15:36:37";" Transakcja Kupna";"O2-D4-95TFDC";"T2-D4-5JM6CM";"-";"Solana (USD)";"85 Jednost.";"154,665";"-";"151,572";"-";"-";"3,972108";"52 219,41";"0,00";"-";"-";"-";"-";"-";"-";"-";"-";"-";"-";"-";"-";"-";"-";"-";"-";"-";"-";"-";"-";"-";"-";"-";"-";"-"
"07 Sie 2024 12:36:27";" Zamknięcie Transakcji";"O2-D4-95T1WS";"T2-D4-5JLVY6";"O2-D4-95SVS4";"Solana (USD)";"85 Jednost.";"154,415";"-";"-";"-";"-";"3,93193";"52 126,46";"76,87";"49 407,50";"-";"-";"-";"-";"-";"-";"-";"-";"-";"-";"-";"-";"-";"-";"-";"-";"-";"-";"-";"-";"-";"-";"-";"-"
"07 Sie 2024 11:24:04";" Zmodyfikowano Transakcję Kupna";"O2-D4-95SVS4";"T2-D4-5JLQ1C";"-";"Solana (USD)";"85 Jednost.";"154,185";"-";"-";"-";"-";"-";"-";"0,00";"-";"-";"-";"-";"-";"-";"-";"-";"-";"-";"-";"-";"-";"-";"-";"-";"-";"-";"-";"-";"-";"-";"-";"-";"-"
"07 Sie 2024 11:23:51";" Transakcja Kupna";"O2-D4-95SVS4";"T2-D4-5JLQ1C";"-";"Solana (USD)";"85 Jednost.";"154,185";"-";"151,087";"-";"-";"3,974202";"52 084,79";"0,00";"-";"-";"-";"-";"-";"-";"-";"-";"-";"-";"-";"-";"-";"-";"-";"-";"-";"-";"-";"-";"-";"-";"-";"-";"-"
"07 Sie 2024 11:22:06";" Zamknięcie Transakcji";"O2-D4-95SVN9";"T2-D4-5JLPY4";"O2-D4-95SVKM";"Solana (USD)";"85 Jednost.";"154,435";"-";"-";"-";"-";"3,93626";"52 190,55";"79,30";"49 330,63";"-";"-";"-";"-";"-";"-";"-";"-";"-";"-";"-";"-";"-";"-";"-";"-";"-";"-";"-";"-";"-";"-";"-";"-"
"07 Sie 2024 11:20:26";" Zmodyfikowano Transakcję Kupna";"O2-D4-95SVKM";"T2-D4-5JLPVS";"-";"Solana (USD)";"85 Jednost.";"154,198";"-";"-";"-";"-";"-";"-";"0,00";"-";"-";"-";"-";"-";"-";"-";"-";"-";"-";"-";"-";"-";"-";"-";"-";"-";"-";"-";"-";"-";"-";"-";"-";"-"
"07 Sie 2024 11:20:12";" Transakcja Kupna";"O2-D4-95SVKM";"T2-D4-5JLPVS";"-";"Solana (USD)";"85 Jednost.";"154,198";"-";"151,110";"-";"-";"3,975395";"52 104,82";"0,00";"-";"-";"-";"-";"-";"-";"-";"-";"-";"-";"-";"-";"-";"-";"-";"-";"-";"-";"-";"-";"-";"-";"-";"-";"-"
"06 Sie 2024 23:00:45";"Koszty Utrzymania Pozycji";"1361784161";"-";"-";"Rachunek";"-";"-";"-";"-";"-";"-";"-";"-";"-46,10";"49 251,33";"-";"-";"-";"-";"-";"-46,10";"-";"-";"-";"-";"-";"-";"-";"-";"-";"-";"-";"-";"-";"-";"-";"-";"-";"-"
"06 Sie 2024 23:00:45";"Koszty Utrzymania Pozycji";"O2-D4-95P4DE";"-";"-";"Solana (USD)";"-";"-";"-";"-";"-";"-";"-";"-";"-";"-";"-";"-";"4 421,25";"-10,00000%";"4,75";"4,75";"-";"-";"-";"-";"-";"-";"-";"-";"-";"-";"-";"-";"-";"-";"-";"-";"-";"-"
"06 Sie 2024 23:00:45";"Koszty Utrzymania Pozycji";"O2-D4-95K8MW";"-";"-";"Solana (USD)";"-";"-";"-";"-";"-";"-";"-";"-";"-";"-";"-";"-";"16 211,25";"-10,00000%";"17,43";"17,43";"-";"-";"-";"-";"-";"-";"-";"-";"-";"-";"-";"-";"-";"-";"-";"-";"-";"-"
"06 Sie 2024 23:00:45";"Koszty Utrzymania Pozycji";"O2-D4-95NXX0";"-";"-";"Solana (USD)";"-";"-";"-";"-";"-";"-";"-";"-";"-";"-";"-";"-";"14 884,87";"-10,00000%";"16,01";"16,01";"-";"-";"-";"-";"-";"-";"-";"-";"-";"-";"-";"-";"-";"-";"-";"-";"-";"-"
"06 Sie 2024 23:00:45";"Koszty Utrzymania Pozycji";"O2-D3-94S9LM";"-";"-";"Solana (USD)";"-";"-";"-";"-";"-";"-";"-";"-";"-";"-";"-";"-";"10 316,25";"-27,50000%";"-30,81";"-30,81";"-";"-";"-";"-";"-";"-";"-";"-";"-";"-";"-";"-";"-";"-";"-";"-";"-";"-"
"06 Sie 2024 23:00:45";"Koszty Utrzymania Pozycji";"O2-D3-94JY88";"-";"-";"Solana (USD)";"-";"-";"-";"-";"-";"-";"-";"-";"-";"-";"-";"-";"7 368,75";"-27,50000%";"-22,01";"-22,01";"-";"-";"-";"-";"-";"-";"-";"-";"-";"-";"-";"-";"-";"-";"-";"-";"-";"-"
"06 Sie 2024 23:00:45";"Koszty Utrzymania Pozycji";"O2-D4-95EL0T";"-";"-";"Solana (USD)";"-";"-";"-";"-";"-";"-";"-";"-";"-";"-";"-";"-";"10 537,31";"-27,50000%";"-31,47";"-31,47";"-";"-";"-";"-";"-";"-";"-";"-";"-";"-";"-";"-";"-";"-";"-";"-";"-";"-"
"06 Sie 2024 18:55:54";" Zamknięcie Transakcji";"O2-D4-95QR8P";"T2-D4-5JK994";"O2-D4-95QN1N";"Solana (USD)";"90 Jednost.";"147,365";"-";"-";"-";"-";"3,92356";"52 560,54";"310,75";"49 297,43";"-";"-";"-";"-";"-";"-";"-";"-";"-";"-";"-";"-";"-";"-";"-";"-";"-";"-";"-";"-";"-";"-";"-";"-"
"06 Sie 2024 18:27:26";"Odrzucono Zlecenie: brak wystarczających środków";"O2-D4-95QNT4";"-";"-";"Solana (USD)";"90 Jednost.";"-";"-";"-";"-";"-";"-";"-";"-";"-";"-";"-";"-";"-";"-";"-";"-";"-";"-";"-";"-";"-";"-";"-";"-";"-";"-";"-";"-";"-";"-";"-";"-";"-"
"06 Sie 2024 18:20:36";" Zmodyfikowano Transakcję Kupna";"O2-D4-95QN1N";"T2-D4-5JK70K";"-";"Solana (USD)";"90 Jednost.";"146,485";"-";"-";"-";"-";"-";"-";"0,00";"-";"-";"-";"-";"-";"-";"-";"-";"-";"-";"-";"-";"-";"-";"-";"-";"-";"-";"-";"-";"-";"-";"-";"-";"-"
"06 Sie 2024 18:20:01";" Transakcja Kupna";"O2-D4-95QN1N";"T2-D4-5JK70K";"-";"Solana (USD)";"90 Jednost.";"146,485";"-";"143,556";"-";"-";"3,963821";"52 257,62";"0,00";"-";"-";"-";"-";"-";"-";"-";"-";"-";"-";"-";"-";"-";"-";"-";"-";"-";"-";"-";"-";"-";"-";"-";"-";"-"
"06 Sie 2024 11:58:49";"Zmodyfikowano Transakcję Sprzedaży";"O2-D4-95P4DE";"T2-D4-5JJ3P4";"-";"Solana (USD)";"30 Jednost.";"138,895";"-";"-";"-";"-";"-";"-";"0,00";"-";"-";"-";"-";"-";"-";"-";"-";"-";"-";"-";"-";"-";"-";"-";"-";"-";"-";"-";"-";"-";"-";"-";"-";"-"
"06 Sie 2024 11:58:26";"Transakcja Sprzedaży";"O2-D4-95P4DE";"T2-D4-5JJ3P4";"-";"Solana (USD)";"30 Jednost.";"138,895";"-";"141,679";"-";"-";"3,976006";"16 567,42";"0,00";"-";"-";"-";"-";"-";"-";"-";"-";"-";"-";"-";"-";"-";"-";"-";"-";"-";"-";"-";"-";"-";"-";"-";"-";"-"
"06 Sie 2024 11:42:36";" Zamknięcie Transakcji";"O2-D4-95P2W8";"T2-D4-5JJ2PL";"O2-CZ-93XJ1D";"Solana (USD)";"32 Jednost.";"139,020";"-";"-";"-";"-";"3,93886";"17 698,65";"1 849,06";"48 986,68";"-";"-";"-";"-";"-";"-";"-";"-";"-";"-";"-";"-";"-";"-";"-";"-";"-";"-";"-";"-";"-";"-";"-";"-"
"06 Sie 2024 11:01:21";"Zmodyfikowano Transakcję Sprzedaży";"O2-D4-95NXX0";"T2-D4-5JHZ2S";"-";"Solana (USD)";"101 Jednost.";"137,125";"-";"-";"-";"-";"-";"-";"0,00";"-";"-";"-";"-";"-";"-";"-";"-";"-";"-";"-";"-";"-";"-";"-";"-";"-";"-";"-";"-";"-";"-";"-";"-";"-"
"06 Sie 2024 11:00:42";"Transakcja Sprzedaży";"O2-D4-95NXX0";"T2-D4-5JHZ2S";"-";"Solana (USD)";"101 Jednost.";"137,125";"-";"139,867";"-";"-";"3,969573";"54 977,09";"0,00";"-";"-";"-";"-";"-";"-";"-";"-";"-";"-";"-";"-";"-";"-";"-";"-";"-";"-";"-";"-";"-";"-";"-";"-";"-"
"06 Sie 2024 10:51:12";"Stop Loss";"O2-D4-95NQE4";"T2-D4-5JHYG5";"-";"Solana (USD)";"98,09 Jednost.";"138,032";"-";"-";"-";"-";"3,92234";"53 640,44";"1 186,16";"47 137,62";"-";"-";"-";"-";"-";"-";"-";"-";"-";"-";"-";"-";"-";"-";"-";"-";"-";"-";"-";"-";"-";"-";"-";"-"
"06 Sie 2024 10:48:07";"Zmodyfikowano Stop Loss";"O2-D4-95NQE4";"-";"O2-D4-95NSE7";"Solana (USD)";"98,09 Jednost.";"141,115";"-";"138,000";"-";"-";"-";"-";"-";"-";"-";"-";"-";"-";"-";"-";"-";"-";"-";"-";"-";"-";"-";"-";"-";"-";"-";"-";"-";"-";"-";"-";"-";"-"
"06 Sie 2024 10:36:58";"Zmodyfikowano Stop Loss";"O2-D4-95NQE4";"-";"O2-D4-95NSE7";"Solana (USD)";"98,09 Jednost.";"141,115";"-";"139,000";"-";"-";"-";"-";"-";"-";"-";"-";"-";"-";"-";"-";"-";"-";"-";"-";"-";"-";"-";"-";"-";"-";"-";"-";"-";"-";"-";"-";"-";"-"
"06 Sie 2024 10:34:07";"Zmodyfikowano Stop Loss";"O2-D4-95NQE4";"-";"O2-D4-95NSE7";"Solana (USD)";"98,09 Jednost.";"141,115";"-";"139,600";"-";"-";"-";"-";"-";"-";"-";"-";"-";"-";"-";"-";"-";"-";"-";"-";"-";"-";"-";"-";"-";"-";"-";"-";"-";"-";"-";"-";"-";"-"
"06 Sie 2024 10:28:11";"Zmodyfikowano Stop Loss";"O2-D4-95NQE4";"-";"O2-D4-95NSE7";"Solana (USD)";"98,09 Jednost.";"141,115";"-";"140,000";"-";"-";"-";"-";"-";"-";"-";"-";"-";"-";"-";"-";"-";"-";"-";"-";"-";"-";"-";"-";"-";"-";"-";"-";"-";"-";"-";"-";"-";"-"
"06 Sie 2024 10:18:39";"Zmodyfikowano Transakcję Sprzedaży";"O2-D4-95NQE4";"T2-D4-5JHTG2";"-";"Solana (USD)";"98,09 Jednost.";"141,115";"-";"141,000";"-";"-";"-";"-";"0,00";"-";"-";"-";"-";"-";"-";"-";"-";"-";"-";"-";"-";"-";"-";"-";"-";"-";"-";"-";"-";"-";"-";"-";"-";"-"
"06 Sie 2024 10:05:32";"Zmodyfikowano Transakcję Sprzedaży";"O2-D4-95NQE4";"T2-D4-5JHTG2";"-";"Solana (USD)";"98,09 Jednost.";"141,115";"-";"-";"-";"-";"-";"-";"0,00";"-";"-";"-";"-";"-";"-";"-";"-";"-";"-";"-";"-";"-";"-";"-";"-";"-";"-";"-";"-";"-";"-";"-";"-";"-"
"06 Sie 2024 10:04:26";"Transakcja Sprzedaży";"O2-D4-95NQE4";"T2-D4-5JHTG2";"-";"Solana (USD)";"98,09 Jednost.";"141,115";"-";"143,937";"-";"-";"3,958872";"54 798,58";"0,00";"-";"-";"-";"-";"-";"-";"-";"-";"-";"-";"-";"-";"-";"-";"-";"-";"-";"-";"-";"-";"-";"-";"-";"-";"-"
"06 Sie 2024 04:12:52";" Zamknięcie Transakcji";"O2-D4-95MV0Z";"T2-D4-5JH99F";"O2-CZ-93XJ1D";"Solana (USD)";"8 Jednost.";"138,830";"-";"-";"-";"-";"3,90572";"4 381,44";"464,31";"45 951,46";"-";"-";"-";"-";"-";"-";"-";"-";"-";"-";"-";"-";"-";"-";"-";"-";"-";"-";"-";"-";"-";"-";"-";"-"
"06 Sie 2024 04:11:45";" Zamknięcie Transakcji";"O2-D4-95MTYR";"T2-D4-5JH986";"O2-CZ-93XJ1D";"Solana (USD)";"10 Jednost.";"138,775";"-";"-";"-";"-";"3,90509";"5 473,76";"582,44";"45 487,15";"-";"-";"-";"-";"-";"-";"-";"-";"-";"-";"-";"-";"-";"-";"-";"-";"-";"-";"-";"-";"-";"-";"-";"-"
"06 Sie 2024 04:09:59";" Zamknięcie Transakcji";"O2-D4-95MTV9";"T2-D4-5JH96E";"O2-D4-95EFGV";"Solana (USD)";"31,5 Jednost.";"139,355";"-";"-";"-";"-";"3,9054";"17 315,77";"1 766,57";"44 904,71";"-";"-";"-";"-";"-";"-";"-";"-";"-";"-";"-";"-";"-";"-";"-";"-";"-";"-";"-";"-";"-";"-";"-";"-"
"06 Sie 2024 03:50:50";" Zamknięcie Transakcji";"O2-D4-95MSFB";"T2-D4-5JH8F5";"O2-D4-95EFGV";"Solana (USD)";"67 Jednost.";"139,070";"-";"-";"-";"-";"3,90443";"36 745,81";"3 831,09";"43 138,14";"-";"-";"-";"-";"-";"-";"-";"-";"-";"-";"-";"-";"-";"-";"-";"-";"-";"-";"-";"-";"-";"-";"-";"-"
"05 Sie 2024 23:00:53";"Koszty Utrzymania Pozycji";"1361254658";"-";"-";"Rachunek";"-";"-";"-";"-";"-";"-";"-";"-";"-38,62";"39 307,05";"-";"-";"-";"-";"-";"-38,62";"-";"-";"-";"-";"-";"-";"-";"-";"-";"-";"-";"-";"-";"-";"-";"-";"-";"-"
"05 Sie 2024 23:00:53";"Koszty Utrzymania Pozycji";"O2-D4-95EFGV";"-";"-";"Solana (USD)";"-";"-";"-";"-";"-";"-";"-";"-";"-";"-";"-";"-";"12 992,64";"-10,00000%";"13,91";"13,91";"-";"-";"-";"-";"-";"-";"-";"-";"-";"-";"-";"-";"-";"-";"-";"-";"-";"-"
"05 Sie 2024 23:00:53";"Koszty Utrzymania Pozycji";"O2-D4-95K8MW";"-";"-";"Solana (USD)";"-";"-";"-";"-";"-";"-";"-";"-";"-";"-";"-";"-";"14 509,55";"-10,00000%";"15,54";"15,54";"-";"-";"-";"-";"-";"-";"-";"-";"-";"-";"-";"-";"-";"-";"-";"-";"-";"-"
"05 Sie 2024 23:00:53";"Koszty Utrzymania Pozycji";"O2-CZ-93XJ1D";"-";"-";"Solana (USD)";"-";"-";"-";"-";"-";"-";"-";"-";"-";"-";"-";"-";"6 595,25";"-10,00000%";"7,06";"7,06";"-";"-";"-";"-";"-";"-";"-";"-";"-";"-";"-";"-";"-";"-";"-";"-";"-";"-"
"05 Sie 2024 23:00:53";"Koszty Utrzymania Pozycji";"O2-D3-94S9LM";"-";"-";"Solana (USD)";"-";"-";"-";"-";"-";"-";"-";"-";"-";"-";"-";"-";"9 233,35";"-27,50000%";"-27,46";"-27,46";"-";"-";"-";"-";"-";"-";"-";"-";"-";"-";"-";"-";"-";"-";"-";"-";"-";"-"
"05 Sie 2024 23:00:53";"Koszty Utrzymania Pozycji";"O2-D3-94JY88";"-";"-";"Solana (USD)";"-";"-";"-";"-";"-";"-";"-";"-";"-";"-";"-";"-";"6 595,25";"-27,50000%";"-19,62";"-19,62";"-";"-";"-";"-";"-";"-";"-";"-";"-";"-";"-";"-";"-";"-";"-";"-";"-";"-"
"05 Sie 2024 23:00:53";"Koszty Utrzymania Pozycji";"O2-D4-95EL0T";"-";"-";"Solana (USD)";"-";"-";"-";"-";"-";"-";"-";"-";"-";"-";"-";"-";"9 431,20";"-27,50000%";"-28,05";"-28,05";"-";"-";"-";"-";"-";"-";"-";"-";"-";"-";"-";"-";"-";"-";"-";"-";"-";"-"
"05 Sie 2024 22:41:34";" Zamknięcie Transakcji";"O2-D4-95M5YY";"T2-D4-5JGXNV";"O2-D4-95M437";"Solana (USD)";"120 Jednost.";"131,580";"-";"-";"-";"-";"3,90717";"62 312,81";"23,44";"39 345,67";"-";"-";"-";"-";"-";"-";"-";"-";"-";"-";"-";"-";"-";"-";"-";"-";"-";"-";"-";"-";"-";"-";"-";"-"
"05 Sie 2024 22:09:53";" Transakcja Kupna";"O2-D4-95M437";"T2-D4-5JGWWS";"-";"Solana (USD)";"120 Jednost.";"131,530";"-";"128,900";"-";"-";"3,94309";"62 236,15";"0,00";"-";"-";"-";"-";"-";"-";"-";"-";"-";"-";"-";"-";"-";"-";"-";"-";"-";"-";"-";"-";"-";"-";"-";"-";"-"
"05 Sie 2024 22:07:41";"Stop Loss";"O2-D4-95M3MN";"T2-D4-5JGWPC";"-";"Solana (USD)";"120 Jednost.";"130,500";"-";"-";"-";"-";"3,90422";"61 754,59";"217,86";"39 322,23";"-";"-";"-";"-";"-";"-";"-";"-";"-";"-";"-";"-";"-";"-";"-";"-";"-";"-";"-";"-";"-";"-";"-";"-"
"05 Sie 2024 22:07:01";"Zmodyfikowano Stop Loss";"O2-D4-95M3MN";"-";"O2-D4-95M3MP";"Solana (USD)";"120 Jednost.";"130,035";"-";"130,500";"-";"-";"-";"-";"-";"-";"-";"-";"-";"-";"-";"-";"-";"-";"-";"-";"-";"-";"-";"-";"-";"-";"-";"-";"-";"-";"-";"-";"-";"-"
"05 Sie 2024 22:06:44";"Zmodyfikowano Stop Loss";"O2-D4-95M3MN";"-";"O2-D4-95M3MP";"Solana (USD)";"120 Jednost.";"130,035";"-";"130,400";"-";"-";"-";"-";"-";"-";"-";"-";"-";"-";"-";"-";"-";"-";"-";"-";"-";"-";"-";"-";"-";"-";"-";"-";"-";"-";"-";"-";"-";"-"
"05 Sie 2024 22:05:35";" Transakcja Kupna";"O2-D4-95M3MN";"T2-D4-5JGWHN";"-";"Solana (USD)";"120 Jednost.";"130,035";"-";"127,430";"-";"-";"3,94331";"61 532,19";"0,00";"-";"-";"-";"-";"-";"-";"-";"-";"-";"-";"-";"-";"-";"-";"-";"-";"-";"-";"-";"-";"-";"-";"-";"-";"-"
"05 Sie 2024 19:24:42";"Stop Loss";"O2-D4-95LKTM";"T2-D4-5JGJEL";"-";"Solana (USD)";"120 Jednost.";"133,750";"-";"-";"-";"-";"3,90022";"63 227,73";"278,48";"39 104,37";"-";"-";"-";"-";"-";"-";"-";"-";"-";"-";"-";"-";"-";"-";"-";"-";"-";"-";"-";"-";"-";"-";"-";"-"
"05 Sie 2024 19:24:32";"Zmodyfikowano Stop Loss";"O2-D4-95LKTM";"-";"O2-D4-95LLE9";"Solana (USD)";"120 Jednost.";"133,155";"-";"133,800";"-";"-";"-";"-";"-";"-";"-";"-";"-";"-";"-";"-";"-";"-";"-";"-";"-";"-";"-";"-";"-";"-";"-";"-";"-";"-";"-";"-";"-";"-"
"05 Sie 2024 19:24:01";"Zmodyfikowano Stop Loss";"O2-D4-95LKTM";"-";"O2-D4-95LLE9";"Solana (USD)";"120 Jednost.";"133,155";"-";"133,100";"-";"-";"-";"-";"-";"-";"-";"-";"-";"-";"-";"-";"-";"-";"-";"-";"-";"-";"-";"-";"-";"-";"-";"-";"-";"-";"-";"-";"-";"-"
"05 Sie 2024 19:23:38";"Zmodyfikowano Stop Loss";"O2-D4-95LKTM";"-";"O2-D4-95LLE9";"Solana (USD)";"120 Jednost.";"133,155";"-";"133,010";"-";"-";"-";"-";"-";"-";"-";"-";"-";"-";"-";"-";"-";"-";"-";"-";"-";"-";"-";"-";"-";"-";"-";"-";"-";"-";"-";"-";"-";"-"
"05 Sie 2024 19:23:12";"Zmodyfikowano Stop Loss";"O2-D4-95LKTM";"-";"O2-D4-95LLE9";"Solana (USD)";"120 Jednost.";"133,155";"-";"133,800";"-";"-";"-";"-";"-";"-";"-";"-";"-";"-";"-";"-";"-";"-";"-";"-";"-";"-";"-";"-";"-";"-";"-";"-";"-";"-";"-";"-";"-";"-"
"05 Sie 2024 19:22:53";" Zmodyfikowano Transakcję Kupna";"O2-D4-95LKTM";"T2-D4-5JGHYE";"-";"Solana (USD)";"120 Jednost.";"133,155";"-";"133,700";"-";"-";"-";"-";"0,00";"-";"-";"-";"-";"-";"-";"-";"-";"-";"-";"-";"-";"-";"-";"-";"-";"-";"-";"-";"-";"-";"-";"-";"-";"-"
"05 Sie 2024 19:17:25";" Zmodyfikowano Transakcję Kupna";"O2-D4-95LKTM";"T2-D4-5JGHYE";"-";"Solana (USD)";"120 Jednost.";"133,155";"-";"-";"-";"-";"-";"-";"0,00";"-";"-";"-";"-";"-";"-";"-";"-";"-";"-";"-";"-";"-";"-";"-";"-";"-";"-";"-";"-";"-";"-";"-";"-";"-"
"05 Sie 2024 19:17:14";" Transakcja Kupna";"O2-D4-95LKTM";"T2-D4-5JGHYE";"-";"Solana (USD)";"120 Jednost.";"133,155";"-";"130,487";"-";"-";"3,93824";"62 927,56";"0,00";"-";"-";"-";"-";"-";"-";"-";"-";"-";"-";"-";"-";"-";"-";"-";"-";"-";"-";"-";"-";"-";"-";"-";"-";"-"
"05 Sie 2024 18:25:55";" Zamknięcie Transakcji";"O2-D4-95LD7H";"T2-D4-5JGCYC";"O2-D4-95L9RG";"Solana (USD)";"120 Jednost.";"135,007";"-";"-";"-";"-";"3,89736";"63 775,04";"863,81";"38 825,89";"-";"-";"-";"-";"-";"-";"-";"-";"-";"-";"-";"-";"-";"-";"-";"-";"-";"-";"-";"-";"-";"-";"-";"-"
"05 Sie 2024 18:07:35";" Transakcja Kupna";"O2-D4-95L9RG";"T2-D4-5JGB0T";"-";"Solana (USD)";"120 Jednost.";"133,160";"-";"130,548";"-";"-";"3,941026";"62 974,44";"0,00";"-";"-";"-";"-";"-";"-";"-";"-";"-";"-";"-";"-";"-";"-";"-";"-";"-";"-";"-";"-";"-";"-";"-";"-";"-"
"05 Sie 2024 17:10:36";"Stop Loss";"O2-D4-95KTE6";"T2-D4-5JG2PT";"-";"Solana (USD)";"119,57 Jednost.";"130,775";"-";"-";"-";"-";"3,89777";"61 561,13";"218,11";"37 962,08";"-";"-";"-";"-";"-";"-";"-";"-";"-";"-";"-";"-";"-";"-";"-";"-";"-";"-";"-";"-";"-";"-";"-";"-"
"05 Sie 2024 17:10:14";" Zmodyfikowano Transakcję Kupna";"O2-D4-95KTE6";"T2-D4-5JFY55";"-";"Solana (USD)";"119,57 Jednost.";"130,307";"-";"130,800";"-";"-";"-";"-";"0,00";"-";"-";"-";"-";"-";"-";"-";"-";"-";"-";"-";"-";"-";"-";"-";"-";"-";"-";"-";"-";"-";"-";"-";"-";"-"
"05 Sie 2024 17:08:57";" Zmodyfikowano Transakcję Kupna";"O2-D4-95KTE6";"T2-D4-5JFY55";"-";"Solana (USD)";"119,57 Jednost.";"130,307";"-";"-";"-";"-";"-";"-";"0,00";"-";"-";"-";"-";"-";"-";"-";"-";"-";"-";"-";"-";"-";"-";"-";"-";"-";"-";"-";"-";"-";"-";"-";"-";"-"
"05 Sie 2024 16:58:01";"Zmodyfikowano Take Profit";"O2-D4-95KTE6";"-";"O2-D4-95KV56";"Solana (USD)";"119,57 Jednost.";"130,307";"-";"-";"130,500";"-";"-";"-";"-";"-";"-";"-";"-";"-";"-";"-";"-";"-";"-";"-";"-";"-";"-";"-";"-";"-";"-";"-";"-";"-";"-";"-";"-";"-"
"05 Sie 2024 16:45:26";" Zmodyfikowano Transakcję Kupna";"O2-D4-95KTE6";"T2-D4-5JFY55";"-";"Solana (USD)";"119,57 Jednost.";"130,307";"-";"-";"131,210";"-";"-";"-";"0,00";"-";"-";"-";"-";"-";"-";"-";"-";"-";"-";"-";"-";"-";"-";"-";"-";"-";"-";"-";"-";"-";"-";"-";"-";"-"
"05 Sie 2024 16:41:40";" Zmodyfikowano Transakcję Kupna";"O2-D4-95KTE6";"T2-D4-5JFY55";"-";"Solana (USD)";"119,57 Jednost.";"130,307";"-";"-";"-";"-";"-";"-";"0,00";"-";"-";"-";"-";"-";"-";"-";"-";"-";"-";"-";"-";"-";"-";"-";"-";"-";"-";"-";"-";"-";"-";"-";"-";"-"
"05 Sie 2024 16:41:24";" Transakcja Kupna";"O2-D4-95KTE6";"T2-D4-5JFY55";"-";"Solana (USD)";"119,57 Jednost.";"130,307";"-";"127,582";"-";"-";"3,941737";"61 415,44";"0,00";"-";"-";"-";"-";"-";"-";"-";"-";"-";"-";"-";"-";"-";"-";"-";"-";"-";"-";"-";"-";"-";"-";"-";"-";"-"
"05 Sie 2024 16:32:34";"Stop Loss";"O2-D4-95KR76";"T2-D4-5JFWR0";"-";"Solana (USD)";"119,57 Jednost.";"128,190";"-";"-";"-";"-";"3,90759";"60 496,32";"175,21";"37 743,97";"-";"-";"-";"-";"-";"-";"-";"-";"-";"-";"-";"-";"-";"-";"-";"-";"-";"-";"-";"-";"-";"-";"-";"-"
"05 Sie 2024 16:32:33";"Zmodyfikowano Stop Loss";"O2-D4-95KR76";"-";"O2-D4-95KR77";"Solana (USD)";"119,57 Jednost.";"127,815";"-";"128,200";"-";"-";"-";"-";"-";"-";"-";"-";"-";"-";"-";"-";"-";"-";"-";"-";"-";"-";"-";"-";"-";"-";"-";"-";"-";"-";"-";"-";"-";"-"
"05 Sie 2024 16:31:14";" Transakcja Kupna";"O2-D4-95KR76";"T2-D4-5JFWH8";"-";"Solana (USD)";"119,57 Jednost.";"127,815";"-";"125,259";"-";"-";"3,946106";"60 307,70";"0,00";"-";"-";"-";"-";"-";"-";"-";"-";"-";"-";"-";"-";"-";"-";"-";"-";"-";"-";"-";"-";"-";"-";"-";"-";"-"
"05 Sie 2024 16:19:53";" Zamknięcie Transakcji";"O2-D4-95KNRM";"T2-D4-5JFTKY";"O2-D4-95KNEL";"Solana (USD)";"119,57 Jednost.";"129,425";"-";"-";"-";"-";"3,90131";"60 980,83";"966,55";"37 568,76";"-";"-";"-";"-";"-";"-";"-";"-";"-";"-";"-";"-";"-";"-";"-";"-";"-";"-";"-";"-";"-";"-";"-";"-"
"05 Sie 2024 16:18:18";" Transakcja Kupna";"O2-D4-95KNEL";"T2-D4-5JFTBC";"-";"Solana (USD)";"119,57 Jednost.";"127,353";"-";"124,766";"-";"-";"3,941347";"60 017,24";"0,00";"-";"-";"-";"-";"-";"-";"-";"-";"-";"-";"-";"-";"-";"-";"-";"-";"-";"-";"-";"-";"-";"-";"-";"-";"-"
"05 Sie 2024 16:05:19";" Zamknięcie Transakcji";"O2-D4-95KK7W";"T2-D4-5JFQSX";"O2-D4-95KJS5";"Solana (USD)";"121,36 Jednost.";"125,645";"-";"-";"-";"-";"3,91172";"60 246,33";"106,81";"36 602,21";"-";"-";"-";"-";"-";"-";"-";"-";"-";"-";"-";"-";"-";"-";"-";"-";"-";"-";"-";"-";"-";"-";"-";"-"
"05 Sie 2024 16:03:41";" Transakcja Kupna";"O2-D4-95KJS5";"T2-D4-5JFQEZ";"-";"Solana (USD)";"121,36 Jednost.";"125,420";"-";"122,912";"-";"-";"3,941838";"59 998,60";"0,00";"-";"-";"-";"-";"-";"-";"-";"-";"-";"-";"-";"-";"-";"-";"-";"-";"-";"-";"-";"-";"-";"-";"-";"-";"-"
"05 Sie 2024 15:34:59";"Zmodyfikowano Transakcję Sprzedaży";"O2-D4-95K8MW";"T2-D4-5JFGCK";"-";"Solana (USD)";"110 Jednost.";"117,280";"-";"-";"-";"-";"-";"-";"0,00";"-";"-";"-";"-";"-";"-";"-";"-";"-";"-";"-";"-";"-";"-";"-";"-";"-";"-";"-";"-";"-";"-";"-";"-";"-"
"05 Sie 2024 15:34:29";"Transakcja Sprzedaży";"O2-D4-95K8MW";"T2-D4-5JFGCK";"-";"Solana (USD)";"110 Jednost.";"117,280";"-";"119,620";"-";"-";"3,937208";"50 793,13";"0,00";"-";"-";"-";"-";"-";"-";"-";"-";"-";"-";"-";"-";"-";"-";"-";"-";"-";"-";"-";"-";"-";"-";"-";"-";"-"
"05 Sie 2024 15:23:11";" Zamknięcie Transakcji";"O2-D4-95K61X";"T2-D4-5JFDJZ";"O2-D4-95K5T0";"Solana (USD)";"110 Jednost.";"112,100";"-";"-";"-";"-";"3,90052";"48 580,72";"122,28";"36 495,40";"-";"-";"-";"-";"-";"-";"-";"-";"-";"-";"-";"-";"-";"-";"-";"-";"-";"-";"-";"-";"-";"-";"-";"-"
"05 Sie 2024 15:21:31";"Transakcja Sprzedaży";"O2-D4-95K5T0";"T2-D4-5JFDCS";"-";"Solana (USD)";"110 Jednost.";"112,385";"-";"114,632";"-";"-";"3,939062";"48 696,06";"0,00";"-";"-";"-";"-";"-";"-";"-";"-";"-";"-";"-";"-";"-";"-";"-";"-";"-";"-";"-";"-";"-";"-";"-";"-";"-"
"05 Sie 2024 15:14:33";" Zamknięcie Transakcji";"O2-D4-95K4P1";"T2-D4-5JFCGY";"O2-D4-95K3GD";"Solana (USD)";"110 Jednost.";"114,415";"-";"-";"-";"-";"3,941988";"49 612,48";"-4,34";"36 373,12";"-";"-";"-";"-";"-";"-";"-";"-";"-";"-";"-";"-";"-";"-";"-";"-";"-";"-";"-";"-";"-";"-";"-";"-"
"05 Sie 2024 15:08:14";"Transakcja Sprzedaży";"O2-D4-95K3GD";"T2-D4-5JFBKX";"-";"Solana (USD)";"110 Jednost.";"114,405";"-";"116,693";"-";"-";"3,94322";"49 623,64";"0,00";"-";"-";"-";"-";"-";"-";"-";"-";"-";"-";"-";"-";"-";"-";"-";"-";"-";"-";"-";"-";"-";"-";"-";"-";"-"
"05 Sie 2024 14:59:37";" Zamknięcie Transakcji";"O2-D4-95K1FG";"T2-D4-5JF8WW";"O2-D4-95JJ3G";"Solana (USD)";"110 Jednost.";"112,080";"-";"-";"-";"-";"3,90319";"48 605,29";"14,60";"36 377,46";"-";"-";"-";"-";"-";"-";"-";"-";"-";"-";"-";"-";"-";"-";"-";"-";"-";"-";"-";"-";"-";"-";"-";"-"
"05 Sie 2024 13:44:49";"Zmodyfikowano Transakcję Sprzedaży";"O2-D4-95JJ3G";"T2-D4-5JEW7F";"-";"Solana (USD)";"110 Jednost.";"112,114";"-";"-";"-";"-";"-";"-";"0,00";"-";"-";"-";"-";"-";"-";"-";"-";"-";"-";"-";"-";"-";"-";"-";"-";"-";"-";"-";"-";"-";"-";"-";"-";"-"
"05 Sie 2024 13:43:48";"Transakcja Sprzedaży";"O2-D4-95JJ3G";"T2-D4-5JEW7F";"-";"Solana (USD)";"110 Jednost.";"112,114";"-";"114,413";"-";"-";"3,953902";"48 761,65";"0,00";"-";"-";"-";"-";"-";"-";"-";"-";"-";"-";"-";"-";"-";"-";"-";"-";"-";"-";"-";"-";"-";"-";"-";"-";"-"
"05 Sie 2024 13:39:23";"Odrzucono Zlecenie: brak wystarczających środków";"O2-D4-95JHFF";"-";"-";"Solana (USD)";"115 Jednost.";"-";"-";"-";"-";"-";"-";"-";"-";"-";"-";"-";"-";"-";"-";"-";"-";"-";"-";"-";"-";"-";"-";"-";"-";"-";"-";"-";"-";"-";"-";"-";"-";"-"
"05 Sie 2024 13:27:28";" Zamknięcie Transakcji";"O2-D4-95JFWZ";"T2-D4-5JETEZ";"O2-D4-95JD4T";"Solana (USD)";"110 Jednost.";"112,335";"-";"-";"-";"-";"3,91346";"48 844,02";"603,53";"36 362,86";"-";"-";"-";"-";"-";"-";"-";"-";"-";"-";"-";"-";"-";"-";"-";"-";"-";"-";"-";"-";"-";"-";"-";"-"
"05 Sie 2024 13:08:14";"Zmodyfikowano Transakcję Sprzedaży";"O2-D4-95JD4T";"T2-D4-5JERH6";"-";"Solana (USD)";"110 Jednost.";"113,737";"-";"-";"110,600";"-";"-";"-";"0,00";"-";"-";"-";"-";"-";"-";"-";"-";"-";"-";"-";"-";"-";"-";"-";"-";"-";"-";"-";"-";"-";"-";"-";"-";"-"
"05 Sie 2024 13:03:51";"Transakcja Sprzedaży";"O2-D4-95JD4T";"T2-D4-5JERH6";"-";"Solana (USD)";"110 Jednost.";"113,737";"-";"116,016";"-";"-";"3,954703";"49 477,56";"0,00";"-";"-";"-";"-";"-";"-";"-";"-";"-";"-";"-";"-";"-";"-";"-";"-";"-";"-";"-";"-";"-";"-";"-";"-";"-"
"05 Sie 2024 13:00:28";"Take Profit";"O2-D4-95J9GB";"T2-D4-5JER71";"-";"Solana (USD)";"108 Jednost.";"115,600";"-";"-";"-";"-";"3,91436";"49 361,04";"119,22";"35 759,33";"-";"-";"-";"-";"-";"-";"-";"-";"-";"-";"-";"-";"-";"-";"-";"-";"-";"-";"-";"-";"-";"-";"-";"-"
"05 Sie 2024 12:59:14";"Zmodyfikowano Take Profit";"O2-D4-95J9GB";"-";"O2-D4-95JCCE";"Solana (USD)";"108 Jednost.";"115,882";"-";"-";"115,600";"-";"-";"-";"-";"-";"-";"-";"-";"-";"-";"-";"-";"-";"-";"-";"-";"-";"-";"-";"-";"-";"-";"-";"-";"-";"-";"-";"-";"-"
"05 Sie 2024 12:58:11";"Zmodyfikowano Transakcję Sprzedaży";"O2-D4-95J9GB";"T2-D4-5JEPDR";"-";"Solana (USD)";"108 Jednost.";"115,882";"-";"-";"115,000";"-";"-";"-";"0,00";"-";"-";"-";"-";"-";"-";"-";"-";"-";"-";"-";"-";"-";"-";"-";"-";"-";"-";"-";"-";"-";"-";"-";"-";"-"
"05 Sie 2024 12:43:29";"Zmodyfikowano Transakcję Sprzedaży";"O2-D4-95J9GB";"T2-D4-5JEPDR";"-";"Solana (USD)";"108 Jednost.";"115,882";"-";"-";"-";"-";"-";"-";"0,00";"-";"-";"-";"-";"-";"-";"-";"-";"-";"-";"-";"-";"-";"-";"-";"-";"-";"-";"-";"-";"-";"-";"-";"-";"-"
"05 Sie 2024 12:42:16";"Transakcja Sprzedaży";"O2-D4-95J9GB";"T2-D4-5JEPDR";"-";"Solana (USD)";"108 Jednost.";"115,882";"-";"118,221";"-";"-";"3,950805";"49 445,33";"0,00";"-";"-";"-";"-";"-";"-";"-";"-";"-";"-";"-";"-";"-";"-";"-";"-";"-";"-";"-";"-";"-";"-";"-";"-";"-"
"05 Sie 2024 12:40:24";"Stop Loss";"O2-D4-95J82H";"T2-D4-5JEP4C";"-";"Solana (USD)";"107 Jednost.";"115,805";"-";"-";"-";"-";"3,91458";"48 993,45";"341,37";"35 640,11";"-";"-";"-";"-";"-";"-";"-";"-";"-";"-";"-";"-";"-";"-";"-";"-";"-";"-";"-";"-";"-";"-";"-";"-"
"05 Sie 2024 12:39:25";"Zmodyfikowano Stop Loss";"O2-D4-95J82H";"-";"O2-D4-95J82J";"Solana (USD)";"107 Jednost.";"116,620";"-";"115,800";"-";"-";"-";"-";"-";"-";"-";"-";"-";"-";"-";"-";"-";"-";"-";"-";"-";"-";"-";"-";"-";"-";"-";"-";"-";"-";"-";"-";"-";"-"
"05 Sie 2024 12:29:53";"Transakcja Sprzedaży";"O2-D4-95J82H";"T2-D4-5JENEE";"-";"Solana (USD)";"107 Jednost.";"116,620";"-";"118,948";"-";"-";"3,951397";"49 306,87";"0,00";"-";"-";"-";"-";"-";"-";"-";"-";"-";"-";"-";"-";"-";"-";"-";"-";"-";"-";"-";"-";"-";"-";"-";"-";"-"
"05 Sie 2024 12:25:46";"Stop Loss";"O2-D4-95J6HL";"T2-D4-5JEMZD";"-";"Solana (USD)";"105 Jednost.";"117,015";"-";"-";"-";"-";"3,91277";"48 557,62";"193,10";"35 298,74";"-";"-";"-";"-";"-";"-";"-";"-";"-";"-";"-";"-";"-";"-";"-";"-";"-";"-";"-";"-";"-";"-";"-";"-"
"05 Sie 2024 12:25:43";"Zmodyfikowano Transakcję Sprzedaży";"O2-D4-95J6HL";"T2-D4-5JEM7K";"-";"Solana (USD)";"105 Jednost.";"117,485";"-";"117,000";"-";"-";"-";"-";"0,00";"-";"-";"-";"-";"-";"-";"-";"-";"-";"-";"-";"-";"-";"-";"-";"-";"-";"-";"-";"-";"-";"-";"-";"-";"-"
"05 Sie 2024 12:16:14";"Zmodyfikowano Transakcję Sprzedaży";"O2-D4-95J6HL";"T2-D4-5JEM7K";"-";"Solana (USD)";"105 Jednost.";"117,485";"-";"-";"-";"-";"-";"-";"0,00";"-";"-";"-";"-";"-";"-";"-";"-";"-";"-";"-";"-";"-";"-";"-";"-";"-";"-";"-";"-";"-";"-";"-";"-";"-"
"05 Sie 2024 12:15:40";"Transakcja Sprzedaży";"O2-D4-95J6HL";"T2-D4-5JEM7K";"-";"Solana (USD)";"105 Jednost.";"117,485";"-";"119,834";"-";"-";"3,954302";"48 779,97";"0,00";"-";"-";"-";"-";"-";"-";"-";"-";"-";"-";"-";"-";"-";"-";"-";"-";"-";"-";"-";"-";"-";"-";"-";"-";"-"
"05 Sie 2024 12:10:03";"Stop Loss";"O2-D4-95J4ZF";"T2-D4-5JELWF";"-";"Solana (USD)";"104 Jednost.";"118,780";"-";"-";"-";"-";"3,91789";"48 884,48";"275,04";"35 105,64";"-";"-";"-";"-";"-";"-";"-";"-";"-";"-";"-";"-";"-";"-";"-";"-";"-";"-";"-";"-";"-";"-";"-";"-"
"05 Sie 2024 12:09:57";"Zmodyfikowano Stop Loss";"O2-D4-95J4ZF";"-";"O2-D4-95J5XP";"Solana (USD)";"104 Jednost.";"119,455";"-";"118,750";"-";"-";"-";"-";"-";"-";"-";"-";"-";"-";"-";"-";"-";"-";"-";"-";"-";"-";"-";"-";"-";"-";"-";"-";"-";"-";"-";"-";"-";"-"
"05 Sie 2024 12:09:40";"Zmodyfikowano Transakcję Sprzedaży";"O2-D4-95J4ZF";"T2-D4-5JEL6R";"-";"Solana (USD)";"104 Jednost.";"119,455";"-";"118,950";"-";"-";"-";"-";"0,00";"-";"-";"-";"-";"-";"-";"-";"-";"-";"-";"-";"-";"-";"-";"-";"-";"-";"-";"-";"-";"-";"-";"-";"-";"-"
"05 Sie 2024 12:01:55";"Zmodyfikowano Transakcję Sprzedaży";"O2-D4-95J4ZF";"T2-D4-5JEL6R";"-";"Solana (USD)";"104 Jednost.";"119,455";"-";"-";"118,200";"-";"-";"-";"0,00";"-";"-";"-";"-";"-";"-";"-";"-";"-";"-";"-";"-";"-";"-";"-";"-";"-";"-";"-";"-";"-";"-";"-";"-";"-"
"05 Sie 2024 12:00:56";"Transakcja Sprzedaży";"O2-D4-95J4ZF";"T2-D4-5JEL6R";"-";"Solana (USD)";"104 Jednost.";"119,455";"-";"121,844";"-";"-";"3,95287";"49 107,76";"0,00";"-";"-";"-";"-";"-";"-";"-";"-";"-";"-";"-";"-";"-";"-";"-";"-";"-";"-";"-";"-";"-";"-";"-";"-";"-"
"05 Sie 2024 11:50:26";"Stop Loss";"O2-D4-95J3JR";"T2-D4-5JEKB1";"-";"Solana (USD)";"104 Jednost.";"118,733";"-";"-";"-";"-";"3,9085";"48 747,96";"263,00";"34 830,60";"-";"-";"-";"-";"-";"-";"-";"-";"-";"-";"-";"-";"-";"-";"-";"-";"-";"-";"-";"-";"-";"-";"-";"-"
"05 Sie 2024 11:50:26";"Zmodyfikowano Stop Loss";"O2-D4-95J3JR";"-";"O2-D4-95J3JS";"Solana (USD)";"104 Jednost.";"119,380";"-";"118,700";"-";"-";"-";"-";"-";"-";"-";"-";"-";"-";"-";"-";"-";"-";"-";"-";"-";"-";"-";"-";"-";"-";"-";"-";"-";"-";"-";"-";"-";"-"
"05 Sie 2024 11:48:38";"Zmodyfikowano Stop Loss";"O2-D4-95J3JR";"-";"O2-D4-95J3JS";"Solana (USD)";"104 Jednost.";"119,380";"-";"119,000";"-";"-";"-";"-";"-";"-";"-";"-";"-";"-";"-";"-";"-";"-";"-";"-";"-";"-";"-";"-";"-";"-";"-";"-";"-";"-";"-";"-";"-";"-"
"05 Sie 2024 11:47:30";"Transakcja Sprzedaży";"O2-D4-95J3JR";"T2-D4-5JEK4G";"-";"Solana (USD)";"104 Jednost.";"119,380";"-";"121,767";"-";"-";"3,947579";"49 011,24";"0,00";"-";"-";"-";"-";"-";"-";"-";"-";"-";"-";"-";"-";"-";"-";"-";"-";"-";"-";"-";"-";"-";"-";"-";"-";"-"
"05 Sie 2024 11:45:24";"Stop Loss";"O2-D4-95J2NZ";"T2-D4-5JEJZH";"-";"Solana (USD)";"104 Jednost.";"120,355";"-";"-";"-";"-";"3,90859";"49 415,04";"182,92";"34 567,60";"-";"-";"-";"-";"-";"-";"-";"-";"-";"-";"-";"-";"-";"-";"-";"-";"-";"-";"-";"-";"-";"-";"-";"-"
"05 Sie 2024 11:45:19";"Zmodyfikowano Stop Loss";"O2-D4-95J2NZ";"-";"O2-D4-95J2P0";"Solana (USD)";"104 Jednost.";"120,805";"-";"120,300";"-";"-";"-";"-";"-";"-";"-";"-";"-";"-";"-";"-";"-";"-";"-";"-";"-";"-";"-";"-";"-";"-";"-";"-";"-";"-";"-";"-";"-";"-"
"05 Sie 2024 11:40:49";"Transakcja Sprzedaży";"O2-D4-95J2NZ";"T2-D4-5JEJH4";"-";"Solana (USD)";"104 Jednost.";"120,805";"-";"123,205";"-";"-";"3,95323";"49 667,27";"0,00";"-";"-";"-";"-";"-";"-";"-";"-";"-";"-";"-";"-";"-";"-";"-";"-";"-";"-";"-";"-";"-";"-";"-";"-";"-"
"05 Sie 2024 11:34:43";" Zamknięcie Transakcji";"O2-D4-95J1TX";"T2-D4-5JEHTM";"O2-D4-95J0LL";"Solana (USD)";"104 Jednost.";"121,285";"-";"-";"-";"-";"3,91238";"49 845,28";"34,59";"34 384,68";"-";"-";"-";"-";"-";"-";"-";"-";"-";"-";"-";"-";"-";"-";"-";"-";"-";"-";"-";"-";"-";"-";"-";"-"
"05 Sie 2024 11:27:46";"Zmodyfikowano Transakcję Sprzedaży";"O2-D4-95J0LL";"T2-D4-5JEH06";"-";"Solana (USD)";"104 Jednost.";"121,370";"-";"-";"120,800";"-";"-";"-";"0,00";"-";"-";"-";"-";"-";"-";"-";"-";"-";"-";"-";"-";"-";"-";"-";"-";"-";"-";"-";"-";"-";"-";"-";"-";"-"
"05 Sie 2024 11:23:30";"Zmodyfikowano Transakcję Sprzedaży";"O2-D4-95J0LL";"T2-D4-5JEH06";"-";"Solana (USD)";"104 Jednost.";"121,370";"-";"-";"-";"-";"-";"-";"0,00";"-";"-";"-";"-";"-";"-";"-";"-";"-";"-";"-";"-";"-";"-";"-";"-";"-";"-";"-";"-";"-";"-";"-";"-";"-"
"05 Sie 2024 11:23:07";"Transakcja Sprzedaży";"O2-D4-95J0LL";"T2-D4-5JEH06";"-";"Solana (USD)";"104 Jednost.";"121,370";"-";"123,797";"-";"-";"3,949813";"49 856,43";"0,00";"-";"-";"-";"-";"-";"-";"-";"-";"-";"-";"-";"-";"-";"-";"-";"-";"-";"-";"-";"-";"-";"-";"-";"-";"-"
"05 Sie 2024 11:00:23";" Zamknięcie Transakcji";"O2-D4-95HXW2";"T2-D4-5JEF14";"O2-D4-95F5HL";"Solana (USD)";"78,91 Jednost.";"121,410";"-";"-";"-";"-";"3,91306";"37 865,71";"9 427,04";"34 350,09";"-";"-";"-";"-";"-";"-";"-";"-";"-";"-";"-";"-";"-";"-";"-";"-";"-";"-";"-";"-";"-";"-";"-";"-"
"05 Sie 2024 07:02:08";"Zmodyfikowano Stop Loss";"O2-D4-95F5HL";"-";"O2-D4-95FJM7";"Solana (USD)";"78,91 Jednost.";"151,940";"-";"126,000";"-";"-";"-";"-";"-";"-";"-";"-";"-";"-";"-";"-";"-";"-";"-";"-";"-";"-";"-";"-";"-";"-";"-";"-";"-";"-";"-";"-";"-";"-"
"05 Sie 2024 00:03:16";"Zmodyfikowano Transakcję Sprzedaży";"O2-D4-95F5HL";"T2-D4-5JCFDB";"-";"Solana (USD)";"78,91 Jednost.";"151,940";"-";"147,000";"-";"-";"-";"-";"0,00";"-";"-";"-";"-";"-";"-";"-";"-";"-";"-";"-";"-";"-";"-";"-";"-";"-";"-";"-";"-";"-";"-";"-";"-";"-"
"02 Sie 2024 23:00:46";"Koszty Utrzymania Pozycji";"1360496957";"-";"-";"Rachunek";"-";"-";"-";"-";"-";"-";"-";"-";"-148,04";"24 923,05";"-";"-";"-";"-";"-";"-148,04";"-";"-";"-";"-";"-";"-";"-";"-";"-";"-";"-";"-";"-";"-";"-";"-";"-";"-"
"02 Sie 2024 23:00:46";"Koszty Utrzymania Pozycji";"O2-D4-95F5HL";"-";"-";"Solana (USD)";"-";"-";"-";"-";"-";"-";"-";"-";"-";"-";"-";"-";"11 926,06";"-10,00000%";"38,37";"38,37";"-";"-";"-";"-";"-";"-";"-";"-";"-";"-";"-";"-";"-";"-";"-";"-";"-";"-"
"02 Sie 2024 23:00:46";"Koszty Utrzymania Pozycji";"O2-D4-95EFGV";"-";"-";"Solana (USD)";"-";"-";"-";"-";"-";"-";"-";"-";"-";"-";"-";"-";"14 886,79";"-10,00000%";"47,89";"47,89";"-";"-";"-";"-";"-";"-";"-";"-";"-";"-";"-";"-";"-";"-";"-";"-";"-";"-"
"02 Sie 2024 23:00:46";"Koszty Utrzymania Pozycji";"O2-CZ-93XJ1D";"-";"-";"Solana (USD)";"-";"-";"-";"-";"-";"-";"-";"-";"-";"-";"-";"-";"7 556,75";"-10,00000%";"24,31";"24,31";"-";"-";"-";"-";"-";"-";"-";"-";"-";"-";"-";"-";"-";"-";"-";"-";"-";"-"
"02 Sie 2024 23:00:46";"Koszty Utrzymania Pozycji";"O2-D3-94S9LM";"-";"-";"Solana (USD)";"-";"-";"-";"-";"-";"-";"-";"-";"-";"-";"-";"-";"10 579,45";"-27,50000%";"-94,53";"-94,53";"-";"-";"-";"-";"-";"-";"-";"-";"-";"-";"-";"-";"-";"-";"-";"-";"-";"-"
"02 Sie 2024 23:00:46";"Koszty Utrzymania Pozycji";"O2-D3-94JY88";"-";"-";"Solana (USD)";"-";"-";"-";"-";"-";"-";"-";"-";"-";"-";"-";"-";"7 556,75";"-27,50000%";"-67,52";"-67,52";"-";"-";"-";"-";"-";"-";"-";"-";"-";"-";"-";"-";"-";"-";"-";"-";"-";"-"
"02 Sie 2024 23:00:46";"Koszty Utrzymania Pozycji";"O2-D4-95EL0T";"-";"-";"Solana (USD)";"-";"-";"-";"-";"-";"-";"-";"-";"-";"-";"-";"-";"10 806,15";"-27,50000%";"-96,56";"-96,56";"-";"-";"-";"-";"-";"-";"-";"-";"-";"-";"-";"-";"-";"-";"-";"-";"-";"-"
"02 Sie 2024 21:07:03";"Transakcja Sprzedaży";"O2-D4-95F5HL";"T2-D4-5JCFDB";"-";"Solana (USD)";"78,91 Jednost.";"151,940";"-";"-";"-";"-";"3,95333";"47 398,78";"0,00";"-";"-";"-";"-";"-";"-";"-";"-";"-";"-";"-";"-";"-";"-";"-";"-";"-";"-";"-";"-";"-";"-";"-";"-";"-"
"02 Sie 2024 20:03:41";" Zamknięcie Transakcji";"O2-D4-95F0S2";"T2-D4-5JCCCW";"O2-CZ-93XJ1D";"Solana (USD)";"6 Jednost.";"153,705";"-";"-";"-";"-";"3,953641";"3 646,16";"-0,36";"25 071,09";"-";"-";"-";"-";"-";"-";"-";"-";"-";"-";"-";"-";"-";"-";"-";"-";"-";"-";"-";"-";"-";"-";"-";"-"
"02 Sie 2024 19:57:07";"Stop Loss";"O2-D4-95EXB1";"T2-D4-5JCC0H";"-";"Solana (USD)";"71,5 Jednost.";"154,205";"-";"-";"-";"-";"3,9131";"43 578,12";"188,02";"25 071,45";"-";"-";"-";"-";"-";"-";"-";"-";"-";"-";"-";"-";"-";"-";"-";"-";"-";"-";"-";"-";"-";"-";"-";"-"
"02 Sie 2024 19:57:01";"Zmodyfikowano Stop Loss";"O2-D4-95EXB1";"-";"O2-D4-95F028";"Solana (USD)";"71,5 Jednost.";"154,877";"-";"154,200";"-";"-";"-";"-";"-";"-";"-";"-";"-";"-";"-";"-";"-";"-";"-";"-";"-";"-";"-";"-";"-";"-";"-";"-";"-";"-";"-";"-";"-";"-"
"02 Sie 2024 19:56:19";"Zmodyfikowano Transakcję Sprzedaży";"O2-D4-95EXB1";"T2-D4-5JC96B";"-";"Solana (USD)";"71,5 Jednost.";"154,877";"-";"154,300";"-";"-";"-";"-";"0,00";"-";"-";"-";"-";"-";"-";"-";"-";"-";"-";"-";"-";"-";"-";"-";"-";"-";"-";"-";"-";"-";"-";"-";"-";"-"
"02 Sie 2024 19:24:21";"Zmodyfikowano Transakcję Sprzedaży";"O2-D4-95EXB1";"T2-D4-5JC96B";"-";"Solana (USD)";"71,5 Jednost.";"154,877";"-";"-";"-";"-";"-";"-";"0,00";"-";"-";"-";"-";"-";"-";"-";"-";"-";"-";"-";"-";"-";"-";"-";"-";"-";"-";"-";"-";"-";"-";"-";"-";"-"
"02 Sie 2024 19:24:01";"Transakcja Sprzedaży";"O2-D4-95EXB1";"T2-D4-5JC96B";"-";"Solana (USD)";"71,5 Jednost.";"154,877";"-";"157,974";"-";"-";"3,952489";"43 768,69";"0,00";"-";"-";"-";"-";"-";"-";"-";"-";"-";"-";"-";"-";"-";"-";"-";"-";"-";"-";"-";"-";"-";"-";"-";"-";"-"
"02 Sie 2024 18:14:54";" Zmodyfikowano Transakcję Kupna";"O2-D4-95EL0T";"T2-D4-5JC26X";"-";"Solana (USD)";"71,5 Jednost.";"157,105";"-";"-";"-";"-";"-";"-";"0,00";"-";"-";"-";"-";"-";"-";"-";"-";"-";"-";"-";"-";"-";"-";"-";"-";"-";"-";"-";"-";"-";"-";"-";"-";"-"
"02 Sie 2024 18:08:12";" Zmodyfikowano Transakcję Kupna";"O2-D4-95EL0T";"T2-D4-5JC26X";"-";"Solana (USD)";"71,5 Jednost.";"157,105";"-";"-";"157,300";"-";"-";"-";"0,00";"-";"-";"-";"-";"-";"-";"-";"-";"-";"-";"-";"-";"-";"-";"-";"-";"-";"-";"-";"-";"-";"-";"-";"-";"-"
"02 Sie 2024 17:56:58";" Transakcja Kupna";"O2-D4-95EL0T";"T2-D4-5JC26X";"-";"Solana (USD)";"71,5 Jednost.";"157,105";"-";"153,958";"-";"-";"3,949122";"44 360,51";"0,00";"-";"-";"-";"-";"-";"-";"-";"-";"-";"-";"-";"-";"-";"-";"-";"-";"-";"-";"-";"-";"-";"-";"-";"-";"-"
"02 Sie 2024 17:52:32";"Stop Loss";"O2-D4-95EK07";"T2-D4-5JC1V2";"-";"Solana (USD)";"71,5 Jednost.";"156,385";"-";"-";"-";"-";"3,90996";"44 158,78";"88,06";"24 883,43";"-";"-";"-";"-";"-";"-";"-";"-";"-";"-";"-";"-";"-";"-";"-";"-";"-";"-";"-";"-";"-";"-";"-";"-"
"02 Sie 2024 17:52:29";"Zmodyfikowano Stop Loss";"O2-D4-95EK07";"-";"O2-D4-95EK08";"Solana (USD)";"71,5 Jednost.";"156,070";"-";"156,400";"-";"-";"-";"-";"-";"-";"-";"-";"-";"-";"-";"-";"-";"-";"-";"-";"-";"-";"-";"-";"-";"-";"-";"-";"-";"-";"-";"-";"-";"-"
"02 Sie 2024 17:48:59";" Transakcja Kupna";"O2-D4-95EK07";"T2-D4-5JC1FZ";"-";"Solana (USD)";"71,5 Jednost.";"156,070";"-";"152,949";"-";"-";"3,94797";"44 055,41";"0,00";"-";"-";"-";"-";"-";"-";"-";"-";"-";"-";"-";"-";"-";"-";"-";"-";"-";"-";"-";"-";"-";"-";"-";"-";"-"
"02 Sie 2024 17:46:33";"Stop Loss";"O2-D4-95EHWN";"T2-D4-5JC15P";"-";"Solana (USD)";"71,42 Jednost.";"156,155";"-";"-";"-";"-";"3,90756";"44 017,35";"5,58";"24 795,37";"-";"-";"-";"-";"-";"-";"-";"-";"-";"-";"-";"-";"-";"-";"-";"-";"-";"-";"-";"-";"-";"-";"-";"-"
"02 Sie 2024 17:44:23";"Zmodyfikowano Stop Loss";"O2-D4-95EHWN";"-";"O2-D4-95EHWP";"Solana (USD)";"71,42 Jednost.";"156,135";"-";"156,200";"-";"-";"-";"-";"-";"-";"-";"-";"-";"-";"-";"-";"-";"-";"-";"-";"-";"-";"-";"-";"-";"-";"-";"-";"-";"-";"-";"-";"-";"-"
"02 Sie 2024 17:42:52";" Transakcja Kupna";"O2-D4-95EHWN";"T2-D4-5JC0KE";"-";"Solana (USD)";"71,42 Jednost.";"156,135";"-";"153,013";"-";"-";"3,946006";"44 002,55";"0,00";"-";"-";"-";"-";"-";"-";"-";"-";"-";"-";"-";"-";"-";"-";"-";"-";"-";"-";"-";"-";"-";"-";"-";"-";"-"
"02 Sie 2024 17:41:10";"Odrzucono Zlecenie: brak wystarczających środków";"O2-D4-95EHJY";"-";"-";"Solana (USD)";"98,5 Jednost.";"-";"-";"-";"-";"-";"-";"-";"-";"-";"-";"-";"-";"-";"-";"-";"-";"-";"-";"-";"-";"-";"-";"-";"-";"-";"-";"-";"-";"-";"-";"-";"-";"-"
"02 Sie 2024 17:29:26";"Zmodyfikowano Transakcję Sprzedaży";"O2-D4-95EFGV";"T2-D4-5JBYVX";"-";"Solana (USD)";"98,5 Jednost.";"153,715";"-";"-";"-";"-";"-";"-";"0,00";"-";"-";"-";"-";"-";"-";"-";"-";"-";"-";"-";"-";"-";"-";"-";"-";"-";"-";"-";"-";"-";"-";"-";"-";"-"
"02 Sie 2024 17:29:08";"Transakcja Sprzedaży";"O2-D4-95EFGV";"T2-D4-5JBYVX";"-";"Solana (USD)";"98,5 Jednost.";"153,715";"-";"156,791";"-";"-";"3,950866";"59 819,77";"0,00";"-";"-";"-";"-";"-";"-";"-";"-";"-";"-";"-";"-";"-";"-";"-";"-";"-";"-";"-";"-";"-";"-";"-";"-";"-"
"02 Sie 2024 17:27:44";"Stop Loss";"O2-D4-95EETE";"T2-D4-5JBYPQ";"-";"Solana (USD)";"98,5 Jednost.";"153,355";"-";"-";"-";"-";"3,91226";"59 690,56";"408,48";"24 789,79";"-";"-";"-";"-";"-";"-";"-";"-";"-";"-";"-";"-";"-";"-";"-";"-";"-";"-";"-";"-";"-";"-";"-";"-"
"02 Sie 2024 17:27:35";"Zmodyfikowano Stop Loss";"O2-D4-95EETE";"-";"O2-D4-95EF4P";"Solana (USD)";"98,5 Jednost.";"154,415";"-";"153,300";"-";"-";"-";"-";"-";"-";"-";"-";"-";"-";"-";"-";"-";"-";"-";"-";"-";"-";"-";"-";"-";"-";"-";"-";"-";"-";"-";"-";"-";"-"
"02 Sie 2024 17:27:13";"Zmodyfikowano Stop Loss";"O2-D4-95EETE";"-";"O2-D4-95EF4P";"Solana (USD)";"98,5 Jednost.";"154,415";"-";"153,800";"-";"-";"-";"-";"-";"-";"-";"-";"-";"-";"-";"-";"-";"-";"-";"-";"-";"-";"-";"-";"-";"-";"-";"-";"-";"-";"-";"-";"-";"-"
"02 Sie 2024 17:26:55";"Zmodyfikowano Transakcję Sprzedaży";"O2-D4-95EETE";"T2-D4-5JBY7W";"-";"Solana (USD)";"98,5 Jednost.";"154,415";"-";"153,900";"-";"-";"-";"-";"0,00";"-";"-";"-";"-";"-";"-";"-";"-";"-";"-";"-";"-";"-";"-";"-";"-";"-";"-";"-";"-";"-";"-";"-";"-";"-"
"02 Sie 2024 17:25:27";"Zmodyfikowano Transakcję Sprzedaży";"O2-D4-95EETE";"T2-D4-5JBY7W";"-";"Solana (USD)";"98,5 Jednost.";"154,415";"-";"-";"-";"-";"-";"-";"0,00";"-";"-";"-";"-";"-";"-";"-";"-";"-";"-";"-";"-";"-";"-";"-";"-";"-";"-";"-";"-";"-";"-";"-";"-";"-"
"02 Sie 2024 17:24:52";"Transakcja Sprzedaży";"O2-D4-95EETE";"T2-D4-5JBY7W";"-";"Solana (USD)";"98,5 Jednost.";"154,415";"-";"157,508";"-";"-";"3,947719";"60 044,32";"0,00";"-";"-";"-";"-";"-";"-";"-";"-";"-";"-";"-";"-";"-";"-";"-";"-";"-";"-";"-";"-";"-";"-";"-";"-";"-"
"02 Sie 2024 17:23:23";" Zamknięcie Transakcji";"O2-D4-95EEHX";"T2-D4-5JBY0V";"O2-D4-95ED9N";"Solana (USD)";"98,5 Jednost.";"154,045";"-";"-";"-";"-";"3,90883";"59 906,53";"42,35";"24 381,31";"-";"-";"-";"-";"-";"-";"-";"-";"-";"-";"-";"-";"-";"-";"-";"-";"-";"-";"-";"-";"-";"-";"-";"-"
"02 Sie 2024 17:15:32";"Zmodyfikowano Transakcję Sprzedaży";"O2-D4-95ED9N";"T2-D4-5JBX5X";"-";"Solana (USD)";"98,5 Jednost.";"154,155";"-";"-";"-";"-";"-";"-";"0,00";"-";"-";"-";"-";"-";"-";"-";"-";"-";"-";"-";"-";"-";"-";"-";"-";"-";"-";"-";"-";"-";"-";"-";"-";"-"
"02 Sie 2024 17:15:04";"Transakcja Sprzedaży";"O2-D4-95ED9N";"T2-D4-5JBX5X";"-";"Solana (USD)";"98,5 Jednost.";"154,155";"-";"157,263";"-";"-";"3,950625";"59 987,34";"0,00";"-";"-";"-";"-";"-";"-";"-";"-";"-";"-";"-";"-";"-";"-";"-";"-";"-";"-";"-";"-";"-";"-";"-";"-";"-"
"02 Sie 2024 09:08:02";" Zamknięcie Transakcji";"O2-D4-95CN00";"T2-D4-5J9D3P";"O2-D4-95CM57";"Solana (USD)";"90 Jednost.";"161,405";"-";"-";"-";"-";"4,002439";"58 141,23";"-5,40";"24 338,96";"-";"-";"-";"-";"-";"-";"-";"-";"-";"-";"-";"-";"-";"-";"-";"-";"-";"-";"-";"-";"-";"-";"-";"-"
"02 Sie 2024 09:02:23";"Zmodyfikowano Transakcję Sprzedaży";"O2-D4-95CM57";"T2-D4-5J9CDR";"-";"Solana (USD)";"90 Jednost.";"161,390";"-";"-";"-";"-";"-";"-";"0,00";"-";"-";"-";"-";"-";"-";"-";"-";"-";"-";"-";"-";"-";"-";"-";"-";"-";"-";"-";"-";"-";"-";"-";"-";"-"
"02 Sie 2024 09:01:53";"Transakcja Sprzedaży";"O2-D4-95CM57";"T2-D4-5J9CDR";"-";"Solana (USD)";"90 Jednost.";"161,390";"-";"164,612";"-";"-";"4,000725";"58 110,93";"0,00";"-";"-";"-";"-";"-";"-";"-";"-";"-";"-";"-";"-";"-";"-";"-";"-";"-";"-";"-";"-";"-";"-";"-";"-";"-"
"02 Sie 2024 08:51:49";" Zamknięcie Transakcji";"O2-D4-95CL9Y";"T2-D4-5J9BP1";"O2-CZ-93XJ1D";"Solana (USD)";"6 Jednost.";"162,050";"-";"-";"-";"-";"3,997659";"3 886,92";"-200,52";"24 344,36";"-";"-";"-";"-";"-";"-";"-";"-";"-";"-";"-";"-";"-";"-";"-";"-";"-";"-";"-";"-";"-";"-";"-";"-"
"02 Sie 2024 08:50:44";" Zamknięcie Transakcji";"O2-D4-95CL7M";"T2-D4-5J9BM2";"O2-CZ-93XJ1D";"Solana (USD)";"6 Jednost.";"162,096";"-";"-";"-";"-";"3,9981";"3 888,45";"-201,65";"24 544,88";"-";"-";"-";"-";"-";"-";"-";"-";"-";"-";"-";"-";"-";"-";"-";"-";"-";"-";"-";"-";"-";"-";"-";"-"
"02 Sie 2024 08:46:41";" Zamknięcie Transakcji";"O2-D4-95CL0C";"T2-D4-5J9BFH";"O2-D4-95BRPV";"Solana (USD)";"100 Jednost.";"161,618";"-";"-";"-";"-";"3,996026";"64 582,97";"-820,38";"24 746,53";"-";"-";"-";"-";"-";"-";"-";"-";"-";"-";"-";"-";"-";"-";"-";"-";"-";"-";"-";"-";"-";"-";"-";"-"
"02 Sie 2024 08:46:33";" Zamknięcie Transakcji";"O2-D4-95CL03";"T2-D4-5J9BFB";"O2-D4-95C242";"Solana (USD)";"90 Jednost.";"161,330";"-";"-";"-";"-";"3,996026";"58 021,09";"-2 245,97";"25 566,91";"-";"-";"-";"-";"-";"-";"-";"-";"-";"-";"-";"-";"-";"-";"-";"-";"-";"-";"-";"-";"-";"-";"-";"-"
"02 Sie 2024 00:12:50";" Zmodyfikowano Transakcję Kupna";"O2-D4-95C242";"T2-D4-5J8W1D";"-";"Solana (USD)";"90 Jednost.";"167,575";"-";"-";"180,000";"-";"-";"-";"0,00";"-";"-";"-";"-";"-";"-";"-";"-";"-";"-";"-";"-";"-";"-";"-";"-";"-";"-";"-";"-";"-";"-";"-";"-";"-"
"02 Sie 2024 00:10:55";" Transakcja Kupna";"O2-D4-95C242";"T2-D4-5J8W1D";"-";"Solana (USD)";"90 Jednost.";"167,575";"-";"164,226";"-";"-";"4,005104";"60 403,97";"0,00";"-";"-";"-";"-";"-";"-";"-";"-";"-";"-";"-";"-";"-";"-";"-";"-";"-";"-";"-";"-";"-";"-";"-";"-";"-"
"02 Sie 2024 00:07:05";" Zamknięcie Transakcji";"O2-D4-95C1ZY";"T2-D4-5J8VXV";"O2-D4-95C1Q7";"Solana (USD)";"90 Jednost.";"166,555";"-";"-";"-";"-";"3,96539";"60 038,55";"19,63";"27 812,88";"-";"-";"-";"-";"-";"-";"-";"-";"-";"-";"-";"-";"-";"-";"-";"-";"-";"-";"-";"-";"-";"-";"-";"-"
"02 Sie 2024 00:00:54";" Zmodyfikowano Transakcję Kupna";"O2-D4-95C1Q7";"T2-D4-5J8VPY";"-";"Solana (USD)";"90 Jednost.";"166,500";"-";"-";"-";"-";"-";"-";"0,00";"-";"-";"-";"-";"-";"-";"-";"-";"-";"-";"-";"-";"-";"-";"-";"-";"-";"-";"-";"-";"-";"-";"-";"-";"-"
"02 Sie 2024 00:00:34";" Transakcja Kupna";"O2-D4-95C1Q7";"T2-D4-5J8VPY";"-";"Solana (USD)";"90 Jednost.";"166,500";"-";"163,170";"-";"-";"4,005154";"60 017,23";"0,00";"-";"-";"-";"-";"-";"-";"-";"-";"-";"-";"-";"-";"-";"-";"-";"-";"-";"-";"-";"-";"-";"-";"-";"-";"-"
"01 Sie 2024 23:34:18";"Stop Loss";"O2-D4-95C1DG";"T2-D4-5J8VKV";"-";"Solana (USD)";"90 Jednost.";"165,685";"-";"-";"-";"-";"3,96241";"59 679,97";"181,87";"27 793,25";"-";"-";"-";"-";"-";"-";"-";"-";"-";"-";"-";"-";"-";"-";"-";"-";"-";"-";"-";"-";"-";"-";"-";"-"
"01 Sie 2024 23:32:25";"Zmodyfikowano Stop Loss";"O2-D4-95C1DG";"-";"O2-D4-95C1HH";"Solana (USD)";"90 Jednost.";"165,175";"-";"165,700";"-";"-";"-";"-";"-";"-";"-";"-";"-";"-";"-";"-";"-";"-";"-";"-";"-";"-";"-";"-";"-";"-";"-";"-";"-";"-";"-";"-";"-";"-"
"01 Sie 2024 23:29:35";" Zmodyfikowano Transakcję Kupna";"O2-D4-95C1DG";"T2-D4-5J8VH7";"-";"Solana (USD)";"90 Jednost.";"165,175";"-";"165,400";"-";"-";"-";"-";"0,00";"-";"-";"-";"-";"-";"-";"-";"-";"-";"-";"-";"-";"-";"-";"-";"-";"-";"-";"-";"-";"-";"-";"-";"-";"-"
"01 Sie 2024 23:09:08";" Zmodyfikowano Transakcję Kupna";"O2-D4-95C1DG";"T2-D4-5J8VH7";"-";"Solana (USD)";"90 Jednost.";"165,175";"-";"-";"-";"-";"-";"-";"0,00";"-";"-";"-";"-";"-";"-";"-";"-";"-";"-";"-";"-";"-";"-";"-";"-";"-";"-";"-";"-";"-";"-";"-";"-";"-"
"01 Sie 2024 23:00:52";"Koszty Utrzymania Pozycji";"1359971934";"-";"-";"Rachunek";"-";"-";"-";"-";"-";"-";"-";"-";"-29,57";"27 611,38";"-";"-";"-";"-";"-";"-29,57";"-";"-";"-";"-";"-";"-";"-";"-";"-";"-";"-";"-";"-";"-";"-";"-";"-";"-"
"01 Sie 2024 23:00:52";"Koszty Utrzymania Pozycji";"O2-D4-95BRPV";"-";"-";"Solana (USD)";"-";"-";"-";"-";"-";"-";"-";"-";"-";"-";"-";"-";"16 463,60";"-10,00000%";"17,90";"17,90";"-";"-";"-";"-";"-";"-";"-";"-";"-";"-";"-";"-";"-";"-";"-";"-";"-";"-"
"01 Sie 2024 23:00:52";"Koszty Utrzymania Pozycji";"O2-D3-94S9LM";"-";"-";"Solana (USD)";"-";"-";"-";"-";"-";"-";"-";"-";"-";"-";"-";"-";"11 524,52";"-27,50000%";"-34,79";"-34,79";"-";"-";"-";"-";"-";"-";"-";"-";"-";"-";"-";"-";"-";"-";"-";"-";"-";"-"
"01 Sie 2024 23:00:52";"Koszty Utrzymania Pozycji";"O2-CZ-93XJ1D";"-";"-";"Solana (USD)";"-";"-";"-";"-";"-";"-";"-";"-";"-";"-";"-";"-";"11 195,24";"-10,00000%";"12,17";"12,17";"-";"-";"-";"-";"-";"-";"-";"-";"-";"-";"-";"-";"-";"-";"-";"-";"-";"-"
"01 Sie 2024 23:00:52";"Koszty Utrzymania Pozycji";"O2-D3-94JY88";"-";"-";"Solana (USD)";"-";"-";"-";"-";"-";"-";"-";"-";"-";"-";"-";"-";"8 231,80";"-27,50000%";"-24,85";"-24,85";"-";"-";"-";"-";"-";"-";"-";"-";"-";"-";"-";"-";"-";"-";"-";"-";"-";"-"
"01 Sie 2024 23:00:50";" Transakcja Kupna";"O2-D4-95C1DG";"T2-D4-5J8VH7";"-";"Solana (USD)";"90 Jednost.";"165,175";"-";"161,872";"-";"-";"4,007258";"59 570,89";"0,00";"-";"-";"-";"-";"-";"-";"-";"-";"-";"-";"-";"-";"-";"-";"-";"-";"-";"-";"-";"-";"-";"-";"-";"-";"-"
"01 Sie 2024 22:50:22";"Stop Loss";"O2-D4-95C0P7";"T2-D4-5J8V5F";"-";"Solana (USD)";"90 Jednost.";"164,360";"-";"-";"-";"-";"3,9677";"59 281,56";"233,90";"27 640,95";"-";"-";"-";"-";"-";"-";"-";"-";"-";"-";"-";"-";"-";"-";"-";"-";"-";"-";"-";"-";"-";"-";"-";"-"
"01 Sie 2024 22:50:19";"Zmodyfikowano Stop Loss";"O2-D4-95C0P7";"-";"O2-D4-95C0ZS";"Solana (USD)";"90 Jednost.";"163,705";"-";"164,400";"-";"-";"-";"-";"-";"-";"-";"-";"-";"-";"-";"-";"-";"-";"-";"-";"-";"-";"-";"-";"-";"-";"-";"-";"-";"-";"-";"-";"-";"-"
"01 Sie 2024 22:49:51";"Zmodyfikowano Stop Loss";"O2-D4-95C0P7";"-";"O2-D4-95C0ZS";"Solana (USD)";"90 Jednost.";"163,705";"-";"164,300";"-";"-";"-";"-";"-";"-";"-";"-";"-";"-";"-";"-";"-";"-";"-";"-";"-";"-";"-";"-";"-";"-";"-";"-";"-";"-";"-";"-";"-";"-"
"01 Sie 2024 22:49:33";" Zmodyfikowano Transakcję Kupna";"O2-D4-95C0P7";"T2-D4-5J8TXD";"-";"Solana (USD)";"90 Jednost.";"163,705";"-";"164,100";"-";"-";"-";"-";"0,00";"-";"-";"-";"-";"-";"-";"-";"-";"-";"-";"-";"-";"-";"-";"-";"-";"-";"-";"-";"-";"-";"-";"-";"-";"-"
"01 Sie 2024 22:38:45";" Zmodyfikowano Transakcję Kupna";"O2-D4-95C0P7";"T2-D4-5J8TXD";"-";"Solana (USD)";"90 Jednost.";"163,705";"-";"-";"-";"-";"-";"-";"0,00";"-";"-";"-";"-";"-";"-";"-";"-";"-";"-";"-";"-";"-";"-";"-";"-";"-";"-";"-";"-";"-";"-";"-";"-";"-"
"01 Sie 2024 22:37:56";" Transakcja Kupna";"O2-D4-95C0P7";"T2-D4-5J8TXD";"-";"Solana (USD)";"90 Jednost.";"163,705";"-";"160,392";"-";"-";"4,007849";"59 049,44";"0,00";"-";"-";"-";"-";"-";"-";"-";"-";"-";"-";"-";"-";"-";"-";"-";"-";"-";"-";"-";"-";"-";"-";"-";"-";"-"
"01 Sie 2024 22:32:54";" Zamknięcie Transakcji";"O2-D4-95C0EZ";"T2-D4-5J8TPW";"O2-D4-95C09M";"Solana (USD)";"90 Jednost.";"162,221";"-";"-";"-";"-";"3,96815";"58 516,79";"102,14";"27 407,05";"-";"-";"-";"-";"-";"-";"-";"-";"-";"-";"-";"-";"-";"-";"-";"-";"-";"-";"-";"-";"-";"-";"-";"-"
"01 Sie 2024 22:31:55";" Zmodyfikowano Transakcję Kupna";"O2-D4-95C09M";"T2-D4-5J8TKL";"-";"Solana (USD)";"90 Jednost.";"161,935";"-";"-";"-";"-";"-";"-";"0,00";"-";"-";"-";"-";"-";"-";"-";"-";"-";"-";"-";"-";"-";"-";"-";"-";"-";"-";"-";"-";"-";"-";"-";"-";"-"
"01 Sie 2024 22:31:42";" Transakcja Kupna";"O2-D4-95C09M";"T2-D4-5J8TKL";"-";"Solana (USD)";"90 Jednost.";"161,935";"-";"158,721";"-";"-";"4,00824";"58 416,69";"0,00";"-";"-";"-";"-";"-";"-";"-";"-";"-";"-";"-";"-";"-";"-";"-";"-";"-";"-";"-";"-";"-";"-";"-";"-";"-"
"01 Sie 2024 21:16:59";"Zmodyfikowano Transakcję Sprzedaży";"O2-D4-95BRPV";"T2-D4-5J8LHM";"-";"Solana (USD)";"100 Jednost.";"159,565";"-";"-";"-";"-";"-";"-";"0,00";"-";"-";"-";"-";"-";"-";"-";"-";"-";"-";"-";"-";"-";"-";"-";"-";"-";"-";"-";"-";"-";"-";"-";"-";"-"
"01 Sie 2024 20:59:29";"Transakcja Sprzedaży";"O2-D4-95BRPV";"T2-D4-5J8LHM";"-";"Solana (USD)";"100 Jednost.";"159,565";"-";"162,756";"-";"-";"4,010645";"63 995,85";"0,00";"-";"-";"-";"-";"-";"-";"-";"-";"-";"-";"-";"-";"-";"-";"-";"-";"-";"-";"-";"-";"-";"-";"-";"-";"-"
"01 Sie 2024 20:49:34";" Zamknięcie Transakcji";"O2-D4-95BQW9";"T2-D4-5J8KTM";"O2-D4-95BQC3";"Solana (USD)";"100 Jednost.";"158,876";"-";"-";"-";"-";"4,009072";"63 694,53";"-254,98";"27 304,91";"-";"-";"-";"-";"-";"-";"-";"-";"-";"-";"-";"-";"-";"-";"-";"-";"-";"-";"-";"-";"-";"-";"-";"-"
"01 Sie 2024 20:43:52";"Zmodyfikowano Transakcję Sprzedaży";"O2-D4-95BQC3";"T2-D4-5J8KB7";"-";"Solana (USD)";"100 Jednost.";"158,240";"-";"-";"-";"-";"-";"-";"0,00";"-";"-";"-";"-";"-";"-";"-";"-";"-";"-";"-";"-";"-";"-";"-";"-";"-";"-";"-";"-";"-";"-";"-";"-";"-"
"01 Sie 2024 20:42:55";"Transakcja Sprzedaży";"O2-D4-95BQC3";"T2-D4-5J8KB7";"-";"Solana (USD)";"100 Jednost.";"158,240";"-";"161,415";"-";"-";"4,008721";"63 434,00";"0,00";"-";"-";"-";"-";"-";"-";"-";"-";"-";"-";"-";"-";"-";"-";"-";"-";"-";"-";"-";"-";"-";"-";"-";"-";"-"
"01 Sie 2024 20:40:12";" Zamknięcie Transakcji";"O2-D4-95BQ34";"T2-D4-5J8K3X";"O2-D4-95BPYL";"Solana (USD)";"100 Jednost.";"159,260";"-";"-";"-";"-";"4,007659";"63 825,97";"-92,18";"27 559,89";"-";"-";"-";"-";"-";"-";"-";"-";"-";"-";"-";"-";"-";"-";"-";"-";"-";"-";"-";"-";"-";"-";"-";"-"
"01 Sie 2024 20:38:21";"Transakcja Sprzedaży";"O2-D4-95BPYL";"T2-D4-5J8JZZ";"-";"Solana (USD)";"100 Jednost.";"159,030";"-";"162,220";"-";"-";"4,00816";"63 741,76";"0,00";"-";"-";"-";"-";"-";"-";"-";"-";"-";"-";"-";"-";"-";"-";"-";"-";"-";"-";"-";"-";"-";"-";"-";"-";"-"
"01 Sie 2024 20:36:02";" Zamknięcie Transakcji";"O2-D4-95BPSC";"T2-D4-5J8JVX";"O2-D4-95BMKJ";"Solana (USD)";"100 Jednost.";"159,985";"-";"-";"-";"-";"3,96869";"64 131,12";"67,47";"27 652,07";"-";"-";"-";"-";"-";"-";"-";"-";"-";"-";"-";"-";"-";"-";"-";"-";"-";"-";"-";"-";"-";"-";"-";"-"
"01 Sie 2024 20:13:53";"Zmodyfikowano Transakcję Sprzedaży";"O2-D4-95BMKJ";"T2-D4-5J8GN2";"-";"Solana (USD)";"100 Jednost.";"160,155";"-";"-";"-";"-";"-";"-";"0,00";"-";"-";"-";"-";"-";"-";"-";"-";"-";"-";"-";"-";"-";"-";"-";"-";"-";"-";"-";"-";"-";"-";"-";"-";"-"
"01 Sie 2024 20:13:23";"Transakcja Sprzedaży";"O2-D4-95BMKJ";"T2-D4-5J8GN2";"-";"Solana (USD)";"100 Jednost.";"160,155";"-";"163,358";"-";"-";"4,006406";"64 164,59";"0,00";"-";"-";"-";"-";"-";"-";"-";"-";"-";"-";"-";"-";"-";"-";"-";"-";"-";"-";"-";"-";"-";"-";"-";"-";"-"
"01 Sie 2024 19:47:15";"Stop Loss";"O2-D4-95BJH3";"T2-D4-5J8EHX";"-";"Solana (USD)";"100 Jednost.";"160,150";"-";"-";"-";"-";"3,96662";"64 163,88";"132,88";"27 584,60";"-";"-";"-";"-";"-";"-";"-";"-";"-";"-";"-";"-";"-";"-";"-";"-";"-";"-";"-";"-";"-";"-";"-";"-"
"01 Sie 2024 19:44:12";"Zmodyfikowano Stop Loss";"O2-D4-95BJH3";"-";"O2-D4-95BJT7";"Solana (USD)";"100 Jednost.";"160,485";"-";"160,150";"-";"-";"-";"-";"-";"-";"-";"-";"-";"-";"-";"-";"-";"-";"-";"-";"-";"-";"-";"-";"-";"-";"-";"-";"-";"-";"-";"-";"-";"-"
"01 Sie 2024 19:42:51";"Zmodyfikowano Stop Loss";"O2-D4-95BJH3";"-";"O2-D4-95BJT7";"Solana (USD)";"100 Jednost.";"160,485";"-";"160,350";"-";"-";"-";"-";"-";"-";"-";"-";"-";"-";"-";"-";"-";"-";"-";"-";"-";"-";"-";"-";"-";"-";"-";"-";"-";"-";"-";"-";"-";"-"
"01 Sie 2024 19:42:28";"Zmodyfikowano Transakcję Sprzedaży";"O2-D4-95BJH3";"T2-D4-5J8DVZ";"-";"Solana (USD)";"100 Jednost.";"160,485";"-";"160,450";"-";"-";"-";"-";"0,00";"-";"-";"-";"-";"-";"-";"-";"-";"-";"-";"-";"-";"-";"-";"-";"-";"-";"-";"-";"-";"-";"-";"-";"-";"-"
"01 Sie 2024 19:40:26";"Zmodyfikowano Transakcję Sprzedaży";"O2-D4-95BJH3";"T2-D4-5J8DVZ";"-";"Solana (USD)";"100 Jednost.";"160,485";"-";"-";"-";"-";"-";"-";"0,00";"-";"-";"-";"-";"-";"-";"-";"-";"-";"-";"-";"-";"-";"-";"-";"-";"-";"-";"-";"-";"-";"-";"-";"-";"-"
"01 Sie 2024 19:40:11";"Transakcja Sprzedaży";"O2-D4-95BJH3";"T2-D4-5J8DVZ";"-";"Solana (USD)";"100 Jednost.";"160,485";"-";"163,684";"-";"-";"4,007058";"64 307,27";"0,00";"-";"-";"-";"-";"-";"-";"-";"-";"-";"-";"-";"-";"-";"-";"-";"-";"-";"-";"-";"-";"-";"-";"-";"-";"-"
"01 Sie 2024 18:03:49";" Zamknięcie Transakcji";"O2-D4-95B8EN";"T2-D4-5J84N2";"O2-D4-95B5X1";"Solana (USD)";"10,76 Jednost.";"161,488";"-";"-";"-";"-";"3,96372";"6 956,61";"36,34";"27 451,72";"-";"-";"-";"-";"-";"-";"-";"-";"-";"-";"-";"-";"-";"-";"-";"-";"-";"-";"-";"-";"-";"-";"-";"-"
"01 Sie 2024 18:03:42";" Zamknięcie Transakcji";"O2-D4-95B8EC";"T2-D4-5J84MS";"O2-D4-95B4LL";"Solana (USD)";"90 Jednost.";"161,395";"-";"-";"-";"-";"3,96345";"58 149,84";"101,66";"27 415,38";"-";"-";"-";"-";"-";"-";"-";"-";"-";"-";"-";"-";"-";"-";"-";"-";"-";"-";"-";"-";"-";"-";"-";"-"
"01 Sie 2024 17:42:30";"Zmodyfikowano Transakcję Sprzedaży";"O2-D4-95B5X1";"T2-D4-5J82CQ";"-";"Solana (USD)";"10,76 Jednost.";"162,340";"-";"-";"158,000";"-";"-";"-";"0,00";"-";"-";"-";"-";"-";"-";"-";"-";"-";"-";"-";"-";"-";"-";"-";"-";"-";"-";"-";"-";"-";"-";"-";"-";"-"
"01 Sie 2024 17:41:56";"Transakcja Sprzedaży";"O2-D4-95B5X1";"T2-D4-5J82CQ";"-";"Solana (USD)";"10,76 Jednost.";"162,340";"-";"165,591";"-";"-";"4,005725";"6 997,11";"0,00";"-";"-";"-";"-";"-";"-";"-";"-";"-";"-";"-";"-";"-";"-";"-";"-";"-";"-";"-";"-";"-";"-";"-";"-";"-"
"01 Sie 2024 17:39:11";"Zmodyfikowano Take Profit";"O2-D4-95B4LL";"-";"O2-D4-95B4QM";"Solana (USD)";"90 Jednost.";"161,680";"-";"-";"158,000";"-";"-";"-";"-";"-";"-";"-";"-";"-";"-";"-";"-";"-";"-";"-";"-";"-";"-";"-";"-";"-";"-";"-";"-";"-";"-";"-";"-";"-"
"01 Sie 2024 17:36:11";"Zmodyfikowano Transakcję Sprzedaży";"O2-D4-95B4LL";"T2-D4-5J814Z";"-";"Solana (USD)";"90 Jednost.";"161,680";"-";"-";"160,000";"-";"-";"-";"0,00";"-";"-";"-";"-";"-";"-";"-";"-";"-";"-";"-";"-";"-";"-";"-";"-";"-";"-";"-";"-";"-";"-";"-";"-";"-"
"01 Sie 2024 17:32:47";"Zmodyfikowano Transakcję Sprzedaży";"O2-D4-95B4LL";"T2-D4-5J814Z";"-";"Solana (USD)";"90 Jednost.";"161,680";"-";"164,927";"160,000";"-";"-";"-";"0,00";"-";"-";"-";"-";"-";"-";"-";"-";"-";"-";"-";"-";"-";"-";"-";"-";"-";"-";"-";"-";"-";"-";"-";"-";"-"
"01 Sie 2024 17:31:49";"Transakcja Sprzedaży";"O2-D4-95B4LL";"T2-D4-5J814Z";"-";"Solana (USD)";"90 Jednost.";"161,680";"-";"164,927";"-";"-";"4,004553";"58 271,05";"0,00";"-";"-";"-";"-";"-";"-";"-";"-";"-";"-";"-";"-";"-";"-";"-";"-";"-";"-";"-";"-";"-";"-";"-";"-";"-"
"01 Sie 2024 17:28:29";"Stop Loss";"O2-D4-95B46Y";"T2-D4-5J80SJ";"-";"Solana (USD)";"90 Jednost.";"163,005";"-";"-";"-";"-";"3,96535";"58 758,14";"176,66";"27 313,72";"-";"-";"-";"-";"-";"-";"-";"-";"-";"-";"-";"-";"-";"-";"-";"-";"-";"-";"-";"-";"-";"-";"-";"-"
"01 Sie 2024 17:28:23";"Zmodyfikowano Stop Loss";"O2-D4-95B46Y";"-";"O2-D4-95B46Z";"Solana (USD)";"90 Jednost.";"163,500";"-";"163,000";"-";"-";"-";"-";"-";"-";"-";"-";"-";"-";"-";"-";"-";"-";"-";"-";"-";"-";"-";"-";"-";"-";"-";"-";"-";"-";"-";"-";"-";"-"
"01 Sie 2024 17:27:13";"Transakcja Sprzedaży";"O2-D4-95B46Y";"T2-D4-5J80QG";"-";"Solana (USD)";"90 Jednost.";"163,500";"-";"166,770";"-";"-";"4,005304";"58 938,04";"0,00";"-";"-";"-";"-";"-";"-";"-";"-";"-";"-";"-";"-";"-";"-";"-";"-";"-";"-";"-";"-";"-";"-";"-";"-";"-"
"01 Sie 2024 17:19:04";" Zamknięcie Transakcji";"O2-D4-95B3BN";"T2-D4-5J7ZYD";"O2-D3-946FM0";"Solana (USD)";"12 Jednost.";"162,940";"-";"-";"-";"-";"4,002889";"7 826,76";"-10,57";"27 137,06";"-";"-";"-";"-";"-";"-";"-";"-";"-";"-";"-";"-";"-";"-";"-";"-";"-";"-";"-";"-";"-";"-";"-";"-"
"01 Sie 2024 17:14:54";"Take Profit";"O2-D4-95B156";"T2-D4-5J7ZGZ";"-";"Solana (USD)";"90 Jednost.";"163,800";"-";"-";"-";"-";"3,96173";"58 990,65";"96,27";"27 147,63";"-";"-";"-";"-";"-";"-";"-";"-";"-";"-";"-";"-";"-";"-";"-";"-";"-";"-";"-";"-";"-";"-";"-";"-"
"01 Sie 2024 17:13:00";"Zmodyfikowano Take Profit";"O2-D4-95B156";"-";"O2-D4-95B220";"Solana (USD)";"90 Jednost.";"164,070";"-";"-";"163,800";"-";"-";"-";"-";"-";"-";"-";"-";"-";"-";"-";"-";"-";"-";"-";"-";"-";"-";"-";"-";"-";"-";"-";"-";"-";"-";"-";"-";"-"
"01 Sie 2024 17:09:33";"Zmodyfikowano Transakcję Sprzedaży";"O2-D4-95B156";"T2-D4-5J7Y17";"-";"Solana (USD)";"90 Jednost.";"164,070";"-";"-";"163,600";"-";"-";"-";"0,00";"-";"-";"-";"-";"-";"-";"-";"-";"-";"-";"-";"-";"-";"-";"-";"-";"-";"-";"-";"-";"-";"-";"-";"-";"-"
"01 Sie 2024 17:04:41";"Zmodyfikowano Transakcję Sprzedaży";"O2-D4-95B156";"T2-D4-5J7Y17";"-";"Solana (USD)";"90 Jednost.";"164,070";"-";"-";"-";"-";"-";"-";"0,00";"-";"-";"-";"-";"-";"-";"-";"-";"-";"-";"-";"-";"-";"-";"-";"-";"-";"-";"-";"-";"-";"-";"-";"-";"-"
"01 Sie 2024 17:04:12";"Transakcja Sprzedaży";"O2-D4-95B156";"T2-D4-5J7Y17";"-";"Solana (USD)";"90 Jednost.";"164,070";"-";"167,402";"-";"-";"4,000976";"59 079,61";"0,00";"-";"-";"-";"-";"-";"-";"-";"-";"-";"-";"-";"-";"-";"-";"-";"-";"-";"-";"-";"-";"-";"-";"-";"-";"-"
"01 Sie 2024 17:02:28";" Zamknięcie Transakcji";"O2-D4-95B0WC";"T2-D4-5J7XS1";"O2-D3-94Q82V";"Solana (USD)";"90 Jednost.";"164,495";"-";"-";"-";"-";"3,96123";"59 233,53";"887,71";"27 051,36";"-";"-";"-";"-";"-";"-";"-";"-";"-";"-";"-";"-";"-";"-";"-";"-";"-";"-";"-";"-";"-";"-";"-";"-"
"01 Sie 2024 16:59:36";"Zmodyfikowano Take Profit";"O2-D3-94Q82V";"-";"O2-D4-959CT3";"Solana (USD)";"90 Jednost.";"166,985";"-";"-";"160,000";"-";"-";"-";"-";"-";"-";"-";"-";"-";"-";"-";"-";"-";"-";"-";"-";"-";"-";"-";"-";"-";"-";"-";"-";"-";"-";"-";"-";"-"
"01 Sie 2024 16:55:02";"Zmodyfikowano Take Profit";"O2-D3-94Q82V";"-";"O2-D4-959CT3";"Solana (USD)";"90 Jednost.";"166,985";"-";"-";"164,000";"-";"-";"-";"-";"-";"-";"-";"-";"-";"-";"-";"-";"-";"-";"-";"-";"-";"-";"-";"-";"-";"-";"-";"-";"-";"-";"-";"-";"-"
"01 Sie 2024 14:46:55";"Zmodyfikowano Transakcję Sprzedaży";"O2-D3-94Q82V";"T2-D3-5HY8T5";"-";"Solana (USD)";"90 Jednost.";"166,985";"-";"-";"165,000";"-";"-";"-";"0,00";"-";"-";"-";"-";"-";"-";"-";"-";"-";"-";"-";"-";"-";"-";"-";"-";"-";"-";"-";"-";"-";"-";"-";"-";"-"
"31 Lip 2024 23:00:51";"Koszty Utrzymania Pozycji";"1359481061";"-";"-";"Rachunek";"-";"-";"-";"-";"-";"-";"-";"-";"-30,58";"26 163,65";"-";"-";"-";"-";"-";"-30,58";"-";"-";"-";"-";"-";"-";"-";"-";"-";"-";"-";"-";"-";"-";"-";"-";"-";"-"
"31 Lip 2024 23:00:51";"Koszty Utrzymania Pozycji";"O2-D3-94Q82V";"-";"-";"Solana (USD)";"-";"-";"-";"-";"-";"-";"-";"-";"-";"-";"-";"-";"15 607,80";"-10,00000%";"16,86";"16,86";"-";"-";"-";"-";"-";"-";"-";"-";"-";"-";"-";"-";"-";"-";"-";"-";"-";"-"
"31 Lip 2024 23:00:51";"Koszty Utrzymania Pozycji";"O2-D3-94S9LM";"-";"-";"Solana (USD)";"-";"-";"-";"-";"-";"-";"-";"-";"-";"-";"-";"-";"12 139,40";"-27,50000%";"-36,42";"-36,42";"-";"-";"-";"-";"-";"-";"-";"-";"-";"-";"-";"-";"-";"-";"-";"-";"-";"-"
"31 Lip 2024 23:00:51";"Koszty Utrzymania Pozycji";"O2-CZ-93XJ1D";"-";"-";"Solana (USD)";"-";"-";"-";"-";"-";"-";"-";"-";"-";"-";"-";"-";"11 792,56";"-10,00000%";"12,74";"12,74";"-";"-";"-";"-";"-";"-";"-";"-";"-";"-";"-";"-";"-";"-";"-";"-";"-";"-"
"31 Lip 2024 23:00:51";"Koszty Utrzymania Pozycji";"O2-D3-94JY88";"-";"-";"Solana (USD)";"-";"-";"-";"-";"-";"-";"-";"-";"-";"-";"-";"-";"8 671,00";"-27,50000%";"-26,01";"-26,01";"-";"-";"-";"-";"-";"-";"-";"-";"-";"-";"-";"-";"-";"-";"-";"-";"-";"-"
"31 Lip 2024 23:00:51";"Koszty Utrzymania Pozycji";"O2-D3-946FM0";"-";"-";"Solana (USD)";"-";"-";"-";"-";"-";"-";"-";"-";"-";"-";"-";"-";"2 081,04";"-10,00000%";"2,25";"2,25";"-";"-";"-";"-";"-";"-";"-";"-";"-";"-";"-";"-";"-";"-";"-";"-";"-";"-"
"31 Lip 2024 20:42:38";"Stop Loss";"O2-D4-957PXR";"T2-D4-5J5VPR";"-";"Solana (USD)";"75 Jednost.";"180,395";"-";"-";"-";"-";"3,9408";"53 853,38";"81,28";"26 194,23";"-";"-";"-";"-";"-";"-";"-";"-";"-";"-";"-";"-";"-";"-";"-";"-";"-";"-";"-";"-";"-";"-";"-";"-"
"31 Lip 2024 20:42:00";"Zmodyfikowano Stop Loss";"O2-D4-957PXR";"-";"O2-D4-957PXS";"Solana (USD)";"75 Jednost.";"180,120";"-";"180,400";"-";"-";"-";"-";"-";"-";"-";"-";"-";"-";"-";"-";"-";"-";"-";"-";"-";"-";"-";"-";"-";"-";"-";"-";"-";"-";"-";"-";"-";"-"
"31 Lip 2024 20:41:13";" Transakcja Kupna";"O2-D4-957PXR";"T2-D4-5J5VE0";"-";"Solana (USD)";"75 Jednost.";"180,120";"-";"176,518";"-";"-";"3,981707";"53 788,87";"0,00";"-";"-";"-";"-";"-";"-";"-";"-";"-";"-";"-";"-";"-";"-";"-";"-";"-";"-";"-";"-";"-";"-";"-";"-";"-"
"30 Lip 2024 23:00:43";"Koszty Utrzymania Pozycji";"1359010154";"-";"-";"Rachunek";"-";"-";"-";"-";"-";"-";"-";"-";"-31,75";"26 112,95";"-";"-";"-";"-";"-";"-31,75";"-";"-";"-";"-";"-";"-";"-";"-";"-";"-";"-";"-";"-";"-";"-";"-";"-";"-"
"30 Lip 2024 23:00:43";"Koszty Utrzymania Pozycji";"O2-D3-94Q82V";"-";"-";"Solana (USD)";"-";"-";"-";"-";"-";"-";"-";"-";"-";"-";"-";"-";"16 171,65";"-10,00000%";"17,50";"17,50";"-";"-";"-";"-";"-";"-";"-";"-";"-";"-";"-";"-";"-";"-";"-";"-";"-";"-"
"30 Lip 2024 23:00:43";"Koszty Utrzymania Pozycji";"O2-D3-94S9LM";"-";"-";"Solana (USD)";"-";"-";"-";"-";"-";"-";"-";"-";"-";"-";"-";"-";"12 577,95";"-27,50000%";"-37,80";"-37,80";"-";"-";"-";"-";"-";"-";"-";"-";"-";"-";"-";"-";"-";"-";"-";"-";"-";"-"
"30 Lip 2024 23:00:43";"Koszty Utrzymania Pozycji";"O2-CZ-93XJ1D";"-";"-";"Solana (USD)";"-";"-";"-";"-";"-";"-";"-";"-";"-";"-";"-";"-";"12 218,58";"-10,00000%";"13,22";"13,22";"-";"-";"-";"-";"-";"-";"-";"-";"-";"-";"-";"-";"-";"-";"-";"-";"-";"-"
"30 Lip 2024 23:00:43";"Koszty Utrzymania Pozycji";"O2-D3-94JY88";"-";"-";"Solana (USD)";"-";"-";"-";"-";"-";"-";"-";"-";"-";"-";"-";"-";"8 984,25";"-27,50000%";"-27,00";"-27,00";"-";"-";"-";"-";"-";"-";"-";"-";"-";"-";"-";"-";"-";"-";"-";"-";"-";"-"
"30 Lip 2024 23:00:43";"Koszty Utrzymania Pozycji";"O2-D3-946FM0";"-";"-";"Solana (USD)";"-";"-";"-";"-";"-";"-";"-";"-";"-";"-";"-";"-";"2 156,22";"-10,00000%";"2,33";"2,33";"-";"-";"-";"-";"-";"-";"-";"-";"-";"-";"-";"-";"-";"-";"-";"-";"-";"-"
"30 Lip 2024 11:32:57";" Zamknięcie Transakcji";"O2-D4-951JFC";"T2-D4-5J2M09";"O2-D3-94S9LM";"Solana (USD)";"2 Jednost.";"181,417";"-";"-";"-";"-";"3,93516";"1 442,16";"17,17";"26 144,70";"-";"-";"-";"-";"-";"-";"-";"-";"-";"-";"-";"-";"-";"-";"-";"-";"-";"-";"-";"-";"-";"-";"-";"-"
"30 Lip 2024 11:32:06";" Zamknięcie Transakcji";"O2-D4-951JCZ";"T2-D4-5J2LZK";"O2-D3-94S9LM";"Solana (USD)";"1 Jedn";"181,473";"-";"-";"-";"-";"3,93523";"721,31";"8,81";"26 127,53";"-";"-";"-";"-";"-";"-";"-";"-";"-";"-";"-";"-";"-";"-";"-";"-";"-";"-";"-";"-";"-";"-";"-";"-"
"30 Lip 2024 11:31:22";" Zamknięcie Transakcji";"O2-D4-951J9H";"T2-D4-5J2LYB";"O2-D3-94S9LM";"Solana (USD)";"2 Jednost.";"181,670";"-";"-";"-";"-";"3,93465";"1 443,98";"19,16";"26 118,72";"-";"-";"-";"-";"-";"-";"-";"-";"-";"-";"-";"-";"-";"-";"-";"-";"-";"-";"-";"-";"-";"-";"-";"-"
"29 Lip 2024 23:00:45";"Koszty Utrzymania Pozycji";"1358563469";"-";"-";"Rachunek";"-";"-";"-";"-";"-";"-";"-";"-";"-35,62";"26 099,56";"-";"-";"-";"-";"-";"-35,62";"-";"-";"-";"-";"-";"-";"-";"-";"-";"-";"-";"-";"-";"-";"-";"-";"-";"-"
"29 Lip 2024 23:00:45";"Koszty Utrzymania Pozycji";"O2-D3-94Q82V";"-";"-";"Solana (USD)";"-";"-";"-";"-";"-";"-";"-";"-";"-";"-";"-";"-";"16 719,30";"-10,00000%";"18,08";"18,08";"-";"-";"-";"-";"-";"-";"-";"-";"-";"-";"-";"-";"-";"-";"-";"-";"-";"-"
"29 Lip 2024 23:00:45";"Koszty Utrzymania Pozycji";"O2-CZ-93XJ1D";"-";"-";"Solana (USD)";"-";"-";"-";"-";"-";"-";"-";"-";"-";"-";"-";"-";"12 632,36";"-10,00000%";"13,66";"13,66";"-";"-";"-";"-";"-";"-";"-";"-";"-";"-";"-";"-";"-";"-";"-";"-";"-";"-"
"29 Lip 2024 23:00:45";"Koszty Utrzymania Pozycji";"O2-D3-94JY88";"-";"-";"Solana (USD)";"-";"-";"-";"-";"-";"-";"-";"-";"-";"-";"-";"-";"9 288,50";"-27,50000%";"-27,91";"-27,91";"-";"-";"-";"-";"-";"-";"-";"-";"-";"-";"-";"-";"-";"-";"-";"-";"-";"-"
"29 Lip 2024 23:00:45";"Koszty Utrzymania Pozycji";"O2-D3-946FM0";"-";"-";"Solana (USD)";"-";"-";"-";"-";"-";"-";"-";"-";"-";"-";"-";"-";"2 229,24";"-10,00000%";"2,41";"2,41";"-";"-";"-";"-";"-";"-";"-";"-";"-";"-";"-";"-";"-";"-";"-";"-";"-";"-"
"29 Lip 2024 23:00:45";"Koszty Utrzymania Pozycji";"O2-D3-94S9LM";"-";"-";"Solana (USD)";"-";"-";"-";"-";"-";"-";"-";"-";"-";"-";"-";"-";"13 932,75";"-27,50000%";"-41,86";"-41,86";"-";"-";"-";"-";"-";"-";"-";"-";"-";"-";"-";"-";"-";"-";"-";"-";"-";"-"
"29 Lip 2024 00:10:21";" Zamknięcie Transakcji";"O2-D4-94VSC4";"T2-D4-5J06BJ";"O2-D3-94JY88";"Solana (USD)";"5 Jednost.";"184,035";"-";"-";"-";"-";"3,91651";"3 640,09";"33,68";"26 135,18";"-";"-";"-";"-";"-";"-";"-";"-";"-";"-";"-";"-";"-";"-";"-";"-";"-";"-";"-";"-";"-";"-";"-";"-"
"29 Lip 2024 00:09:42";" Zamknięcie Transakcji";"O2-D4-94VS9R";"T2-D4-5J06BB";"O2-D3-94JY88";"Solana (USD)";"5 Jednost.";"184,096";"-";"-";"-";"-";"3,91669";"3 641,47";"34,88";"26 101,50";"-";"-";"-";"-";"-";"-";"-";"-";"-";"-";"-";"-";"-";"-";"-";"-";"-";"-";"-";"-";"-";"-";"-";"-"
"29 Lip 2024 00:08:30";" Zamknięcie Transakcji";"O2-D4-94VS6Y";"T2-D4-5J069S";"O2-D3-94JY88";"Solana (USD)";"10 Jednost.";"184,435";"-";"-";"-";"-";"3,91653";"7 296,03";"83,03";"26 066,62";"-";"-";"-";"-";"-";"-";"-";"-";"-";"-";"-";"-";"-";"-";"-";"-";"-";"-";"-";"-";"-";"-";"-";"-"
"29 Lip 2024 00:07:39";" Zamknięcie Transakcji";"O2-D4-94VS4Q";"T2-D4-5J0697";"O2-D3-94JY88";"Solana (USD)";"10 Jednost.";"184,505";"-";"-";"-";"-";"3,91662";"7 298,99";"85,77";"25 983,59";"-";"-";"-";"-";"-";"-";"-";"-";"-";"-";"-";"-";"-";"-";"-";"-";"-";"-";"-";"-";"-";"-";"-";"-"
"29 Lip 2024 00:07:16";" Zamknięcie Transakcji";"O2-D4-94VS3E";"T2-D4-5J068V";"O2-D3-94JY88";"Solana (USD)";"10 Jednost.";"184,515";"-";"-";"-";"-";"3,91662";"7 299,38";"86,17";"25 897,82";"-";"-";"-";"-";"-";"-";"-";"-";"-";"-";"-";"-";"-";"-";"-";"-";"-";"-";"-";"-";"-";"-";"-";"-"
"29 Lip 2024 00:06:15";" Zamknięcie Transakcji";"O2-D4-94VS0F";"T2-D4-5J067P";"O2-D3-9484MP";"Solana (USD)";"41,21 Jednost.";"184,490";"-";"-";"-";"-";"3,91662";"30 076,70";"65,21";"25 811,65";"-";"-";"-";"-";"-";"-";"-";"-";"-";"-";"-";"-";"-";"-";"-";"-";"-";"-";"-";"-";"-";"-";"-";"-"
"26 Lip 2024 23:00:53";"Koszty Utrzymania Pozycji";"1358149914";"-";"-";"Rachunek";"-";"-";"-";"-";"-";"-";"-";"-";"-236,32";"25 746,44";"-";"-";"-";"-";"-";"-236,32";"-";"-";"-";"-";"-";"-";"-";"-";"-";"-";"-";"-";"-";"-";"-";"-";"-";"-"
"26 Lip 2024 23:00:53";"Koszty Utrzymania Pozycji";"O2-D3-94Q82V";"-";"-";"Solana (USD)";"-";"-";"-";"-";"-";"-";"-";"-";"-";"-";"-";"-";"16 400,79";"-10,00000%";"52,80";"52,80";"-";"-";"-";"-";"-";"-";"-";"-";"-";"-";"-";"-";"-";"-";"-";"-";"-";"-"
"26 Lip 2024 23:00:53";"Koszty Utrzymania Pozycji";"O2-D3-9484MP";"-";"-";"Solana (USD)";"-";"-";"-";"-";"-";"-";"-";"-";"-";"-";"-";"-";"7 509,73";"-27,50000%";"-67,16";"-67,16";"-";"-";"-";"-";"-";"-";"-";"-";"-";"-";"-";"-";"-";"-";"-";"-";"-";"-"
"26 Lip 2024 23:00:53";"Koszty Utrzymania Pozycji";"O2-CZ-93XJ1D";"-";"-";"Solana (USD)";"-";"-";"-";"-";"-";"-";"-";"-";"-";"-";"-";"-";"12 391,70";"-10,00000%";"39,90";"39,90";"-";"-";"-";"-";"-";"-";"-";"-";"-";"-";"-";"-";"-";"-";"-";"-";"-";"-"
"26 Lip 2024 23:00:53";"Koszty Utrzymania Pozycji";"O2-D3-94JY88";"-";"-";"Solana (USD)";"-";"-";"-";"-";"-";"-";"-";"-";"-";"-";"-";"-";"16 400,79";"-27,50000%";"-146,67";"-146,67";"-";"-";"-";"-";"-";"-";"-";"-";"-";"-";"-";"-";"-";"-";"-";"-";"-";"-"
"26 Lip 2024 23:00:53";"Koszty Utrzymania Pozycji";"O2-D3-946FM0";"-";"-";"Solana (USD)";"-";"-";"-";"-";"-";"-";"-";"-";"-";"-";"-";"-";"2 186,77";"-10,00000%";"7,04";"7,04";"-";"-";"-";"-";"-";"-";"-";"-";"-";"-";"-";"-";"-";"-";"-";"-";"-";"-"
"26 Lip 2024 23:00:53";"Koszty Utrzymania Pozycji";"O2-D3-94S9LM";"-";"-";"Solana (USD)";"-";"-";"-";"-";"-";"-";"-";"-";"-";"-";"-";"-";"13 667,32";"-27,50000%";"-122,23";"-122,23";"-";"-";"-";"-";"-";"-";"-";"-";"-";"-";"-";"-";"-";"-";"-";"-";"-";"-"
"26 Lip 2024 12:41:20";" Zmodyfikowano Transakcję Kupna";"O2-D3-94S9LM";"T2-D3-5HYWJ7";"-";"Solana (USD)";"75 Jednost.";"179,235";"-";"-";"-";"-";"-";"-";"0,00";"-";"-";"-";"-";"-";"-";"-";"-";"-";"-";"-";"-";"-";"-";"-";"-";"-";"-";"-";"-";"-";"-";"-";"-";"-"
"26 Lip 2024 12:40:17";" Transakcja Kupna";"O2-D3-94S9LM";"T2-D3-5HYWJ7";"-";"Solana (USD)";"75 Jednost.";"179,235";"-";"175,656";"-";"-";"3,956206";"53 181,79";"0,00";"-";"-";"-";"-";"-";"-";"-";"-";"-";"-";"-";"-";"-";"-";"-";"-";"-";"-";"-";"-";"-";"-";"-";"-";"-"
"26 Lip 2024 09:35:39";" Zamknięcie Transakcji";"O2-D3-94RR45";"T2-D3-5HYNJ6";"O2-D3-94R2WL";"Solana (USD)";"75 Jednost.";"177,070";"-";"-";"-";"-";"3,92572";"52 658,63";"507,89";"25 982,76";"-";"-";"-";"-";"-";"-";"-";"-";"-";"-";"-";"-";"-";"-";"-";"-";"-";"-";"-";"-";"-";"-";"-";"-"
"26 Lip 2024 05:01:42";" Zmodyfikowano Transakcję Kupna";"O2-D3-94R2WL";"T2-D3-5HYFMM";"-";"Solana (USD)";"75 Jednost.";"175,345";"-";"-";"-";"-";"-";"-";"0,00";"-";"-";"-";"-";"-";"-";"-";"-";"-";"-";"-";"-";"-";"-";"-";"-";"-";"-";"-";"-";"-";"-";"-";"-";"-"
"26 Lip 2024 05:01:32";" Transakcja Kupna";"O2-D3-94R2WL";"T2-D3-5HYFMM";"-";"Solana (USD)";"75 Jednost.";"175,345";"-";"171,848";"-";"-";"3,967238";"52 172,65";"0,00";"-";"-";"-";"-";"-";"-";"-";"-";"-";"-";"-";"-";"-";"-";"-";"-";"-";"-";"-";"-";"-";"-";"-";"-";"-"
"26 Lip 2024 00:25:56";"Zmodyfikowano Transakcję Sprzedaży";"O2-D3-94Q82V";"T2-D3-5HY8T5";"-";"Solana (USD)";"90 Jednost.";"166,985";"-";"-";"-";"-";"-";"-";"0,00";"-";"-";"-";"-";"-";"-";"-";"-";"-";"-";"-";"-";"-";"-";"-";"-";"-";"-";"-";"-";"-";"-";"-";"-";"-"
"26 Lip 2024 00:01:55";" Zamknięcie Transakcji";"O2-D3-94QELP";"T2-D3-5HY9EY";"O2-D3-94QE1S";"Solana (USD)";"75 Jednost.";"171,250";"-";"-";"-";"-";"3,973791";"51 038,37";"-403,84";"25 474,87";"-";"-";"-";"-";"-";"-";"-";"-";"-";"-";"-";"-";"-";"-";"-";"-";"-";"-";"-";"-";"-";"-";"-";"-"
"25 Lip 2024 23:54:00";" Transakcja Kupna";"O2-D3-94QE1S";"T2-D3-5HY98T";"-";"Solana (USD)";"75 Jednost.";"172,605";"-";"169,153";"-";"-";"3,974803";"51 455,31";"0,00";"-";"-";"-";"-";"-";"-";"-";"-";"-";"-";"-";"-";"-";"-";"-";"-";"-";"-";"-";"-";"-";"-";"-";"-";"-"
"25 Lip 2024 23:01:00";"Koszty Utrzymania Pozycji";"1357783171";"-";"-";"Rachunek";"-";"-";"-";"-";"-";"-";"-";"-";"-35,71";"25 878,71";"-";"-";"-";"-";"-";"-35,71";"-";"-";"-";"-";"-";"-";"-";"-";"-";"-";"-";"-";"-";"-";"-";"-";"-";"-"
"25 Lip 2024 23:01:00";"Koszty Utrzymania Pozycji";"O2-D3-94Q82V";"-";"-";"Solana (USD)";"-";"-";"-";"-";"-";"-";"-";"-";"-";"-";"-";"-";"15 345,45";"-10,00000%";"16,53";"16,53";"-";"-";"-";"-";"-";"-";"-";"-";"-";"-";"-";"-";"-";"-";"-";"-";"-";"-"
"25 Lip 2024 23:01:00";"Koszty Utrzymania Pozycji";"O2-D3-9484MP";"-";"-";"Solana (USD)";"-";"-";"-";"-";"-";"-";"-";"-";"-";"-";"-";"-";"7 026,51";"-27,50000%";"-21,02";"-21,02";"-";"-";"-";"-";"-";"-";"-";"-";"-";"-";"-";"-";"-";"-";"-";"-";"-";"-"
"25 Lip 2024 23:01:00";"Koszty Utrzymania Pozycji";"O2-CZ-93XJ1D";"-";"-";"Solana (USD)";"-";"-";"-";"-";"-";"-";"-";"-";"-";"-";"-";"-";"11 594,34";"-10,00000%";"12,49";"12,49";"-";"-";"-";"-";"-";"-";"-";"-";"-";"-";"-";"-";"-";"-";"-";"-";"-";"-"
"25 Lip 2024 23:01:00";"Koszty Utrzymania Pozycji";"O2-D3-94JY88";"-";"-";"Solana (USD)";"-";"-";"-";"-";"-";"-";"-";"-";"-";"-";"-";"-";"15 345,45";"-27,50000%";"-45,91";"-45,91";"-";"-";"-";"-";"-";"-";"-";"-";"-";"-";"-";"-";"-";"-";"-";"-";"-";"-"
"25 Lip 2024 23:01:00";"Koszty Utrzymania Pozycji";"O2-D3-946FM0";"-";"-";"Solana (USD)";"-";"-";"-";"-";"-";"-";"-";"-";"-";"-";"-";"-";"2 046,06";"-10,00000%";"2,20";"2,20";"-";"-";"-";"-";"-";"-";"-";"-";"-";"-";"-";"-";"-";"-";"-";"-";"-";"-"
"25 Lip 2024 22:57:41";" Zamknięcie Transakcji";"O2-D3-94Q9LK";"T2-D3-5HY939";"O2-D3-94Q91N";"Solana (USD)";"75 Jednost.";"169,165";"-";"-";"-";"-";"3,93119";"50 377,69";"122,36";"25 914,42";"-";"-";"-";"-";"-";"-";"-";"-";"-";"-";"-";"-";"-";"-";"-";"-";"-";"-";"-";"-";"-";"-";"-";"-"
"25 Lip 2024 22:55:40";"Zmodyfikowano Stop Loss";"O2-D3-94Q91N";"-";"O2-D3-94Q91P";"Solana (USD)";"75 Jednost.";"168,750";"-";"169,000";"-";"-";"-";"-";"-";"-";"-";"-";"-";"-";"-";"-";"-";"-";"-";"-";"-";"-";"-";"-";"-";"-";"-";"-";"-";"-";"-";"-";"-";"-"
"25 Lip 2024 22:49:07";" Transakcja Kupna";"O2-D3-94Q91N";"T2-D3-5HY90D";"-";"Solana (USD)";"75 Jednost.";"168,750";"-";"165,375";"-";"-";"3,971527";"50 264,63";"0,00";"-";"-";"-";"-";"-";"-";"-";"-";"-";"-";"-";"-";"-";"-";"-";"-";"-";"-";"-";"-";"-";"-";"-";"-";"-"
"25 Lip 2024 22:47:40";"Odrzucono Zlecenie: brak wystarczających środków";"O2-D3-94Q8Y0";"-";"-";"Solana (USD)";"80 Jednost.";"-";"-";"-";"-";"-";"-";"-";"-";"-";"-";"-";"-";"-";"-";"-";"-";"-";"-";"-";"-";"-";"-";"-";"-";"-";"-";"-";"-";"-";"-";"-";"-";"-"
"25 Lip 2024 22:47:32";"Odrzucono Zlecenie: brak wystarczających środków";"O2-D3-94Q8XP";"-";"-";"Solana (USD)";"90 Jednost.";"-";"-";"-";"-";"-";"-";"-";"-";"-";"-";"-";"-";"-";"-";"-";"-";"-";"-";"-";"-";"-";"-";"-";"-";"-";"-";"-";"-";"-";"-";"-";"-";"-"
"25 Lip 2024 22:40:38";"Zmodyfikowano Transakcję Sprzedaży";"O2-D3-94Q82V";"T2-D3-5HY8T5";"-";"Solana (USD)";"90 Jednost.";"166,985";"-";"-";"165,600";"-";"-";"-";"0,00";"-";"-";"-";"-";"-";"-";"-";"-";"-";"-";"-";"-";"-";"-";"-";"-";"-";"-";"-";"-";"-";"-";"-";"-";"-"
"25 Lip 2024 22:36:25";"Zmodyfikowano Transakcję Sprzedaży";"O2-D3-94Q82V";"T2-D3-5HY8T5";"-";"Solana (USD)";"90 Jednost.";"166,985";"-";"-";"-";"-";"-";"-";"0,00";"-";"-";"-";"-";"-";"-";"-";"-";"-";"-";"-";"-";"-";"-";"-";"-";"-";"-";"-";"-";"-";"-";"-";"-";"-"
"25 Lip 2024 22:35:36";"Transakcja Sprzedaży";"O2-D3-94Q82V";"T2-D3-5HY8T5";"-";"Solana (USD)";"90 Jednost.";"166,985";"-";"170,304";"-";"-";"3,97299";"59 708,67";"0,00";"-";"-";"-";"-";"-";"-";"-";"-";"-";"-";"-";"-";"-";"-";"-";"-";"-";"-";"-";"-";"-";"-";"-";"-";"-"
"25 Lip 2024 22:08:56";" Zamknięcie Transakcji";"O2-D3-94Q5Y1";"T2-D3-5HY86L";"O2-D3-94PXSE";"Solana (USD)";"90 Jednost.";"166,805";"-";"-";"-";"-";"3,93321";"59 640,54";"21,24";"25 792,06";"-";"-";"-";"-";"-";"-";"-";"-";"-";"-";"-";"-";"-";"-";"-";"-";"-";"-";"-";"-";"-";"-";"-";"-"
"25 Lip 2024 21:09:15";"Transakcja Sprzedaży";"O2-D3-94PXSE";"T2-D3-5HY39X";"-";"Solana (USD)";"90 Jednost.";"166,865";"-";"170,243";"-";"-";"3,973741";"59 677,04";"0,00";"-";"-";"-";"-";"-";"-";"-";"-";"-";"-";"-";"-";"-";"-";"-";"-";"-";"-";"-";"-";"-";"-";"-";"-";"-"
"25 Lip 2024 21:04:14";"Stop Loss";"O2-D3-94PX2M";"T2-D3-5HY34B";"-";"Solana (USD)";"90 Jednost.";"167,215";"-";"-";"-";"-";"3,93427";"59 803,12";"229,80";"25 770,82";"-";"-";"-";"-";"-";"-";"-";"-";"-";"-";"-";"-";"-";"-";"-";"-";"-";"-";"-";"-";"-";"-";"-";"-"
"25 Lip 2024 21:03:16";"Zmodyfikowano Stop Loss";"O2-D3-94PX2M";"-";"O2-D3-94PX2N";"Solana (USD)";"90 Jednost.";"167,864";"-";"167,200";"-";"-";"-";"-";"-";"-";"-";"-";"-";"-";"-";"-";"-";"-";"-";"-";"-";"-";"-";"-";"-";"-";"-";"-";"-";"-";"-";"-";"-";"-"
"25 Lip 2024 21:02:42";"Zmodyfikowano Stop Loss";"O2-D3-94PX2M";"-";"O2-D3-94PX2N";"Solana (USD)";"90 Jednost.";"167,864";"-";"167,600";"-";"-";"-";"-";"-";"-";"-";"-";"-";"-";"-";"-";"-";"-";"-";"-";"-";"-";"-";"-";"-";"-";"-";"-";"-";"-";"-";"-";"-";"-"
"25 Lip 2024 21:02:04";"Transakcja Sprzedaży";"O2-D3-94PX2M";"T2-D3-5HY303";"-";"Solana (USD)";"90 Jednost.";"167,864";"-";"171,250";"-";"-";"3,97294";"60 022,22";"0,00";"-";"-";"-";"-";"-";"-";"-";"-";"-";"-";"-";"-";"-";"-";"-";"-";"-";"-";"-";"-";"-";"-";"-";"-";"-"
"25 Lip 2024 20:55:16";" Zamknięcie Transakcji";"O2-D3-94PW8M";"T2-D3-5HY2JE";"O2-D3-94PT9C";"Solana (USD)";"90 Jednost.";"167,581";"-";"-";"-";"-";"3,93378";"59 926,76";"0,35";"25 541,02";"-";"-";"-";"-";"-";"-";"-";"-";"-";"-";"-";"-";"-";"-";"-";"-";"-";"-";"-";"-";"-";"-";"-";"-"
"25 Lip 2024 20:41:27";"Transakcja Sprzedaży";"O2-D3-94PT9C";"T2-D3-5HY15Q";"-";"Solana (USD)";"90 Jednost.";"167,582";"-";"170,933";"-";"-";"3,972439";"59 913,83";"0,00";"-";"-";"-";"-";"-";"-";"-";"-";"-";"-";"-";"-";"-";"-";"-";"-";"-";"-";"-";"-";"-";"-";"-";"-";"-"
"25 Lip 2024 20:34:19";"Stop Loss";"O2-D3-94PS2E";"T2-D3-5HY0VB";"-";"Solana (USD)";"90 Jednost.";"168,515";"-";"-";"-";"-";"3,93273";"60 244,65";"85,65";"25 540,67";"-";"-";"-";"-";"-";"-";"-";"-";"-";"-";"-";"-";"-";"-";"-";"-";"-";"-";"-";"-";"-";"-";"-";"-"
"25 Lip 2024 20:34:07";"Zmodyfikowano Stop Loss";"O2-D3-94PS2E";"-";"O2-D3-94PS2F";"Solana (USD)";"90 Jednost.";"168,757";"-";"168,500";"-";"-";"-";"-";"-";"-";"-";"-";"-";"-";"-";"-";"-";"-";"-";"-";"-";"-";"-";"-";"-";"-";"-";"-";"-";"-";"-";"-";"-";"-"
"25 Lip 2024 20:29:12";"Transakcja Sprzedaży";"O2-D3-94PS2E";"T2-D3-5HY0MV";"-";"Solana (USD)";"90 Jednost.";"168,757";"-";"172,132";"-";"-";"3,97319";"60 345,32";"0,00";"-";"-";"-";"-";"-";"-";"-";"-";"-";"-";"-";"-";"-";"-";"-";"-";"-";"-";"-";"-";"-";"-";"-";"-";"-"
"25 Lip 2024 20:22:18";" Zamknięcie Transakcji";"O2-D3-94PR90";"T2-D3-5HY06Y";"O2-D3-94PR1H";"Solana (USD)";"90 Jednost.";"169,936";"-";"-";"-";"-";"3,93346";"60 763,70";"95,23";"25 455,02";"-";"-";"-";"-";"-";"-";"-";"-";"-";"-";"-";"-";"-";"-";"-";"-";"-";"-";"-";"-";"-";"-";"-";"-"
"25 Lip 2024 20:20:20";"Transakcja Sprzedaży";"O2-D3-94PR1H";"T2-D3-5HY039";"-";"Solana (USD)";"90 Jednost.";"170,205";"-";"173,593";"-";"-";"3,972749";"60 856,35";"0,00";"-";"-";"-";"-";"-";"-";"-";"-";"-";"-";"-";"-";"-";"-";"-";"-";"-";"-";"-";"-";"-";"-";"-";"-";"-"
"25 Lip 2024 20:11:01";" Zamknięcie Transakcji";"O2-D3-94PNNX";"T2-D3-5HXYFD";"O2-D3-94PMM8";"Solana (USD)";"90 Jednost.";"170,060";"-";"-";"-";"-";"3,93316";"60 803,59";"136,99";"25 359,79";"-";"-";"-";"-";"-";"-";"-";"-";"-";"-";"-";"-";"-";"-";"-";"-";"-";"-";"-";"-";"-";"-";"-";"-"
"25 Lip 2024 20:02:04";"Transakcja Sprzedaży";"O2-D3-94PMM8";"T2-D3-5HXXV0";"-";"Solana (USD)";"90 Jednost.";"170,447";"-";"173,855";"-";"-";"3,971587";"60 925,05";"0,00";"-";"-";"-";"-";"-";"-";"-";"-";"-";"-";"-";"-";"-";"-";"-";"-";"-";"-";"-";"-";"-";"-";"-";"-";"-"
"25 Lip 2024 19:35:49";"Stop Loss";"O2-D3-94NW5X";"T2-D3-5HXWHS";"-";"Solana (USD)";"88,8 Jednost.";"170,005";"-";"-";"-";"-";"3,92722";"59 883,01";"75,68";"25 222,80";"-";"-";"-";"-";"-";"-";"-";"-";"-";"-";"-";"-";"-";"-";"-";"-";"-";"-";"-";"-";"-";"-";"-";"-"
"25 Lip 2024 19:35:26";"Zmodyfikowano Transakcję Sprzedaży";"O2-D3-94NW5X";"T2-D3-5HXDZB";"-";"Solana (USD)";"88,8 Jednost.";"170,222";"-";"170,000";"-";"-";"-";"-";"0,00";"-";"-";"-";"-";"-";"-";"-";"-";"-";"-";"-";"-";"-";"-";"-";"-";"-";"-";"-";"-";"-";"-";"-";"-";"-"
"25 Lip 2024 19:35:26";"Zmodyfikowano Stop Loss";"O2-D3-94NW5X";"-";"O2-D3-94PJQP";"Solana (USD)";"88,8 Jednost.";"170,222";"-";"170,000";"-";"-";"-";"-";"-";"-";"-";"-";"-";"-";"-";"-";"-";"-";"-";"-";"-";"-";"-";"-";"-";"-";"-";"-";"-";"-";"-";"-";"-";"-"
"25 Lip 2024 19:34:13";"Zmodyfikowano Transakcję Sprzedaży";"O2-D3-94NW5X";"T2-D3-5HXDZB";"-";"Solana (USD)";"88,8 Jednost.";"170,222";"-";"170,100";"169,000";"-";"-";"-";"0,00";"-";"-";"-";"-";"-";"-";"-";"-";"-";"-";"-";"-";"-";"-";"-";"-";"-";"-";"-";"-";"-";"-";"-";"-";"-"
"25 Lip 2024 19:33:00";"Zmodyfikowano Take Profit";"O2-D3-94NW5X";"-";"O2-D3-94PEJE";"Solana (USD)";"88,8 Jednost.";"170,222";"-";"-";"169,000";"-";"-";"-";"-";"-";"-";"-";"-";"-";"-";"-";"-";"-";"-";"-";"-";"-";"-";"-";"-";"-";"-";"-";"-";"-";"-";"-";"-";"-"
"25 Lip 2024 18:58:48";"Zmodyfikowano Transakcję Sprzedaży";"O2-D3-94NW5X";"T2-D3-5HXDZB";"-";"Solana (USD)";"88,8 Jednost.";"170,222";"-";"-";"169,800";"-";"-";"-";"0,00";"-";"-";"-";"-";"-";"-";"-";"-";"-";"-";"-";"-";"-";"-";"-";"-";"-";"-";"-";"-";"-";"-";"-";"-";"-"
"25 Lip 2024 16:50:12";"Zmodyfikowano Transakcję Sprzedaży";"O2-D3-94NW5X";"T2-D3-5HXDZB";"-";"Solana (USD)";"88,8 Jednost.";"170,222";"-";"-";"-";"-";"-";"-";"0,00";"-";"-";"-";"-";"-";"-";"-";"-";"-";"-";"-";"-";"-";"-";"-";"-";"-";"-";"-";"-";"-";"-";"-";"-";"-"
"25 Lip 2024 16:47:32";"Transakcja Sprzedaży";"O2-D3-94NW5X";"T2-D3-5HXDZB";"-";"Solana (USD)";"88,8 Jednost.";"170,222";"-";"173,639";"-";"-";"3,969112";"59 995,96";"0,00";"-";"-";"-";"-";"-";"-";"-";"-";"-";"-";"-";"-";"-";"-";"-";"-";"-";"-";"-";"-";"-";"-";"-";"-";"-"
"25 Lip 2024 16:32:52";" Zamknięcie Transakcji";"O2-D3-94NSJD";"T2-D3-5HXC19";"O2-CZ-93XJ1D";"Solana (USD)";"50 Jednost.";"170,255";"-";"-";"-";"-";"3,970825";"33 802,64";"-3 288,84";"25 147,12";"-";"-";"-";"-";"-";"-";"-";"-";"-";"-";"-";"-";"-";"-";"-";"-";"-";"-";"-";"-";"-";"-";"-";"-"
"25 Lip 2024 16:28:09";"Stop Loss";"O2-D3-94NNPH";"T2-D3-5HXB9G";"-";"Solana (USD)";"41 Jednost.";"169,859";"-";"-";"-";"-";"3,972439";"27 664,93";"-544,15";"28 435,96";"-";"-";"-";"-";"-";"-";"-";"-";"-";"-";"-";"-";"-";"-";"-";"-";"-";"-";"-";"-";"-";"-";"-";"-"
"25 Lip 2024 16:15:08";"Transakcja Sprzedaży";"O2-D3-94NNPH";"T2-D3-5HX80H";"-";"Solana (USD)";"41 Jednost.";"166,518";"-";"169,848";"-";"-";"3,979392";"27 168,25";"0,00";"-";"-";"-";"-";"-";"-";"-";"-";"-";"-";"-";"-";"-";"-";"-";"-";"-";"-";"-";"-";"-";"-";"-";"-";"-"
"25 Lip 2024 16:11:07";"Stop Loss";"O2-D3-94NHD1";"T2-D3-5HX77B";"-";"Solana (USD)";"40 Jednost.";"166,600";"-";"-";"-";"-";"3,94096";"26 526,48";"188,38";"28 980,11";"-";"-";"-";"-";"-";"-";"-";"-";"-";"-";"-";"-";"-";"-";"-";"-";"-";"-";"-";"-";"-";"-";"-";"-"
"25 Lip 2024 16:09:26";"Zmodyfikowano Stop Loss";"O2-D3-94NHD1";"-";"O2-D3-94NLM0";"Solana (USD)";"40 Jednost.";"167,795";"-";"166,600";"-";"-";"-";"-";"-";"-";"-";"-";"-";"-";"-";"-";"-";"-";"-";"-";"-";"-";"-";"-";"-";"-";"-";"-";"-";"-";"-";"-";"-";"-"
"25 Lip 2024 16:08:56";"Zmodyfikowano Stop Loss";"O2-D3-94NHD1";"-";"O2-D3-94NLM0";"Solana (USD)";"40 Jednost.";"167,795";"-";"167,000";"-";"-";"-";"-";"-";"-";"-";"-";"-";"-";"-";"-";"-";"-";"-";"-";"-";"-";"-";"-";"-";"-";"-";"-";"-";"-";"-";"-";"-";"-"
"25 Lip 2024 16:06:53";"Zmodyfikowano Transakcję Sprzedaży";"O2-D3-94NHD1";"T2-D3-5HX3DC";"-";"Solana (USD)";"40 Jednost.";"167,795";"-";"167,200";"-";"-";"-";"-";"0,00";"-";"-";"-";"-";"-";"-";"-";"-";"-";"-";"-";"-";"-";"-";"-";"-";"-";"-";"-";"-";"-";"-";"-";"-";"-"
"25 Lip 2024 15:53:08";"Zmodyfikowano Transakcję Sprzedaży";"O2-D3-94NHD1";"T2-D3-5HX3DC";"-";"Solana (USD)";"40 Jednost.";"167,795";"-";"-";"-";"-";"-";"-";"0,00";"-";"-";"-";"-";"-";"-";"-";"-";"-";"-";"-";"-";"-";"-";"-";"-";"-";"-";"-";"-";"-";"-";"-";"-";"-"
"25 Lip 2024 15:52:42";"Transakcja Sprzedaży";"O2-D3-94NHD1";"T2-D3-5HX3DC";"-";"Solana (USD)";"40 Jednost.";"167,795";"-";"171,150";"-";"-";"3,976757";"26 691,19";"0,00";"-";"-";"-";"-";"-";"-";"-";"-";"-";"-";"-";"-";"-";"-";"-";"-";"-";"-";"-";"-";"-";"-";"-";"-";"-"
"25 Lip 2024 15:49:19";" Zamknięcie Transakcji";"O2-D3-94NGSL";"T2-D3-5HX2Y2";"O2-D3-94NBQB";"Solana (USD)";"39 Jednost.";"167,770";"-";"-";"-";"-";"3,93608";"26 012,76";"4,61";"28 791,73";"-";"-";"-";"-";"-";"-";"-";"-";"-";"-";"-";"-";"-";"-";"-";"-";"-";"-";"-";"-";"-";"-";"-";"-"
"25 Lip 2024 15:23:11";"Transakcja Sprzedaży";"O2-D3-94NBQB";"T2-D3-5HWYSS";"-";"Solana (USD)";"39 Jednost.";"167,800";"-";"171,156";"-";"-";"3,9732";"26 001,41";"0,00";"-";"-";"-";"-";"-";"-";"-";"-";"-";"-";"-";"-";"-";"-";"-";"-";"-";"-";"-";"-";"-";"-";"-";"-";"-"
"25 Lip 2024 15:00:03";"Stop Loss";"O2-D3-94MYML";"T2-D3-5HWX1X";"-";"Solana (USD)";"39 Jednost.";"167,510";"-";"-";"-";"-";"3,93697";"25 978,27";"123,60";"28 787,12";"-";"-";"-";"-";"-";"-";"-";"-";"-";"-";"-";"-";"-";"-";"-";"-";"-";"-";"-";"-";"-";"-";"-";"-"
"25 Lip 2024 14:56:01";"Zmodyfikowano Stop Loss";"O2-D3-94MYML";"-";"O2-D3-94N5RH";"Solana (USD)";"39 Jednost.";"168,315";"-";"167,500";"-";"-";"-";"-";"-";"-";"-";"-";"-";"-";"-";"-";"-";"-";"-";"-";"-";"-";"-";"-";"-";"-";"-";"-";"-";"-";"-";"-";"-";"-"
"25 Lip 2024 14:52:45";"Zmodyfikowano Stop Loss";"O2-D3-94MYML";"-";"O2-D3-94N5RH";"Solana (USD)";"39 Jednost.";"168,315";"-";"168,100";"-";"-";"-";"-";"-";"-";"-";"-";"-";"-";"-";"-";"-";"-";"-";"-";"-";"-";"-";"-";"-";"-";"-";"-";"-";"-";"-";"-";"-";"-"
"25 Lip 2024 14:38:53";"Zmodyfikowano Transakcję Sprzedaży";"O2-D3-94MYML";"T2-D3-5HWPHW";"-";"Solana (USD)";"39 Jednost.";"168,315";"-";"169,100";"-";"-";"-";"-";"0,00";"-";"-";"-";"-";"-";"-";"-";"-";"-";"-";"-";"-";"-";"-";"-";"-";"-";"-";"-";"-";"-";"-";"-";"-";"-"
"25 Lip 2024 13:13:05";"Zmodyfikowano Transakcję Sprzedaży";"O2-D3-94MYML";"T2-D3-5HWPHW";"-";"Solana (USD)";"39 Jednost.";"168,315";"-";"-";"-";"-";"-";"-";"0,00";"-";"-";"-";"-";"-";"-";"-";"-";"-";"-";"-";"-";"-";"-";"-";"-";"-";"-";"-";"-";"-";"-";"-";"-";"-"
"25 Lip 2024 13:12:49";"Transakcja Sprzedaży";"O2-D3-94MYML";"T2-D3-5HWPHW";"-";"Solana (USD)";"39 Jednost.";"168,315";"-";"171,681";"-";"-";"3,977539";"26 109,69";"0,00";"-";"-";"-";"-";"-";"-";"-";"-";"-";"-";"-";"-";"-";"-";"-";"-";"-";"-";"-";"-";"-";"-";"-";"-";"-"
"25 Lip 2024 13:00:55";" Zamknięcie Transakcji";"O2-D3-94MX5K";"T2-D3-5HWNNW";"O2-D3-94M9F2";"Solana (USD)";"37 Jednost.";"168,190";"-";"-";"-";"-";"3,93918";"24 760,01";"180,73";"28 663,52";"-";"-";"-";"-";"-";"-";"-";"-";"-";"-";"-";"-";"-";"-";"-";"-";"-";"-";"-";"-";"-";"-";"-";"-"
"25 Lip 2024 12:43:19";"Zmodyfikowano Stop Loss";"O2-D3-94M9F2";"-";"O2-D3-94MQMS";"Solana (USD)";"37 Jednost.";"169,430";"-";"168,300";"-";"-";"-";"-";"-";"-";"-";"-";"-";"-";"-";"-";"-";"-";"-";"-";"-";"-";"-";"-";"-";"-";"-";"-";"-";"-";"-";"-";"-";"-"
"25 Lip 2024 12:36:52";"Zmodyfikowano Stop Loss";"O2-D3-94M9F2";"-";"O2-D3-94MQMS";"Solana (USD)";"37 Jednost.";"169,430";"-";"168,700";"-";"-";"-";"-";"-";"-";"-";"-";"-";"-";"-";"-";"-";"-";"-";"-";"-";"-";"-";"-";"-";"-";"-";"-";"-";"-";"-";"-";"-";"-"
"25 Lip 2024 12:19:06";"Zmodyfikowano Stop Loss";"O2-D3-94M9F2";"-";"O2-D3-94MQMS";"Solana (USD)";"37 Jednost.";"169,430";"-";"168,900";"-";"-";"-";"-";"-";"-";"-";"-";"-";"-";"-";"-";"-";"-";"-";"-";"-";"-";"-";"-";"-";"-";"-";"-";"-";"-";"-";"-";"-";"-"
"25 Lip 2024 12:18:24";"Zmodyfikowano Stop Loss";"O2-D3-94M9F2";"-";"O2-D3-94MQMS";"Solana (USD)";"37 Jednost.";"169,430";"-";"169,000";"-";"-";"-";"-";"-";"-";"-";"-";"-";"-";"-";"-";"-";"-";"-";"-";"-";"-";"-";"-";"-";"-";"-";"-";"-";"-";"-";"-";"-";"-"
"25 Lip 2024 12:14:55";"Zmodyfikowano Transakcję Sprzedaży";"O2-D3-94M9F2";"T2-D3-5HWCZN";"-";"Solana (USD)";"37 Jednost.";"169,430";"-";"169,200";"-";"-";"-";"-";"0,00";"-";"-";"-";"-";"-";"-";"-";"-";"-";"-";"-";"-";"-";"-";"-";"-";"-";"-";"-";"-";"-";"-";"-";"-";"-"
"25 Lip 2024 10:23:44";"Zmodyfikowano Transakcję Sprzedaży";"O2-D3-94M9F2";"T2-D3-5HWCZN";"-";"Solana (USD)";"37 Jednost.";"169,430";"-";"-";"-";"-";"-";"-";"0,00";"-";"-";"-";"-";"-";"-";"-";"-";"-";"-";"-";"-";"-";"-";"-";"-";"-";"-";"-";"-";"-";"-";"-";"-";"-"
"25 Lip 2024 10:23:10";"Transakcja Sprzedaży";"O2-D3-94M9F2";"T2-D3-5HWCZN";"-";"Solana (USD)";"37 Jednost.";"169,430";"-";"172,823";"-";"-";"3,985074";"24 982,07";"0,00";"-";"-";"-";"-";"-";"-";"-";"-";"-";"-";"-";"-";"-";"-";"-";"-";"-";"-";"-";"-";"-";"-";"-";"-";"-"
"25 Lip 2024 10:22:15";"Odrzucono Zlecenie: brak wystarczających środków";"O2-D3-94M99Y";"-";"-";"Solana (USD)";"70 Jednost.";"-";"-";"-";"-";"-";"-";"-";"-";"-";"-";"-";"-";"-";"-";"-";"-";"-";"-";"-";"-";"-";"-";"-";"-";"-";"-";"-";"-";"-";"-";"-";"-";"-"
"25 Lip 2024 10:22:04";"Odrzucono Zlecenie: brak wystarczających środków";"O2-D3-94M996";"-";"-";"Solana (USD)";"75 Jednost.";"-";"-";"-";"-";"-";"-";"-";"-";"-";"-";"-";"-";"-";"-";"-";"-";"-";"-";"-";"-";"-";"-";"-";"-";"-";"-";"-";"-";"-";"-";"-";"-";"-"
"25 Lip 2024 08:48:30";" Zamknięcie Transakcji";"O2-D3-94LV62";"T2-D3-5HW2F7";"O2-CZ-93ZT4S";"Solana (USD)";"36 Jednost.";"171,365";"-";"-";"-";"-";"3,95013";"24 613,77";"1 225,09";"28 482,79";"-";"-";"-";"-";"-";"-";"-";"-";"-";"-";"-";"-";"-";"-";"-";"-";"-";"-";"-";"-";"-";"-";"-";"-"
"25 Lip 2024 08:46:25";"Odrzucono Zlecenie: brak wystarczających środków";"O2-D3-94LV00";"-";"-";"Solana (USD)";"36,96 Jednost.";"-";"-";"-";"-";"-";"-";"-";"-";"-";"-";"-";"-";"-";"-";"-";"-";"-";"-";"-";"-";"-";"-";"-";"-";"-";"-";"-";"-";"-";"-";"-";"-";"-"
"25 Lip 2024 03:21:57";"Take Profit";"O2-D3-94KLJQ";"T2-D3-5HVRHW";"-";"Solana (USD)";"75 Jednost.";"174,000";"-";"-";"-";"-";"3,94443";"51 992,00";"616,81";"27 257,70";"-";"-";"-";"-";"-";"-";"-";"-";"-";"-";"-";"-";"-";"-";"-";"-";"-";"-";"-";"-";"-";"-";"-";"-"
"25 Lip 2024 00:15:29";"Zmodyfikowano Transakcję Sprzedaży";"O2-D3-94KLJQ";"T2-D3-5HVN2M";"-";"Solana (USD)";"75 Jednost.";"176,085";"-";"-";"174,000";"-";"-";"-";"0,00";"-";"-";"-";"-";"-";"-";"-";"-";"-";"-";"-";"-";"-";"-";"-";"-";"-";"-";"-";"-";"-";"-";"-";"-";"-"
"25 Lip 2024 00:14:09";"Stop Loss";"O2-D3-94KNRJ";"T2-D3-5HVNG6";"-";"Solana (USD)";"73,41 Jednost.";"178,697";"-";"-";"-";"-";"3,94092";"52 217,11";"208,88";"26 640,89";"-";"-";"-";"-";"-";"-";"-";"-";"-";"-";"-";"-";"-";"-";"-";"-";"-";"-";"-";"-";"-";"-";"-";"-"
"25 Lip 2024 00:13:47";"Zmodyfikowano Stop Loss";"O2-D3-94KNRJ";"-";"O2-D3-94KP07";"Solana (USD)";"73,41 Jednost.";"177,975";"-";"178,700";"-";"-";"-";"-";"-";"-";"-";"-";"-";"-";"-";"-";"-";"-";"-";"-";"-";"-";"-";"-";"-";"-";"-";"-";"-";"-";"-";"-";"-";"-"
"25 Lip 2024 00:13:20";"Zmodyfikowano Stop Loss";"O2-D3-94KNRJ";"-";"O2-D3-94KP07";"Solana (USD)";"73,41 Jednost.";"177,975";"-";"178,300";"-";"-";"-";"-";"-";"-";"-";"-";"-";"-";"-";"-";"-";"-";"-";"-";"-";"-";"-";"-";"-";"-";"-";"-";"-";"-";"-";"-";"-";"-"
"25 Lip 2024 00:12:45";" Zmodyfikowano Transakcję Kupna";"O2-D3-94KNRJ";"T2-D3-5HVNDV";"-";"Solana (USD)";"73,41 Jednost.";"177,975";"-";"178,000";"-";"-";"-";"-";"0,00";"-";"-";"-";"-";"-";"-";"-";"-";"-";"-";"-";"-";"-";"-";"-";"-";"-";"-";"-";"-";"-";"-";"-";"-";"-"
"25 Lip 2024 00:09:56";" Zmodyfikowano Transakcję Kupna";"O2-D3-94KNRJ";"T2-D3-5HVNDV";"-";"Solana (USD)";"73,41 Jednost.";"177,975";"-";"-";"-";"-";"-";"-";"0,00";"-";"-";"-";"-";"-";"-";"-";"-";"-";"-";"-";"-";"-";"-";"-";"-";"-";"-";"-";"-";"-";"-";"-";"-";"-"
"25 Lip 2024 00:09:25";" Transakcja Kupna";"O2-D3-94KNRJ";"T2-D3-5HVNDV";"-";"Solana (USD)";"73,41 Jednost.";"177,975";"-";"174,416";"-";"-";"3,980174";"52 001,54";"0,00";"-";"-";"-";"-";"-";"-";"-";"-";"-";"-";"-";"-";"-";"-";"-";"-";"-";"-";"-";"-";"-";"-";"-";"-";"-"
"24 Lip 2024 23:32:47";"Zmodyfikowano Transakcję Sprzedaży";"O2-D3-94KLJQ";"T2-D3-5HVN2M";"-";"Solana (USD)";"75 Jednost.";"176,085";"-";"-";"-";"-";"-";"-";"0,00";"-";"-";"-";"-";"-";"-";"-";"-";"-";"-";"-";"-";"-";"-";"-";"-";"-";"-";"-";"-";"-";"-";"-";"-";"-"
"24 Lip 2024 23:32:11";"Transakcja Sprzedaży";"O2-D3-94KLJQ";"T2-D3-5HVN2M";"-";"Solana (USD)";"75 Jednost.";"176,085";"-";"179,625";"-";"-";"3,982839";"52 598,86";"0,00";"-";"-";"-";"-";"-";"-";"-";"-";"-";"-";"-";"-";"-";"-";"-";"-";"-";"-";"-";"-";"-";"-";"-";"-";"-"
"24 Lip 2024 23:19:20";" Zamknięcie Transakcji";"O2-D3-94KKTW";"T2-D3-5HVN25";"O2-D3-94KKQV";"Solana (USD)";"75 Jednost.";"177,814";"-";"-";"-";"-";"3,94326";"53 116,00";"4,44";"26 432,01";"-";"-";"-";"-";"-";"-";"-";"-";"-";"-";"-";"-";"-";"-";"-";"-";"-";"-";"-";"-";"-";"-";"-";"-"
"24 Lip 2024 23:17:45";"Zmodyfikowano Transakcję Sprzedaży";"O2-D3-94KKQV";"T2-D3-5HVN22";"-";"Solana (USD)";"75 Jednost.";"177,829";"-";"-";"-";"-";"-";"-";"0,00";"-";"-";"-";"-";"-";"-";"-";"-";"-";"-";"-";"-";"-";"-";"-";"-";"-";"-";"-";"-";"-";"-";"-";"-";"-"
"24 Lip 2024 23:17:32";"Transakcja Sprzedaży";"O2-D3-94KKQV";"T2-D3-5HVN22";"-";"Solana (USD)";"75 Jednost.";"177,829";"-";"181,378";"-";"-";"3,98299";"53 121,83";"0,00";"-";"-";"-";"-";"-";"-";"-";"-";"-";"-";"-";"-";"-";"-";"-";"-";"-";"-";"-";"-";"-";"-";"-";"-";"-"
"24 Lip 2024 23:16:40";" Zamknięcie Transakcji";"O2-D3-94KKPD";"T2-D3-5HVN21";"O2-D3-94KKM2";"Solana (USD)";"3,5 Jednost.";"178,205";"-";"-";"-";"-";"3,982839";"2 484,16";"-9,48";"26 427,57";"-";"-";"-";"-";"-";"-";"-";"-";"-";"-";"-";"-";"-";"-";"-";"-";"-";"-";"-";"-";"-";"-";"-";"-"
"24 Lip 2024 23:15:21";"Transakcja Sprzedaży";"O2-D3-94KKM2";"T2-D3-5HVN1Z";"-";"Solana (USD)";"3,5 Jednost.";"177,525";"-";"181,064";"-";"-";"3,982639";"2 474,56";"0,00";"-";"-";"-";"-";"-";"-";"-";"-";"-";"-";"-";"-";"-";"-";"-";"-";"-";"-";"-";"-";"-";"-";"-";"-";"-"
"24 Lip 2024 23:14:01";" Zamknięcie Transakcji";"O2-D3-94KKJS";"T2-D3-5HVN1W";"O2-D3-94KFJM";"Solana (USD)";"3,5 Jednost.";"177,690";"-";"-";"-";"-";"3,94301";"2 476,86";"7,04";"26 437,05";"-";"-";"-";"-";"-";"-";"-";"-";"-";"-";"-";"-";"-";"-";"-";"-";"-";"-";"-";"-";"-";"-";"-";"-"
"24 Lip 2024 23:13:53";" Zamknięcie Transakcji";"O2-D3-94KKJH";"T2-D3-5HVN1V";"O2-D3-94KFE7";"Solana (USD)";"72 Jednost.";"177,760";"-";"-";"-";"-";"3,94301";"50 972,68";"156,14";"26 430,01";"-";"-";"-";"-";"-";"-";"-";"-";"-";"-";"-";"-";"-";"-";"-";"-";"-";"-";"-";"-";"-";"-";"-";"-"
"24 Lip 2024 23:00:56";"Koszty Utrzymania Pozycji";"1357261932";"-";"-";"Rachunek";"-";"-";"-";"-";"-";"-";"-";"-";"-50,39";"26 273,87";"-";"-";"-";"-";"-";"-50,39";"-";"-";"-";"-";"-";"-";"-";"-";"-";"-";"-";"-";"-";"-";"-";"-";"-";"-"
"24 Lip 2024 23:00:56";"Koszty Utrzymania Pozycji";"O2-D3-94KFJM";"-";"-";"Solana (USD)";"-";"-";"-";"-";"-";"-";"-";"-";"-";"-";"-";"-";"630,24";"-10,00000%";"0,68";"0,68";"-";"-";"-";"-";"-";"-";"-";"-";"-";"-";"-";"-";"-";"-";"-";"-";"-";"-"
"24 Lip 2024 23:00:56";"Koszty Utrzymania Pozycji";"O2-D3-94KFE7";"-";"-";"Solana (USD)";"-";"-";"-";"-";"-";"-";"-";"-";"-";"-";"-";"-";"12 965,04";"-10,00000%";"14,01";"14,01";"-";"-";"-";"-";"-";"-";"-";"-";"-";"-";"-";"-";"-";"-";"-";"-";"-";"-"
"24 Lip 2024 23:00:56";"Koszty Utrzymania Pozycji";"O2-CZ-93ZT4S";"-";"-";"Solana (USD)";"-";"-";"-";"-";"-";"-";"-";"-";"-";"-";"-";"-";"6 482,52";"-27,50000%";"-19,46";"-19,46";"-";"-";"-";"-";"-";"-";"-";"-";"-";"-";"-";"-";"-";"-";"-";"-";"-";"-"
"24 Lip 2024 23:00:56";"Koszty Utrzymania Pozycji";"O2-D3-9484MP";"-";"-";"Solana (USD)";"-";"-";"-";"-";"-";"-";"-";"-";"-";"-";"-";"-";"7 420,68";"-27,50000%";"-22,27";"-22,27";"-";"-";"-";"-";"-";"-";"-";"-";"-";"-";"-";"-";"-";"-";"-";"-";"-";"-"
"24 Lip 2024 23:00:56";"Koszty Utrzymania Pozycji";"O2-CZ-93XJ1D";"-";"-";"Solana (USD)";"-";"-";"-";"-";"-";"-";"-";"-";"-";"-";"-";"-";"21 248,26";"-10,00000%";"22,96";"22,96";"-";"-";"-";"-";"-";"-";"-";"-";"-";"-";"-";"-";"-";"-";"-";"-";"-";"-"
"24 Lip 2024 23:00:56";"Koszty Utrzymania Pozycji";"O2-D3-94JY88";"-";"-";"Solana (USD)";"-";"-";"-";"-";"-";"-";"-";"-";"-";"-";"-";"-";"16 206,30";"-27,50000%";"-48,64";"-48,64";"-";"-";"-";"-";"-";"-";"-";"-";"-";"-";"-";"-";"-";"-";"-";"-";"-";"-"
"24 Lip 2024 23:00:56";"Koszty Utrzymania Pozycji";"O2-D3-946FM0";"-";"-";"Solana (USD)";"-";"-";"-";"-";"-";"-";"-";"-";"-";"-";"-";"-";"2 160,84";"-10,00000%";"2,33";"2,33";"-";"-";"-";"-";"-";"-";"-";"-";"-";"-";"-";"-";"-";"-";"-";"-";"-";"-"
"24 Lip 2024 22:44:07";"Zmodyfikowano Transakcję Sprzedaży";"O2-D3-94KFE7";"T2-D3-5HVM6J";"-";"Solana (USD)";"72 Jednost.";"178,310";"-";"-";"177,000";"-";"-";"-";"0,00";"-";"-";"-";"-";"-";"-";"-";"-";"-";"-";"-";"-";"-";"-";"-";"-";"-";"-";"-";"-";"-";"-";"-";"-";"-"
"24 Lip 2024 22:43:52";"Zmodyfikowano Transakcję Sprzedaży";"O2-D3-94KFJM";"T2-D3-5HVM8M";"-";"Solana (USD)";"3,5 Jednost.";"178,200";"-";"-";"177,000";"-";"-";"-";"0,00";"-";"-";"-";"-";"-";"-";"-";"-";"-";"-";"-";"-";"-";"-";"-";"-";"-";"-";"-";"-";"-";"-";"-";"-";"-"
"24 Lip 2024 22:15:54";"Zmodyfikowano Transakcję Sprzedaży";"O2-D3-94KFE7";"T2-D3-5HVM6J";"-";"Solana (USD)";"72 Jednost.";"178,310";"-";"-";"-";"-";"-";"-";"0,00";"-";"-";"-";"-";"-";"-";"-";"-";"-";"-";"-";"-";"-";"-";"-";"-";"-";"-";"-";"-";"-";"-";"-";"-";"-"
"24 Lip 2024 22:15:45";"Zmodyfikowano Transakcję Sprzedaży";"O2-D3-94KFJM";"T2-D3-5HVM8M";"-";"Solana (USD)";"3,5 Jednost.";"178,200";"-";"-";"-";"-";"-";"-";"0,00";"-";"-";"-";"-";"-";"-";"-";"-";"-";"-";"-";"-";"-";"-";"-";"-";"-";"-";"-";"-";"-";"-";"-";"-";"-"
"24 Lip 2024 22:15:33";"Transakcja Sprzedaży";"O2-D3-94KFJM";"T2-D3-5HVM8M";"-";"Solana (USD)";"3,5 Jednost.";"178,200";"-";"181,764";"-";"-";"3,985174";"2 485,55";"0,00";"-";"-";"-";"-";"-";"-";"-";"-";"-";"-";"-";"-";"-";"-";"-";"-";"-";"-";"-";"-";"-";"-";"-";"-";"-"
"24 Lip 2024 22:14:01";"Transakcja Sprzedaży";"O2-D3-94KFE7";"T2-D3-5HVM6J";"-";"Solana (USD)";"72 Jednost.";"178,310";"-";"181,876";"-";"-";"3,984944";"51 159,98";"0,00";"-";"-";"-";"-";"-";"-";"-";"-";"-";"-";"-";"-";"-";"-";"-";"-";"-";"-";"-";"-";"-";"-";"-";"-";"-"
"24 Lip 2024 22:00:21";"Stop Loss";"O2-D3-94K79V";"T2-D3-5HVLHE";"-";"Solana (USD)";"72 Jednost.";"178,400";"-";"-";"-";"-";"3,94585";"51 193,14";"122,16";"26 324,26";"-";"-";"-";"-";"-";"-";"-";"-";"-";"-";"-";"-";"-";"-";"-";"-";"-";"-";"-";"-";"-";"-";"-";"-"
"24 Lip 2024 21:56:46";"Zmodyfikowano Transakcję Sprzedaży";"O2-D3-94K79V";"T2-D3-5HVGV3";"-";"Solana (USD)";"72 Jednost.";"178,830";"-";"178,400";"-";"-";"-";"-";"0,00";"-";"-";"-";"-";"-";"-";"-";"-";"-";"-";"-";"-";"-";"-";"-";"-";"-";"-";"-";"-";"-";"-";"-";"-";"-"
"24 Lip 2024 21:17:23";"Zmodyfikowano Transakcję Sprzedaży";"O2-D3-94K79V";"T2-D3-5HVGV3";"-";"Solana (USD)";"72 Jednost.";"178,830";"-";"-";"-";"-";"-";"-";"0,00";"-";"-";"-";"-";"-";"-";"-";"-";"-";"-";"-";"-";"-";"-";"-";"-";"-";"-";"-";"-";"-";"-";"-";"-";"-"
"24 Lip 2024 21:17:07";"Transakcja Sprzedaży";"O2-D3-94K79V";"T2-D3-5HVGV3";"-";"Solana (USD)";"72 Jednost.";"178,830";"-";"182,406";"-";"-";"3,987168";"51 337,81";"0,00";"-";"-";"-";"-";"-";"-";"-";"-";"-";"-";"-";"-";"-";"-";"-";"-";"-";"-";"-";"-";"-";"-";"-";"-";"-"
"24 Lip 2024 20:59:56";"Stop Loss";"O2-D3-94K4EY";"T2-D3-5HVG02";"-";"Solana (USD)";"72 Jednost.";"177,810";"-";"-";"-";"-";"3,94679";"51 035,89";"234,44";"26 202,10";"-";"-";"-";"-";"-";"-";"-";"-";"-";"-";"-";"-";"-";"-";"-";"-";"-";"-";"-";"-";"-";"-";"-";"-"
"24 Lip 2024 20:59:49";"Zmodyfikowano Stop Loss";"O2-D3-94K4EY";"-";"O2-D3-94K4EZ";"Solana (USD)";"72 Jednost.";"178,635";"-";"177,800";"-";"-";"-";"-";"-";"-";"-";"-";"-";"-";"-";"-";"-";"-";"-";"-";"-";"-";"-";"-";"-";"-";"-";"-";"-";"-";"-";"-";"-";"-"
"24 Lip 2024 20:58:47";"Zmodyfikowano Stop Loss";"O2-D3-94K4EY";"-";"O2-D3-94K4EZ";"Solana (USD)";"72 Jednost.";"178,635";"-";"178,000";"-";"-";"-";"-";"-";"-";"-";"-";"-";"-";"-";"-";"-";"-";"-";"-";"-";"-";"-";"-";"-";"-";"-";"-";"-";"-";"-";"-";"-";"-"
"24 Lip 2024 20:49:17";"Transakcja Sprzedaży";"O2-D3-94K4EY";"T2-D3-5HVF8Q";"-";"Solana (USD)";"72 Jednost.";"178,635";"-";"182,202";"-";"-";"3,986166";"51 268,95";"0,00";"-";"-";"-";"-";"-";"-";"-";"-";"-";"-";"-";"-";"-";"-";"-";"-";"-";"-";"-";"-";"-";"-";"-";"-";"-"
"24 Lip 2024 20:45:46";"Stop Loss";"O2-D3-94K2XR";"T2-D3-5HVEXD";"-";"Solana (USD)";"72 Jednost.";"179,030";"-";"-";"-";"-";"3,94631";"51 379,86";"83,82";"25 967,66";"-";"-";"-";"-";"-";"-";"-";"-";"-";"-";"-";"-";"-";"-";"-";"-";"-";"-";"-";"-";"-";"-";"-";"-"
"24 Lip 2024 20:45:36";"Zmodyfikowano Transakcję Sprzedaży";"O2-D3-94K2XR";"T2-D3-5HVE4W";"-";"Solana (USD)";"72 Jednost.";"179,325";"-";"179,000";"-";"-";"-";"-";"0,00";"-";"-";"-";"-";"-";"-";"-";"-";"-";"-";"-";"-";"-";"-";"-";"-";"-";"-";"-";"-";"-";"-";"-";"-";"-"
"24 Lip 2024 20:34:52";"Zmodyfikowano Transakcję Sprzedaży";"O2-D3-94K2XR";"T2-D3-5HVE4W";"-";"Solana (USD)";"72 Jednost.";"179,325";"-";"-";"-";"-";"-";"-";"0,00";"-";"-";"-";"-";"-";"-";"-";"-";"-";"-";"-";"-";"-";"-";"-";"-";"-";"-";"-";"-";"-";"-";"-";"-";"-"
"24 Lip 2024 20:34:30";"Transakcja Sprzedaży";"O2-D3-94K2XR";"T2-D3-5HVE4W";"-";"Solana (USD)";"72 Jednost.";"179,325";"-";"182,921";"-";"-";"3,985154";"51 453,91";"0,00";"-";"-";"-";"-";"-";"-";"-";"-";"-";"-";"-";"-";"-";"-";"-";"-";"-";"-";"-";"-";"-";"-";"-";"-";"-"
"24 Lip 2024 20:27:30";" Zamknięcie Transakcji";"O2-D3-94K2CN";"T2-D3-5HVDVF";"O2-D3-94K190";"Solana (USD)";"72 Jednost.";"180,030";"-";"-";"-";"-";"3,94578";"51 659,97";"91,19";"25 883,84";"-";"-";"-";"-";"-";"-";"-";"-";"-";"-";"-";"-";"-";"-";"-";"-";"-";"-";"-";"-";"-";"-";"-";"-"
"24 Lip 2024 20:16:32";"Transakcja Sprzedaży";"O2-D3-94K190";"T2-D3-5HVD7G";"-";"Solana (USD)";"72 Jednost.";"180,351";"-";"-";"-";"-";"3,98327";"51 723,84";"0,00";"-";"-";"-";"-";"-";"-";"-";"-";"-";"-";"-";"-";"-";"-";"-";"-";"-";"-";"-";"-";"-";"-";"-";"-";"-"
"24 Lip 2024 20:11:12";" Zamknięcie Transakcji";"O2-D3-94K0TL";"T2-D3-5HVD0X";"O2-D3-94K0BE";"Solana (USD)";"72 Jednost.";"180,810";"-";"-";"-";"-";"3,94341";"51 852,48";"5,68";"25 792,65";"-";"-";"-";"-";"-";"-";"-";"-";"-";"-";"-";"-";"-";"-";"-";"-";"-";"-";"-";"-";"-";"-";"-";"-"
"24 Lip 2024 20:05:05";"Zmodyfikowano Transakcję Sprzedaży";"O2-D3-94K0BE";"T2-D3-5HVCS7";"-";"Solana (USD)";"72 Jednost.";"180,830";"-";"-";"-";"-";"-";"-";"0,00";"-";"-";"-";"-";"-";"-";"-";"-";"-";"-";"-";"-";"-";"-";"-";"-";"-";"-";"-";"-";"-";"-";"-";"-";"-"
"24 Lip 2024 20:04:55";" Zmodyfikowano Transakcję Kupna";"O2-D3-94JY88";"T2-D3-5HVBM3";"-";"Solana (USD)";"90 Jednost.";"182,315";"-";"-";"-";"-";"-";"-";"0,00";"-";"-";"-";"-";"-";"-";"-";"-";"-";"-";"-";"-";"-";"-";"-";"-";"-";"-";"-";"-";"-";"-";"-";"-";"-"
"24 Lip 2024 20:04:43";"Transakcja Sprzedaży";"O2-D3-94K0BE";"T2-D3-5HVCS7";"-";"Solana (USD)";"72 Jednost.";"180,830";"-";"184,450";"-";"-";"3,982889";"51 856,25";"0,00";"-";"-";"-";"-";"-";"-";"-";"-";"-";"-";"-";"-";"-";"-";"-";"-";"-";"-";"-";"-";"-";"-";"-";"-";"-"
"24 Lip 2024 20:03:39";"Odrzucono Zlecenie: brak wystarczających środków";"O2-D3-94K06X";"-";"-";"Solana (USD)";"69,31 Jednost.";"-";"-";"-";"-";"-";"-";"-";"-";"-";"-";"-";"-";"-";"-";"-";"-";"-";"-";"-";"-";"-";"-";"-";"-";"-";"-";"-";"-";"-";"-";"-";"-";"-"
"24 Lip 2024 20:03:19";"Odrzucono Zlecenie: brak wystarczających środków";"O2-D3-94K055";"-";"-";"Solana (USD)";"72,05 Jednost.";"-";"-";"-";"-";"-";"-";"-";"-";"-";"-";"-";"-";"-";"-";"-";"-";"-";"-";"-";"-";"-";"-";"-";"-";"-";"-";"-";"-";"-";"-";"-";"-";"-"
"24 Lip 2024 20:02:07";"Odrzucono Zlecenie: brak wystarczających środków";"O2-D3-94K007";"-";"-";"Solana (USD)";"88 Jednost.";"-";"-";"-";"-";"-";"-";"-";"-";"-";"-";"-";"-";"-";"-";"-";"-";"-";"-";"-";"-";"-";"-";"-";"-";"-";"-";"-";"-";"-";"-";"-";"-";"-"
"24 Lip 2024 20:01:11";"Odrzucono Zlecenie: brak wystarczających środków";"O2-D3-94JZWX";"-";"-";"Solana (USD)";"90 Jednost.";"-";"-";"-";"-";"-";"-";"-";"-";"-";"-";"-";"-";"-";"-";"-";"-";"-";"-";"-";"-";"-";"-";"-";"-";"-";"-";"-";"-";"-";"-";"-";"-";"-"
"24 Lip 2024 19:42:09";" Transakcja Kupna";"O2-D3-94JY88";"T2-D3-5HVBM3";"-";"Solana (USD)";"90 Jednost.";"182,315";"-";"178,660";"-";"-";"3,979964";"65 304,64";"0,00";"-";"-";"-";"-";"-";"-";"-";"-";"-";"-";"-";"-";"-";"-";"-";"-";"-";"-";"-";"-";"-";"-";"-";"-";"-"
"24 Lip 2024 18:55:12";" Zamknięcie Transakcji";"O2-D3-94JTG5";"T2-D3-5HV8MS";"O2-D3-94JT0D";"Solana (USD)";"90 Jednost.";"179,956";"-";"-";"-";"-";"3,94001";"64 453,97";"170,56";"25 786,97";"-";"-";"-";"-";"-";"-";"-";"-";"-";"-";"-";"-";"-";"-";"-";"-";"-";"-";"-";"-";"-";"-";"-";"-"
"24 Lip 2024 18:54:21";"Zmodyfikowano Stop Loss";"O2-D3-94JT0D";"-";"O2-D3-94JT0E";"Solana (USD)";"90 Jednost.";"179,475";"-";"179,000";"-";"-";"-";"-";"-";"-";"-";"-";"-";"-";"-";"-";"-";"-";"-";"-";"-";"-";"-";"-";"-";"-";"-";"-";"-";"-";"-";"-";"-";"-"
"24 Lip 2024 18:54:01";"Zmodyfikowano Stop Loss";"O2-D3-94JT0D";"-";"O2-D3-94JT0E";"Solana (USD)";"90 Jednost.";"179,475";"-";"179,950";"-";"-";"-";"-";"-";"-";"-";"-";"-";"-";"-";"-";"-";"-";"-";"-";"-";"-";"-";"-";"-";"-";"-";"-";"-";"-";"-";"-";"-";"-"
"24 Lip 2024 18:53:30";"Zmodyfikowano Stop Loss";"O2-D3-94JT0D";"-";"O2-D3-94JT0E";"Solana (USD)";"90 Jednost.";"179,475";"-";"179,750";"-";"-";"-";"-";"-";"-";"-";"-";"-";"-";"-";"-";"-";"-";"-";"-";"-";"-";"-";"-";"-";"-";"-";"-";"-";"-";"-";"-";"-";"-"
"24 Lip 2024 18:49:31";" Transakcja Kupna";"O2-D3-94JT0D";"T2-D3-5HV8ED";"-";"Solana (USD)";"90 Jednost.";"179,475";"-";"175,872";"-";"-";"3,979573";"64 281,04";"0,00";"-";"-";"-";"-";"-";"-";"-";"-";"-";"-";"-";"-";"-";"-";"-";"-";"-";"-";"-";"-";"-";"-";"-";"-";"-"
"24 Lip 2024 18:45:42";"Stop Loss";"O2-D3-94JPX0";"T2-D3-5HV867";"-";"Solana (USD)";"90 Jednost.";"178,343";"-";"-";"-";"-";"3,94035";"63 881,88";"31,21";"25 616,41";"-";"-";"-";"-";"-";"-";"-";"-";"-";"-";"-";"-";"-";"-";"-";"-";"-";"-";"-";"-";"-";"-";"-";"-"
"24 Lip 2024 18:41:00";"Zmodyfikowano Stop Loss";"O2-D3-94JPX0";"-";"O2-D3-94JPX1";"Solana (USD)";"90 Jednost.";"178,255";"-";"178,360";"-";"-";"-";"-";"-";"-";"-";"-";"-";"-";"-";"-";"-";"-";"-";"-";"-";"-";"-";"-";"-";"-";"-";"-";"-";"-";"-";"-";"-";"-"
"24 Lip 2024 18:16:15";" Transakcja Kupna";"O2-D3-94JPX0";"T2-D3-5HV6K3";"-";"Solana (USD)";"90 Jednost.";"178,255";"-";"174,681";"-";"-";"3,979433";"63 841,84";"0,00";"-";"-";"-";"-";"-";"-";"-";"-";"-";"-";"-";"-";"-";"-";"-";"-";"-";"-";"-";"-";"-";"-";"-";"-";"-"
"24 Lip 2024 17:08:38";" Zamknięcie Transakcji";"O2-D3-94JFL0";"T2-D3-5HV15N";"O2-D3-94J9C9";"Solana (USD)";"52,34 Jednost.";"180,385";"-";"-";"-";"-";"3,93565";"37 531,29";"86,10";"25 585,20";"-";"-";"-";"-";"-";"-";"-";"-";"-";"-";"-";"-";"-";"-";"-";"-";"-";"-";"-";"-";"-";"-";"-";"-"
"24 Lip 2024 17:08:29";" Zamknięcie Transakcji";"O2-D3-94JFJZ";"T2-D3-5HV150";"O2-D3-94J9G5";"Solana (USD)";"38,33 Jednost.";"180,525";"-";"-";"-";"-";"3,93605";"27 509,29";"83,73";"25 499,10";"-";"-";"-";"-";"-";"-";"-";"-";"-";"-";"-";"-";"-";"-";"-";"-";"-";"-";"-";"-";"-";"-";"-";"-"
"24 Lip 2024 16:34:22";" Zmodyfikowano Transakcję Kupna";"O2-D3-94J9C9";"T2-D3-5HTXJ1";"-";"Solana (USD)";"52,34 Jednost.";"179,967";"-";"-";"-";"-";"-";"-";"0,00";"-";"-";"-";"-";"-";"-";"-";"-";"-";"-";"-";"-";"-";"-";"-";"-";"-";"-";"-";"-";"-";"-";"-";"-";"-"
"24 Lip 2024 16:34:14";" Zmodyfikowano Transakcję Kupna";"O2-D3-94J9G5";"T2-D3-5HTXLF";"-";"Solana (USD)";"38,33 Jednost.";"179,970";"-";"-";"-";"-";"-";"-";"0,00";"-";"-";"-";"-";"-";"-";"-";"-";"-";"-";"-";"-";"-";"-";"-";"-";"-";"-";"-";"-";"-";"-";"-";"-";"-"
"24 Lip 2024 16:33:26";" Transakcja Kupna";"O2-D3-94J9G5";"T2-D3-5HTXLF";"-";"Solana (USD)";"38,33 Jednost.";"179,970";"-";"176,386";"-";"-";"3,971627";"27 397,27";"0,00";"-";"-";"-";"-";"-";"-";"-";"-";"-";"-";"-";"-";"-";"-";"-";"-";"-";"-";"-";"-";"-";"-";"-";"-";"-"
"24 Lip 2024 16:32:32";" Transakcja Kupna";"O2-D3-94J9C9";"T2-D3-5HTXJ1";"-";"Solana (USD)";"52,34 Jednost.";"179,967";"-";"176,351";"-";"-";"3,971056";"37 405,25";"0,00";"-";"-";"-";"-";"-";"-";"-";"-";"-";"-";"-";"-";"-";"-";"-";"-";"-";"-";"-";"-";"-";"-";"-";"-";"-"
"23 Lip 2024 23:00:55";"Koszty Utrzymania Pozycji";"1356824372";"-";"-";"Rachunek";"-";"-";"-";"-";"-";"-";"-";"-";"-15,77";"25 415,37";"-";"-";"-";"-";"-";"-15,77";"-";"-";"-";"-";"-";"-";"-";"-";"-";"-";"-";"-";"-";"-";"-";"-";"-";"-"
"23 Lip 2024 23:00:55";"Koszty Utrzymania Pozycji";"O2-CZ-93ZT4S";"-";"-";"Solana (USD)";"-";"-";"-";"-";"-";"-";"-";"-";"-";"-";"-";"-";"6 258,78";"-27,50000%";"-18,67";"-18,67";"-";"-";"-";"-";"-";"-";"-";"-";"-";"-";"-";"-";"-";"-";"-";"-";"-";"-"
"23 Lip 2024 23:00:55";"Koszty Utrzymania Pozycji";"O2-D3-9484MP";"-";"-";"Solana (USD)";"-";"-";"-";"-";"-";"-";"-";"-";"-";"-";"-";"-";"7 164,56";"-27,50000%";"-21,38";"-21,38";"-";"-";"-";"-";"-";"-";"-";"-";"-";"-";"-";"-";"-";"-";"-";"-";"-";"-"
"23 Lip 2024 23:00:55";"Koszty Utrzymania Pozycji";"O2-CZ-93XJ1D";"-";"-";"Solana (USD)";"-";"-";"-";"-";"-";"-";"-";"-";"-";"-";"-";"-";"20 514,89";"-10,00000%";"22,04";"22,04";"-";"-";"-";"-";"-";"-";"-";"-";"-";"-";"-";"-";"-";"-";"-";"-";"-";"-"
"23 Lip 2024 23:00:55";"Koszty Utrzymania Pozycji";"O2-D3-946FM0";"-";"-";"Solana (USD)";"-";"-";"-";"-";"-";"-";"-";"-";"-";"-";"-";"-";"2 086,26";"-10,00000%";"2,24";"2,24";"-";"-";"-";"-";"-";"-";"-";"-";"-";"-";"-";"-";"-";"-";"-";"-";"-";"-"
"23 Lip 2024 10:30:07";"Stop Loss";"O2-D3-94DL2Y";"T2-D3-5HRHPH";"-";"Solana (USD)";"91,59 Jednost.";"176,570";"-";"-";"-";"-";"3,9167";"63 977,52";"30,49";"25 431,14";"-";"-";"-";"-";"-";"-";"-";"-";"-";"-";"-";"-";"-";"-";"-";"-";"-";"-";"-";"-";"-";"-";"-";"-"
"23 Lip 2024 10:28:17";"Zmodyfikowano Stop Loss";"O2-D3-94DL2Y";"-";"O2-D3-94DL2Z";"Solana (USD)";"91,59 Jednost.";"176,485";"-";"176,600";"-";"-";"-";"-";"-";"-";"-";"-";"-";"-";"-";"-";"-";"-";"-";"-";"-";"-";"-";"-";"-";"-";"-";"-";"-";"-";"-";"-";"-";"-"
"23 Lip 2024 10:02:47";" Transakcja Kupna";"O2-D3-94DL2Y";"T2-D3-5HRGCB";"-";"Solana (USD)";"91,59 Jednost.";"176,485";"-";"172,956";"-";"-";"3,960084";"64 011,83";"0,00";"-";"-";"-";"-";"-";"-";"-";"-";"-";"-";"-";"-";"-";"-";"-";"-";"-";"-";"-";"-";"-";"-";"-";"-";"-"
"22 Lip 2024 23:00:53";"Koszty Utrzymania Pozycji";"1356440134";"-";"-";"Rachunek";"-";"-";"-";"-";"-";"-";"-";"-";"-16,51";"25 400,65";"-";"-";"-";"-";"-";"-16,51";"-";"-";"-";"-";"-";"-";"-";"-";"-";"-";"-";"-";"-";"-";"-";"-";"-";"-"
"22 Lip 2024 23:00:53";"Koszty Utrzymania Pozycji";"O2-CZ-93ZT4S";"-";"-";"Solana (USD)";"-";"-";"-";"-";"-";"-";"-";"-";"-";"-";"-";"-";"6 572,59";"-27,50000%";"-19,55";"-19,55";"-";"-";"-";"-";"-";"-";"-";"-";"-";"-";"-";"-";"-";"-";"-";"-";"-";"-"
"22 Lip 2024 23:00:53";"Koszty Utrzymania Pozycji";"O2-D3-9484MP";"-";"-";"Solana (USD)";"-";"-";"-";"-";"-";"-";"-";"-";"-";"-";"-";"-";"7 523,79";"-27,50000%";"-22,38";"-22,38";"-";"-";"-";"-";"-";"-";"-";"-";"-";"-";"-";"-";"-";"-";"-";"-";"-";"-"
"22 Lip 2024 23:00:53";"Koszty Utrzymania Pozycji";"O2-CZ-93XJ1D";"-";"-";"Solana (USD)";"-";"-";"-";"-";"-";"-";"-";"-";"-";"-";"-";"-";"21 543,49";"-10,00000%";"23,07";"23,07";"-";"-";"-";"-";"-";"-";"-";"-";"-";"-";"-";"-";"-";"-";"-";"-";"-";"-"
"22 Lip 2024 23:00:53";"Koszty Utrzymania Pozycji";"O2-D3-946FM0";"-";"-";"Solana (USD)";"-";"-";"-";"-";"-";"-";"-";"-";"-";"-";"-";"-";"2 190,86";"-10,00000%";"2,35";"2,35";"-";"-";"-";"-";"-";"-";"-";"-";"-";"-";"-";"-";"-";"-";"-";"-";"-";"-"
"22 Lip 2024 21:40:29";" Zamknięcie Transakcji";"O2-D3-94C9DM";"T2-D3-5HR26E";"O2-D3-94C297";"Solana (USD)";"69,33 Jednost.";"182,380";"-";"-";"-";"-";"3,950335";"49 949,63";"-60,25";"25 417,16";"-";"-";"-";"-";"-";"-";"-";"-";"-";"-";"-";"-";"-";"-";"-";"-";"-";"-";"-";"-";"-";"-";"-";"-"
"22 Lip 2024 20:05:21";" Transakcja Kupna";"O2-D3-94C297";"T2-D3-5HQYYD";"-";"Solana (USD)";"69,33 Jednost.";"182,600";"-";"178,939";"-";"-";"3,950024";"50 005,95";"0,00";"-";"-";"-";"-";"-";"-";"-";"-";"-";"-";"-";"-";"-";"-";"-";"-";"-";"-";"-";"-";"-";"-";"-";"-";"-"
"22 Lip 2024 19:20:08";"Stop Loss";"O2-D3-94BXZF";"T2-D3-5HQXFQ";"-";"Solana (USD)";"42,31 Jednost.";"180,100";"-";"-";"-";"-";"3,91072";"30 099,30";"98,45";"25 477,41";"-";"-";"-";"-";"-";"-";"-";"-";"-";"-";"-";"-";"-";"-";"-";"-";"-";"-";"-";"-";"-";"-";"-";"-"
"22 Lip 2024 19:20:06";"Zmodyfikowano Stop Loss";"O2-D3-94BXZF";"-";"O2-D3-94BXZG";"Solana (USD)";"42,31 Jednost.";"179,505";"-";"180,100";"-";"-";"-";"-";"-";"-";"-";"-";"-";"-";"-";"-";"-";"-";"-";"-";"-";"-";"-";"-";"-";"-";"-";"-";"-";"-";"-";"-";"-";"-"
"22 Lip 2024 19:19:37";"Zmodyfikowano Stop Loss";"O2-D3-94BXZF";"-";"O2-D3-94BXZG";"Solana (USD)";"42,31 Jednost.";"179,505";"-";"180,000";"-";"-";"-";"-";"-";"-";"-";"-";"-";"-";"-";"-";"-";"-";"-";"-";"-";"-";"-";"-";"-";"-";"-";"-";"-";"-";"-";"-";"-";"-"
"22 Lip 2024 19:19:05";"Zmodyfikowano Stop Loss";"O2-D3-94BXZF";"-";"O2-D3-94BXZG";"Solana (USD)";"42,31 Jednost.";"179,505";"-";"179,900";"-";"-";"-";"-";"-";"-";"-";"-";"-";"-";"-";"-";"-";"-";"-";"-";"-";"-";"-";"-";"-";"-";"-";"-";"-";"-";"-";"-";"-";"-"
"22 Lip 2024 19:18:27";"Zmodyfikowano Stop Loss";"O2-D3-94BXZF";"-";"O2-D3-94BXZG";"Solana (USD)";"42,31 Jednost.";"179,505";"-";"179,850";"-";"-";"-";"-";"-";"-";"-";"-";"-";"-";"-";"-";"-";"-";"-";"-";"-";"-";"-";"-";"-";"-";"-";"-";"-";"-";"-";"-";"-";"-"
"22 Lip 2024 19:07:58";" Transakcja Kupna";"O2-D3-94BXZF";"T2-D3-5HQWYG";"-";"Solana (USD)";"42,31 Jednost.";"179,505";"-";"175,915";"-";"-";"3,950074";"30 000,24";"0,00";"-";"-";"-";"-";"-";"-";"-";"-";"-";"-";"-";"-";"-";"-";"-";"-";"-";"-";"-";"-";"-";"-";"-";"-";"-"
"22 Lip 2024 10:28:38";" Zamknięcie Transakcji";"O2-D3-9499HK";"T2-D3-5HPXV7";"O2-CZ-93ZT4S";"Solana (USD)";"4 Jednost.";"178,500";"-";"-";"-";"-";"3,91306";"2 822,00";"246,52";"25 378,96";"-";"-";"-";"-";"-";"-";"-";"-";"-";"-";"-";"-";"-";"-";"-";"-";"-";"-";"-";"-";"-";"-";"-";"-"
"22 Lip 2024 10:27:01";" Zamknięcie Transakcji";"O2-D3-9499DX";"T2-D3-5HPXT8";"O2-CZ-93ZT4S";"Solana (USD)";"4 Jednost.";"178,585";"-";"-";"-";"-";"3,91358";"2 823,71";"247,89";"25 132,44";"-";"-";"-";"-";"-";"-";"-";"-";"-";"-";"-";"-";"-";"-";"-";"-";"-";"-";"-";"-";"-";"-";"-";"-"
"22 Lip 2024 10:03:06";" Zamknięcie Transakcji";"O2-D3-9497GC";"T2-D3-5HPWX3";"O2-CZ-94092B";"Solana (USD)";"4 Jednost.";"178,330";"-";"-";"-";"-";"3,91477";"2 820,55";"253,76";"24 884,55";"-";"-";"-";"-";"-";"-";"-";"-";"-";"-";"-";"-";"-";"-";"-";"-";"-";"-";"-";"-";"-";"-";"-";"-"
"22 Lip 2024 09:59:39";" Zamknięcie Transakcji";"O2-D3-949769";"T2-D3-5HPWQV";"O2-CZ-94092B";"Solana (USD)";"2 Jednost.";"178,371";"-";"-";"-";"-";"3,91241";"1 409,74";"127,12";"24 630,79";"-";"-";"-";"-";"-";"-";"-";"-";"-";"-";"-";"-";"-";"-";"-";"-";"-";"-";"-";"-";"-";"-";"-";"-"
"22 Lip 2024 09:59:08";" Zamknięcie Transakcji";"O2-D3-949752";"T2-D3-5HPWQ9";"O2-CZ-94092B";"Solana (USD)";"2 Jednost.";"178,355";"-";"-";"-";"-";"3,91287";"1 409,78";"127,01";"24 503,67";"-";"-";"-";"-";"-";"-";"-";"-";"-";"-";"-";"-";"-";"-";"-";"-";"-";"-";"-";"-";"-";"-";"-";"-"
"22 Lip 2024 00:59:45";" Zmodyfikowano Transakcję Kupna";"O2-D3-9484MP";"T2-D3-5HPG8B";"-";"Solana (USD)";"41,21 Jednost.";"184,086";"-";"-";"-";"-";"-";"-";"0,00";"-";"-";"-";"-";"-";"-";"-";"-";"-";"-";"-";"-";"-";"-";"-";"-";"-";"-";"-";"-";"-";"-";"-";"-";"-"
"22 Lip 2024 00:58:32";" Zamknięcie Transakcji";"O2-D3-9485FP";"T2-D3-5HPGJ4";"O2-CZ-94092B";"Solana (USD)";"2 Jednost.";"183,825";"-";"-";"-";"-";"3,91436";"1 453,57";"169,88";"24 376,66";"-";"-";"-";"-";"-";"-";"-";"-";"-";"-";"-";"-";"-";"-";"-";"-";"-";"-";"-";"-";"-";"-";"-";"-"
"22 Lip 2024 00:57:29";" Zamknięcie Transakcji";"O2-D3-9485DP";"T2-D3-5HPGHE";"O2-CZ-94092B";"Solana (USD)";"2 Jednost.";"183,815";"-";"-";"-";"-";"3,91451";"1 453,55";"169,81";"24 206,78";"-";"-";"-";"-";"-";"-";"-";"-";"-";"-";"-";"-";"-";"-";"-";"-";"-";"-";"-";"-";"-";"-";"-";"-"
"22 Lip 2024 00:56:53";" Zamknięcie Transakcji";"O2-D3-9485CW";"T2-D3-5HPGH6";"O2-CZ-94092B";"Solana (USD)";"2 Jednost.";"183,850";"-";"-";"-";"-";"3,91441";"1 453,79";"170,08";"24 036,97";"-";"-";"-";"-";"-";"-";"-";"-";"-";"-";"-";"-";"-";"-";"-";"-";"-";"-";"-";"-";"-";"-";"-";"-"
"22 Lip 2024 00:55:49";" Zamknięcie Transakcji";"O2-D3-9485B2";"T2-D3-5HPGGR";"O2-CZ-94092B";"Solana (USD)";"2 Jednost.";"183,875";"-";"-";"-";"-";"3,91436";"1 453,96";"170,27";"23 866,89";"-";"-";"-";"-";"-";"-";"-";"-";"-";"-";"-";"-";"-";"-";"-";"-";"-";"-";"-";"-";"-";"-";"-";"-"
"22 Lip 2024 00:44:21";" Transakcja Kupna";"O2-D3-9484MP";"T2-D3-5HPG8B";"-";"Solana (USD)";"41,21 Jednost.";"184,086";"-";"180,405";"-";"-";"3,954242";"29 997,60";"0,00";"-";"-";"-";"-";"-";"-";"-";"-";"-";"-";"-";"-";"-";"-";"-";"-";"-";"-";"-";"-";"-";"-";"-";"-";"-"
"19 Lip 2024 23:00:57";"Koszty Utrzymania Pozycji";"1356045454";"-";"-";"Rachunek";"-";"-";"-";"-";"-";"-";"-";"-";"-20,15";"23 696,62";"-";"-";"-";"-";"-";"-20,15";"-";"-";"-";"-";"-";"-";"-";"-";"-";"-";"-";"-";"-";"-";"-";"-";"-";"-"
"19 Lip 2024 23:00:57";"Koszty Utrzymania Pozycji";"O2-CZ-93XJ1D";"-";"-";"Solana (USD)";"-";"-";"-";"-";"-";"-";"-";"-";"-";"-";"-";"-";"20 128,44";"-10,00000%";"64,83";"64,83";"-";"-";"-";"-";"-";"-";"-";"-";"-";"-";"-";"-";"-";"-";"-";"-";"-";"-"
"19 Lip 2024 23:00:57";"Koszty Utrzymania Pozycji";"O2-CZ-94092B";"-";"-";"Solana (USD)";"-";"-";"-";"-";"-";"-";"-";"-";"-";"-";"-";"-";"2 729,28";"-27,50000%";"-24,42";"-24,42";"-";"-";"-";"-";"-";"-";"-";"-";"-";"-";"-";"-";"-";"-";"-";"-";"-";"-"
"19 Lip 2024 23:00:57";"Koszty Utrzymania Pozycji";"O2-D3-946FM0";"-";"-";"Solana (USD)";"-";"-";"-";"-";"-";"-";"-";"-";"-";"-";"-";"-";"2 046,96";"-10,00000%";"6,59";"6,59";"-";"-";"-";"-";"-";"-";"-";"-";"-";"-";"-";"-";"-";"-";"-";"-";"-";"-"
"19 Lip 2024 23:00:57";"Koszty Utrzymania Pozycji";"O2-CZ-93ZT4S";"-";"-";"Solana (USD)";"-";"-";"-";"-";"-";"-";"-";"-";"-";"-";"-";"-";"7 505,52";"-27,50000%";"-67,15";"-67,15";"-";"-";"-";"-";"-";"-";"-";"-";"-";"-";"-";"-";"-";"-";"-";"-";"-";"-"
"19 Lip 2024 15:35:00";" Zamknięcie Transakcji";"O2-D3-946HEC";"T2-D3-5HNKSK";"O2-CZ-94092B";"Solana (USD)";"10 Jednost.";"163,165";"-";"-";"-";"-";"3,91603";"6 453,82";"40,73";"23 716,77";"-";"-";"-";"-";"-";"-";"-";"-";"-";"-";"-";"-";"-";"-";"-";"-";"-";"-";"-";"-";"-";"-";"-";"-"
"19 Lip 2024 15:26:24";"Transakcja Sprzedaży";"O2-D3-946FM0";"T2-D3-5HNJC9";"-";"Solana (USD)";"12 Jednost.";"162,720";"-";"-";"-";"-";"3,953791";"7 720,33";"0,00";"-";"-";"-";"-";"-";"-";"-";"-";"-";"-";"-";"-";"-";"-";"-";"-";"-";"-";"-";"-";"-";"-";"-";"-";"-"
"19 Lip 2024 14:30:39";"Take Profit";"O2-CZ-93ZRSQ";"T2-D3-5HNFM0";"-";"Solana (USD)";"119 Jednost.";"163,300";"-";"-";"-";"-";"3,91574";"76 858,34";"104,84";"23 676,04";"-";"-";"-";"-";"-";"-";"-";"-";"-";"-";"-";"-";"-";"-";"-";"-";"-";"-";"-";"-";"-";"-";"-";"-"
"18 Lip 2024 23:00:55";"Koszty Utrzymania Pozycji";"1355666638";"-";"-";"Rachunek";"-";"-";"-";"-";"-";"-";"-";"-";"-69,03";"23 571,20";"-";"-";"-";"-";"-";"-69,03";"-";"-";"-";"-";"-";"-";"-";"-";"-";"-";"-";"-";"-";"-";"-";"-";"-";"-"
"18 Lip 2024 23:00:55";"Koszty Utrzymania Pozycji";"O2-CZ-93XJ1D";"-";"-";"Solana (USD)";"-";"-";"-";"-";"-";"-";"-";"-";"-";"-";"-";"-";"18 638,10";"-10,00000%";"20,01";"20,01";"-";"-";"-";"-";"-";"-";"-";"-";"-";"-";"-";"-";"-";"-";"-";"-";"-";"-"
"18 Lip 2024 23:00:55";"Koszty Utrzymania Pozycji";"O2-CZ-93ZT4S";"-";"-";"Solana (USD)";"-";"-";"-";"-";"-";"-";"-";"-";"-";"-";"-";"-";"6 949,80";"-27,50000%";"-20,73";"-20,73";"-";"-";"-";"-";"-";"-";"-";"-";"-";"-";"-";"-";"-";"-";"-";"-";"-";"-"
"18 Lip 2024 23:00:55";"Koszty Utrzymania Pozycji";"O2-CZ-94092B";"-";"-";"Solana (USD)";"-";"-";"-";"-";"-";"-";"-";"-";"-";"-";"-";"-";"4 106,70";"-27,50000%";"-12,25";"-12,25";"-";"-";"-";"-";"-";"-";"-";"-";"-";"-";"-";"-";"-";"-";"-";"-";"-";"-"
"18 Lip 2024 23:00:55";"Koszty Utrzymania Pozycji";"O2-CZ-93ZRSQ";"-";"-";"Solana (USD)";"-";"-";"-";"-";"-";"-";"-";"-";"-";"-";"-";"-";"18 796,05";"-27,50000%";"-56,06";"-56,06";"-";"-";"-";"-";"-";"-";"-";"-";"-";"-";"-";"-";"-";"-";"-";"-";"-";"-"
"18 Lip 2024 15:18:44";"Zmodyfikowano Take Profit";"O2-CZ-93ZRSQ";"-";"O2-CZ-943FHX";"Solana (USD)";"119 Jednost.";"163,075";"-";"-";"163,300";"-";"-";"-";"-";"-";"-";"-";"-";"-";"-";"-";"-";"-";"-";"-";"-";"-";"-";"-";"-";"-";"-";"-";"-";"-";"-";"-";"-";"-"
"18 Lip 2024 15:13:33";"Zmodyfikowano Take Profit";"O2-CZ-93ZRSQ";"-";"O2-CZ-943FHX";"Solana (USD)";"119 Jednost.";"163,075";"-";"-";"163,500";"-";"-";"-";"-";"-";"-";"-";"-";"-";"-";"-";"-";"-";"-";"-";"-";"-";"-";"-";"-";"-";"-";"-";"-";"-";"-";"-";"-";"-"
"18 Lip 2024 15:12:14";" Zmodyfikowano Transakcję Kupna";"O2-CZ-93ZRSQ";"T2-CZ-5HJSBP";"-";"Solana (USD)";"119 Jednost.";"163,075";"-";"-";"165,000";"-";"-";"-";"0,00";"-";"-";"-";"-";"-";"-";"-";"-";"-";"-";"-";"-";"-";"-";"-";"-";"-";"-";"-";"-";"-";"-";"-";"-";"-"
"17 Lip 2024 23:00:52";"Koszty Utrzymania Pozycji";"1355234731";"-";"-";"Rachunek";"-";"-";"-";"-";"-";"-";"-";"-";"-67,97";"23 640,23";"-";"-";"-";"-";"-";"-67,97";"-";"-";"-";"-";"-";"-";"-";"-";"-";"-";"-";"-";"-";"-";"-";"-";"-";"-"
"17 Lip 2024 23:00:52";"Koszty Utrzymania Pozycji";"O2-CZ-93XJ1D";"-";"-";"Solana (USD)";"-";"-";"-";"-";"-";"-";"-";"-";"-";"-";"-";"-";"18 432,78";"-10,00000%";"19,71";"19,71";"-";"-";"-";"-";"-";"-";"-";"-";"-";"-";"-";"-";"-";"-";"-";"-";"-";"-"
"17 Lip 2024 23:00:52";"Koszty Utrzymania Pozycji";"O2-CZ-93ZT4S";"-";"-";"Solana (USD)";"-";"-";"-";"-";"-";"-";"-";"-";"-";"-";"-";"-";"6 873,24";"-27,50000%";"-20,41";"-20,41";"-";"-";"-";"-";"-";"-";"-";"-";"-";"-";"-";"-";"-";"-";"-";"-";"-";"-"
"17 Lip 2024 23:00:52";"Koszty Utrzymania Pozycji";"O2-CZ-94092B";"-";"-";"Solana (USD)";"-";"-";"-";"-";"-";"-";"-";"-";"-";"-";"-";"-";"4 061,46";"-27,50000%";"-12,06";"-12,06";"-";"-";"-";"-";"-";"-";"-";"-";"-";"-";"-";"-";"-";"-";"-";"-";"-";"-"
"17 Lip 2024 23:00:52";"Koszty Utrzymania Pozycji";"O2-CZ-93ZRSQ";"-";"-";"Solana (USD)";"-";"-";"-";"-";"-";"-";"-";"-";"-";"-";"-";"-";"18 588,99";"-27,50000%";"-55,21";"-55,21";"-";"-";"-";"-";"-";"-";"-";"-";"-";"-";"-";"-";"-";"-";"-";"-";"-";"-"
"17 Lip 2024 19:10:39";" Zamknięcie Transakcji";"O2-CZ-940WJB";"T2-CZ-5HKS2Y";"O2-CZ-93XJ1D";"Solana (USD)";"5 Jednost.";"156,035";"-";"-";"-";"-";"3,951978";"3 083,23";"-46,34";"23 708,20";"-";"-";"-";"-";"-";"-";"-";"-";"-";"-";"-";"-";"-";"-";"-";"-";"-";"-";"-";"-";"-";"-";"-";"-"
"17 Lip 2024 19:09:13";" Zamknięcie Transakcji";"O2-CZ-940WF1";"T2-CZ-5HKRYW";"O2-CZ-93XJ1D";"Solana (USD)";"10 Jednost.";"156,180";"-";"-";"-";"-";"3,951116";"6 170,85";"-98,38";"23 754,54";"-";"-";"-";"-";"-";"-";"-";"-";"-";"-";"-";"-";"-";"-";"-";"-";"-";"-";"-";"-";"-";"-";"-";"-"
"17 Lip 2024 19:04:54";" Zamknięcie Transakcji";"O2-CZ-940W4Y";"T2-CZ-5HKRPL";"O2-CZ-940VWQ";"Solana (USD)";"113 Jednost.";"156,607";"-";"-";"-";"-";"3,951797";"69 933,33";"-440,75";"23 852,92";"-";"-";"-";"-";"-";"-";"-";"-";"-";"-";"-";"-";"-";"-";"-";"-";"-";"-";"-";"-";"-";"-";"-";"-"
"17 Lip 2024 19:01:06";"Transakcja Sprzedaży";"O2-CZ-940VWQ";"T2-CZ-5HKRH8";"-";"Solana (USD)";"113 Jednost.";"155,620";"-";"158,727";"-";"-";"3,951727";"69 491,35";"0,00";"-";"-";"-";"-";"-";"-";"-";"-";"-";"-";"-";"-";"-";"-";"-";"-";"-";"-";"-";"-";"-";"-";"-";"-";"-"
"17 Lip 2024 18:51:14";" Zamknięcie Transakcji";"O2-CZ-940V4D";"T2-CZ-5HKQTW";"O2-CZ-940TKP";"Solana (USD)";"113 Jednost.";"155,105";"-";"-";"-";"-";"3,91325";"69 276,14";"8,84";"24 293,67";"-";"-";"-";"-";"-";"-";"-";"-";"-";"-";"-";"-";"-";"-";"-";"-";"-";"-";"-";"-";"-";"-";"-";"-"
"17 Lip 2024 18:42:59";"Transakcja Sprzedaży";"O2-CZ-940TKP";"T2-CZ-5HKQBX";"-";"Solana (USD)";"113 Jednost.";"155,125";"-";"158,227";"-";"-";"3,952038";"69 275,76";"0,00";"-";"-";"-";"-";"-";"-";"-";"-";"-";"-";"-";"-";"-";"-";"-";"-";"-";"-";"-";"-";"-";"-";"-";"-";"-"
"17 Lip 2024 18:35:00";" Zamknięcie Transakcji";"O2-CZ-940T0C";"T2-CZ-5HKPT2";"O2-CZ-940S5R";"Solana (USD)";"113 Jednost.";"155,770";"-";"-";"-";"-";"3,91351";"69 577,91";"19,90";"24 284,83";"-";"-";"-";"-";"-";"-";"-";"-";"-";"-";"-";"-";"-";"-";"-";"-";"-";"-";"-";"-";"-";"-";"-";"-"
"17 Lip 2024 18:33:07";"Zmodyfikowano Transakcję Sprzedaży";"O2-CZ-940S5R";"T2-CZ-5HKP2K";"-";"Solana (USD)";"113 Jednost.";"155,815";"-";"-";"-";"-";"-";"-";"0,00";"-";"-";"-";"-";"-";"-";"-";"-";"-";"-";"-";"-";"-";"-";"-";"-";"-";"-";"-";"-";"-";"-";"-";"-";"-"
"17 Lip 2024 18:25:12";"Transakcja Sprzedaży";"O2-CZ-940S5R";"T2-CZ-5HKP2K";"-";"Solana (USD)";"113 Jednost.";"155,815";"-";"158,967";"-";"-";"3,95326";"69 605,42";"0,00";"-";"-";"-";"-";"-";"-";"-";"-";"-";"-";"-";"-";"-";"-";"-";"-";"-";"-";"-";"-";"-";"-";"-";"-";"-"
"17 Lip 2024 18:20:19";" Zamknięcie Transakcji";"O2-CZ-940RSH";"T2-CZ-5HKNPT";"O2-CZ-940QXJ";"Solana (USD)";"110 Jednost.";"156,750";"-";"-";"-";"-";"3,91304";"68 148,72";"256,11";"24 264,93";"-";"-";"-";"-";"-";"-";"-";"-";"-";"-";"-";"-";"-";"-";"-";"-";"-";"-";"-";"-";"-";"-";"-";"-"
"17 Lip 2024 18:11:55";"Zmodyfikowano Transakcję Sprzedaży";"O2-CZ-940QXJ";"T2-CZ-5HKMX1";"-";"Solana (USD)";"110 Jednost.";"157,345";"-";"-";"-";"-";"-";"-";"0,00";"-";"-";"-";"-";"-";"-";"-";"-";"-";"-";"-";"-";"-";"-";"-";"-";"-";"-";"-";"-";"-";"-";"-";"-";"-"
"17 Lip 2024 18:11:25";"Transakcja Sprzedaży";"O2-CZ-940QXJ";"T2-CZ-5HKMX1";"-";"Solana (USD)";"110 Jednost.";"157,345";"-";"160,491";"-";"-";"3,951457";"68 391,62";"0,00";"-";"-";"-";"-";"-";"-";"-";"-";"-";"-";"-";"-";"-";"-";"-";"-";"-";"-";"-";"-";"-";"-";"-";"-";"-"
"17 Lip 2024 18:07:11";"Stop Loss";"O2-CZ-940P69";"T2-CZ-5HKMMV";"-";"Solana (USD)";"110 Jednost.";"157,800";"-";"-";"-";"-";"3,91183";"68 583,81";"162,22";"24 008,82";"-";"-";"-";"-";"-";"-";"-";"-";"-";"-";"-";"-";"-";"-";"-";"-";"-";"-";"-";"-";"-";"-";"-";"-"
"17 Lip 2024 18:06:42";"Zmodyfikowano Transakcję Sprzedaży";"O2-CZ-940P69";"T2-CZ-5HKLFR";"-";"Solana (USD)";"110 Jednost.";"158,177";"-";"157,800";"-";"-";"-";"-";"0,00";"-";"-";"-";"-";"-";"-";"-";"-";"-";"-";"-";"-";"-";"-";"-";"-";"-";"-";"-";"-";"-";"-";"-";"-";"-"
"17 Lip 2024 17:56:49";" Zmodyfikowano Transakcję Kupna";"O2-CZ-93ZT4S";"T2-CZ-5HJTFS";"-";"Solana (USD)";"44 Jednost.";"162,750";"-";"-";"-";"-";"-";"-";"0,00";"-";"-";"-";"-";"-";"-";"-";"-";"-";"-";"-";"-";"-";"-";"-";"-";"-";"-";"-";"-";"-";"-";"-";"-";"-"
"17 Lip 2024 17:56:41";" Zmodyfikowano Transakcję Kupna";"O2-CZ-94092B";"T2-CZ-5HK7L4";"-";"Solana (USD)";"26 Jednost.";"162,125";"-";"-";"-";"-";"-";"-";"0,00";"-";"-";"-";"-";"-";"-";"-";"-";"-";"-";"-";"-";"-";"-";"-";"-";"-";"-";"-";"-";"-";"-";"-";"-";"-"
"17 Lip 2024 17:50:46";"Zmodyfikowano Transakcję Sprzedaży";"O2-CZ-940P69";"T2-CZ-5HKLFR";"-";"Solana (USD)";"110 Jednost.";"158,177";"-";"-";"-";"-";"-";"-";"0,00";"-";"-";"-";"-";"-";"-";"-";"-";"-";"-";"-";"-";"-";"-";"-";"-";"-";"-";"-";"-";"-";"-";"-";"-";"-"
"17 Lip 2024 17:50:33";"Transakcja Sprzedaży";"O2-CZ-940P69";"T2-CZ-5HKLFR";"-";"Solana (USD)";"110 Jednost.";"158,177";"-";"161,315";"-";"-";"3,950555";"68 737,56";"0,00";"-";"-";"-";"-";"-";"-";"-";"-";"-";"-";"-";"-";"-";"-";"-";"-";"-";"-";"-";"-";"-";"-";"-";"-";"-"
"17 Lip 2024 17:49:51";" Zamknięcie Transakcji";"O2-CZ-940P3N";"T2-CZ-5HKLBP";"O2-CZ-940NYT";"Solana (USD)";"26 Jednost.";"158,550";"-";"-";"-";"-";"3,91136";"16 285,82";"15,76";"23 846,60";"-";"-";"-";"-";"-";"-";"-";"-";"-";"-";"-";"-";"-";"-";"-";"-";"-";"-";"-";"-";"-";"-";"-";"-"
"17 Lip 2024 17:47:38";"Transakcja Sprzedaży";"O2-CZ-940NYT";"T2-CZ-5HKL60";"-";"Solana (USD)";"26 Jednost.";"158,705";"-";"161,914";"-";"-";"3,950355";"16 300,46";"0,00";"-";"-";"-";"-";"-";"-";"-";"-";"-";"-";"-";"-";"-";"-";"-";"-";"-";"-";"-";"-";"-";"-";"-";"-";"-"
"17 Lip 2024 17:46:57";" Zamknięcie Transakcji";"O2-CZ-940NWW";"T2-CZ-5HKL51";"O2-CZ-940NTD";"Solana (USD)";"26 Jednost.";"158,895";"-";"-";"-";"-";"3,91147";"16 321,71";"5,19";"23 830,84";"-";"-";"-";"-";"-";"-";"-";"-";"-";"-";"-";"-";"-";"-";"-";"-";"-";"-";"-";"-";"-";"-";"-";"-"
"17 Lip 2024 17:46:05";"Transakcja Sprzedaży";"O2-CZ-940NTD";"T2-CZ-5HKL2Y";"-";"Solana (USD)";"26 Jednost.";"158,946";"-";"162,124";"-";"-";"3,950465";"16 325,67";"0,00";"-";"-";"-";"-";"-";"-";"-";"-";"-";"-";"-";"-";"-";"-";"-";"-";"-";"-";"-";"-";"-";"-";"-";"-";"-"
"17 Lip 2024 17:44:17";" Zmodyfikowano Transakcję Kupna";"O2-CZ-93ZT4S";"T2-CZ-5HJTFS";"-";"Solana (USD)";"44 Jednost.";"162,750";"-";"-";"165,000";"-";"-";"-";"0,00";"-";"-";"-";"-";"-";"-";"-";"-";"-";"-";"-";"-";"-";"-";"-";"-";"-";"-";"-";"-";"-";"-";"-";"-";"-"
"17 Lip 2024 17:44:02";" Zmodyfikowano Transakcję Kupna";"O2-CZ-94092B";"T2-CZ-5HK7L4";"-";"Solana (USD)";"26 Jednost.";"162,125";"-";"-";"165,000";"-";"-";"-";"0,00";"-";"-";"-";"-";"-";"-";"-";"-";"-";"-";"-";"-";"-";"-";"-";"-";"-";"-";"-";"-";"-";"-";"-";"-";"-"
"17 Lip 2024 16:31:49";" Zmodyfikowano Transakcję Kupna";"O2-CZ-94092B";"T2-CZ-5HK7L4";"-";"Solana (USD)";"26 Jednost.";"162,125";"-";"-";"-";"-";"-";"-";"0,00";"-";"-";"-";"-";"-";"-";"-";"-";"-";"-";"-";"-";"-";"-";"-";"-";"-";"-";"-";"-";"-";"-";"-";"-";"-"
"17 Lip 2024 15:59:42";" Transakcja Kupna";"O2-CZ-94092B";"T2-CZ-5HK7L4";"-";"Solana (USD)";"26 Jednost.";"162,125";"-";"158,883";"-";"-";"3,946657";"16 636,14";"0,00";"-";"-";"-";"-";"-";"-";"-";"-";"-";"-";"-";"-";"-";"-";"-";"-";"-";"-";"-";"-";"-";"-";"-";"-";"-"
"17 Lip 2024 15:54:33";"Stop Loss";"O2-CZ-93ZYF6";"T2-CZ-5HK6XQ";"-";"Solana (USD)";"26 Jednost.";"161,582";"-";"-";"-";"-";"3,90635";"16 576,00";"29,86";"23 825,65";"-";"-";"-";"-";"-";"-";"-";"-";"-";"-";"-";"-";"-";"-";"-";"-";"-";"-";"-";"-";"-";"-";"-";"-"
"17 Lip 2024 15:53:46";"Zmodyfikowano Stop Loss";"O2-CZ-93ZYF6";"-";"O2-CZ-9407XC";"Solana (USD)";"26 Jednost.";"161,288";"-";"161,600";"-";"-";"-";"-";"-";"-";"-";"-";"-";"-";"-";"-";"-";"-";"-";"-";"-";"-";"-";"-";"-";"-";"-";"-";"-";"-";"-";"-";"-";"-"
"17 Lip 2024 15:53:08";" Zmodyfikowano Transakcję Kupna";"O2-CZ-93ZYF6";"T2-CZ-5HJY4T";"-";"Solana (USD)";"26 Jednost.";"161,288";"-";"161,400";"-";"-";"-";"-";"0,00";"-";"-";"-";"-";"-";"-";"-";"-";"-";"-";"-";"-";"-";"-";"-";"-";"-";"-";"-";"-";"-";"-";"-";"-";"-"
"17 Lip 2024 14:43:57";" Zmodyfikowano Transakcję Kupna";"O2-CZ-93ZYF6";"T2-CZ-5HJY4T";"-";"Solana (USD)";"26 Jednost.";"161,288";"-";"-";"-";"-";"-";"-";"0,00";"-";"-";"-";"-";"-";"-";"-";"-";"-";"-";"-";"-";"-";"-";"-";"-";"-";"-";"-";"-";"-";"-";"-";"-";"-"
"17 Lip 2024 14:03:19";" Transakcja Kupna";"O2-CZ-93ZYF6";"T2-CZ-5HJY4T";"-";"Solana (USD)";"26 Jednost.";"161,288";"-";"158,074";"-";"-";"3,946707";"16 550,46";"0,00";"-";"-";"-";"-";"-";"-";"-";"-";"-";"-";"-";"-";"-";"-";"-";"-";"-";"-";"-";"-";"-";"-";"-";"-";"-"
"17 Lip 2024 13:51:15";"Stop Loss";"O2-CZ-93ZX3S";"T2-CZ-5HJXMS";"-";"Solana (USD)";"26 Jednost.";"160,800";"-";"-";"-";"-";"3,90614";"16 494,90";"31,99";"23 795,79";"-";"-";"-";"-";"-";"-";"-";"-";"-";"-";"-";"-";"-";"-";"-";"-";"-";"-";"-";"-";"-";"-";"-";"-"
"17 Lip 2024 13:50:05";"Zmodyfikowano Stop Loss";"O2-CZ-93ZX3S";"-";"O2-CZ-93ZX3T";"Solana (USD)";"26 Jednost.";"160,485";"-";"160,800";"-";"-";"-";"-";"-";"-";"-";"-";"-";"-";"-";"-";"-";"-";"-";"-";"-";"-";"-";"-";"-";"-";"-";"-";"-";"-";"-";"-";"-";"-"
"17 Lip 2024 13:49:29";"Zmodyfikowano Stop Loss";"O2-CZ-93ZX3S";"-";"O2-CZ-93ZX3T";"Solana (USD)";"26 Jednost.";"160,485";"-";"160,700";"-";"-";"-";"-";"-";"-";"-";"-";"-";"-";"-";"-";"-";"-";"-";"-";"-";"-";"-";"-";"-";"-";"-";"-";"-";"-";"-";"-";"-";"-"
"17 Lip 2024 13:39:03";" Transakcja Kupna";"O2-CZ-93ZX3S";"T2-CZ-5HJX27";"-";"Solana (USD)";"26 Jednost.";"160,485";"-";"157,276";"-";"-";"3,943801";"16 455,94";"0,00";"-";"-";"-";"-";"-";"-";"-";"-";"-";"-";"-";"-";"-";"-";"-";"-";"-";"-";"-";"-";"-";"-";"-";"-";"-"
"17 Lip 2024 13:38:50";"Odrzucono Zlecenie: brak wystarczających środków";"O2-CZ-93ZX2Y";"-";"-";"Solana (USD)";"88 Jednost.";"-";"-";"-";"-";"-";"-";"-";"-";"-";"-";"-";"-";"-";"-";"-";"-";"-";"-";"-";"-";"-";"-";"-";"-";"-";"-";"-";"-";"-";"-";"-";"-";"-"
"17 Lip 2024 13:34:05";"Stop Loss";"O2-CZ-93ZWFY";"T2-CZ-5HJWS9";"-";"Solana (USD)";"88 Jednost.";"161,005";"-";"-";"-";"-";"3,90411";"55 870,99";"51,53";"23 763,80";"-";"-";"-";"-";"-";"-";"-";"-";"-";"-";"-";"-";"-";"-";"-";"-";"-";"-";"-";"-";"-";"-";"-";"-"
"17 Lip 2024 13:33:17";"Zmodyfikowano Stop Loss";"O2-CZ-93ZWFY";"-";"O2-CZ-93ZWFZ";"Solana (USD)";"88 Jednost.";"161,155";"-";"161,000";"-";"-";"-";"-";"-";"-";"-";"-";"-";"-";"-";"-";"-";"-";"-";"-";"-";"-";"-";"-";"-";"-";"-";"-";"-";"-";"-";"-";"-";"-"
"17 Lip 2024 13:28:52";"Transakcja Sprzedaży";"O2-CZ-93ZWFY";"T2-CZ-5HJWGH";"-";"Solana (USD)";"88 Jednost.";"161,155";"-";"164,378";"-";"-";"3,94308";"55 919,34";"0,00";"-";"-";"-";"-";"-";"-";"-";"-";"-";"-";"-";"-";"-";"-";"-";"-";"-";"-";"-";"-";"-";"-";"-";"-";"-"
"17 Lip 2024 13:27:23";"Odrzucono Zlecenie: brak wystarczających środków";"O2-CZ-93ZWDC";"-";"-";"Solana (USD)";"88 Jednost.";"-";"-";"-";"-";"-";"-";"-";"-";"-";"-";"-";"-";"-";"-";"-";"-";"-";"-";"-";"-";"-";"-";"-";"-";"-";"-";"-";"-";"-";"-";"-";"-";"-"
"17 Lip 2024 13:18:14";"Stop Loss";"O2-CZ-93ZTN9";"T2-CZ-5HJVTX";"-";"Solana (USD)";"88 Jednost.";"161,500";"-";"-";"-";"-";"3,90841";"56 104,41";"106,97";"23 712,27";"-";"-";"-";"-";"-";"-";"-";"-";"-";"-";"-";"-";"-";"-";"-";"-";"-";"-";"-";"-";"-";"-";"-";"-"
"17 Lip 2024 13:17:50";"Zmodyfikowano Stop Loss";"O2-CZ-93ZTN9";"-";"O2-CZ-93ZVL0";"Solana (USD)";"88 Jednost.";"161,811";"-";"161,500";"-";"-";"-";"-";"-";"-";"-";"-";"-";"-";"-";"-";"-";"-";"-";"-";"-";"-";"-";"-";"-";"-";"-";"-";"-";"-";"-";"-";"-";"-"
"17 Lip 2024 13:17:15";"Zmodyfikowano Transakcję Sprzedaży";"O2-CZ-93ZTN9";"T2-CZ-5HJTVW";"-";"Solana (USD)";"88 Jednost.";"161,811";"-";"161,700";"-";"-";"-";"-";"0,00";"-";"-";"-";"-";"-";"-";"-";"-";"-";"-";"-";"-";"-";"-";"-";"-";"-";"-";"-";"-";"-";"-";"-";"-";"-"
"17 Lip 2024 13:09:04";" Zmodyfikowano Transakcję Kupna";"O2-CZ-93ZT4S";"T2-CZ-5HJTFS";"-";"Solana (USD)";"44 Jednost.";"162,750";"-";"-";"-";"-";"-";"-";"0,00";"-";"-";"-";"-";"-";"-";"-";"-";"-";"-";"-";"-";"-";"-";"-";"-";"-";"-";"-";"-";"-";"-";"-";"-";"-"
"17 Lip 2024 13:07:17";"Zmodyfikowano Transakcję Sprzedaży";"O2-CZ-93ZTN9";"T2-CZ-5HJTVW";"-";"Solana (USD)";"88 Jednost.";"161,811";"-";"-";"-";"-";"-";"-";"0,00";"-";"-";"-";"-";"-";"-";"-";"-";"-";"-";"-";"-";"-";"-";"-";"-";"-";"-";"-";"-";"-";"-";"-";"-";"-"
"17 Lip 2024 13:06:15";"Transakcja Sprzedaży";"O2-CZ-93ZTN9";"T2-CZ-5HJTVW";"-";"Solana (USD)";"88 Jednost.";"161,811";"-";"165,047";"-";"-";"3,950375";"56 250,84";"0,00";"-";"-";"-";"-";"-";"-";"-";"-";"-";"-";"-";"-";"-";"-";"-";"-";"-";"-";"-";"-";"-";"-";"-";"-";"-"
"17 Lip 2024 13:02:37";" Zmodyfikowano Transakcję Kupna";"O2-CZ-93ZT4S";"T2-CZ-5HJTFS";"-";"Solana (USD)";"44 Jednost.";"162,750";"-";"-";"163,000";"-";"-";"-";"0,00";"-";"-";"-";"-";"-";"-";"-";"-";"-";"-";"-";"-";"-";"-";"-";"-";"-";"-";"-";"-";"-";"-";"-";"-";"-"
"17 Lip 2024 13:00:15";"Zmodyfikowano Take Profit";"O2-CZ-93ZT4S";"-";"O2-CZ-93ZT9B";"Solana (USD)";"44 Jednost.";"162,750";"-";"-";"163,000";"-";"-";"-";"-";"-";"-";"-";"-";"-";"-";"-";"-";"-";"-";"-";"-";"-";"-";"-";"-";"-";"-";"-";"-";"-";"-";"-";"-";"-"
"17 Lip 2024 12:59:42";" Zmodyfikowano Transakcję Kupna";"O2-CZ-93ZT4S";"T2-CZ-5HJTFS";"-";"Solana (USD)";"44 Jednost.";"162,750";"-";"159,495";"162,900";"-";"-";"-";"0,00";"-";"-";"-";"-";"-";"-";"-";"-";"-";"-";"-";"-";"-";"-";"-";"-";"-";"-";"-";"-";"-";"-";"-";"-";"-"
"17 Lip 2024 12:56:25";" Transakcja Kupna";"O2-CZ-93ZT4S";"T2-CZ-5HJTFS";"-";"Solana (USD)";"44 Jednost.";"162,750";"-";"159,495";"-";"-";"3,949062";"28 279,23";"0,00";"-";"-";"-";"-";"-";"-";"-";"-";"-";"-";"-";"-";"-";"-";"-";"-";"-";"-";"-";"-";"-";"-";"-";"-";"-"
"17 Lip 2024 12:51:03";"Stop Loss";"O2-CZ-93ZS4J";"T2-CZ-5HJT7L";"-";"Solana (USD)";"44 Jednost.";"162,700";"-";"-";"-";"-";"3,90721";"28 252,11";"26,65";"23 605,30";"-";"-";"-";"-";"-";"-";"-";"-";"-";"-";"-";"-";"-";"-";"-";"-";"-";"-";"-";"-";"-";"-";"-";"-"
"17 Lip 2024 12:50:31";"Zmodyfikowano Stop Loss";"O2-CZ-93ZS4J";"-";"O2-CZ-93ZS4K";"Solana (USD)";"44 Jednost.";"162,855";"-";"162,700";"-";"-";"-";"-";"-";"-";"-";"-";"-";"-";"-";"-";"-";"-";"-";"-";"-";"-";"-";"-";"-";"-";"-";"-";"-";"-";"-";"-";"-";"-"
"17 Lip 2024 12:37:10";"Transakcja Sprzedaży";"O2-CZ-93ZS4J";"T2-CZ-5HJSL5";"-";"Solana (USD)";"44 Jednost.";"162,855";"-";"166,142";"-";"-";"3,943621";"28 258,48";"0,00";"-";"-";"-";"-";"-";"-";"-";"-";"-";"-";"-";"-";"-";"-";"-";"-";"-";"-";"-";"-";"-";"-";"-";"-";"-"
"17 Lip 2024 12:35:45";"Odrzucono Zlecenie: brak wystarczających środków";"O2-CZ-93ZS33";"-";"-";"Solana (USD)";"45 Jednost.";"-";"-";"-";"-";"-";"-";"-";"-";"-";"-";"-";"-";"-";"-";"-";"-";"-";"-";"-";"-";"-";"-";"-";"-";"-";"-";"-";"-";"-";"-";"-";"-";"-"
"17 Lip 2024 12:29:06";" Zamknięcie Transakcji";"O2-CZ-93ZRW9";"T2-CZ-5HJSDL";"O2-CZ-93X27G";"Solana (USD)";"69 Jednost.";"162,986";"-";"-";"-";"-";"3,90627";"44 371,50";"1 448,20";"23 578,65";"-";"-";"-";"-";"-";"-";"-";"-";"-";"-";"-";"-";"-";"-";"-";"-";"-";"-";"-";"-";"-";"-";"-";"-"
"17 Lip 2024 12:28:35";" Zmodyfikowano Transakcję Kupna";"O2-CZ-93ZRSQ";"T2-CZ-5HJSBP";"-";"Solana (USD)";"119 Jednost.";"163,075";"-";"-";"-";"-";"-";"-";"0,00";"-";"-";"-";"-";"-";"-";"-";"-";"-";"-";"-";"-";"-";"-";"-";"-";"-";"-";"-";"-";"-";"-";"-";"-";"-"
"17 Lip 2024 12:26:49";" Transakcja Kupna";"O2-CZ-93ZRSQ";"T2-CZ-5HJSBP";"-";"Solana (USD)";"119 Jednost.";"163,075";"-";"159,814";"-";"-";"3,946096";"76 577,64";"0,00";"-";"-";"-";"-";"-";"-";"-";"-";"-";"-";"-";"-";"-";"-";"-";"-";"-";"-";"-";"-";"-";"-";"-";"-";"-"
"17 Lip 2024 11:03:59";" Zamknięcie Transakcji";"O2-CZ-93ZMV0";"T2-CZ-5HJP4V";"O2-CZ-93ZK67";"Solana (USD)";"119 Jednost.";"161,745";"-";"-";"-";"-";"3,90264";"75 871,52";"48,76";"22 130,45";"-";"-";"-";"-";"-";"-";"-";"-";"-";"-";"-";"-";"-";"-";"-";"-";"-";"-";"-";"-";"-";"-";"-";"-"
"17 Lip 2024 10:31:56";" Transakcja Kupna";"O2-CZ-93ZK67";"T2-CZ-5HJLKN";"-";"Solana (USD)";"119 Jednost.";"161,640";"-";"158,408";"-";"-";"3,950505";"75 988,59";"0,00";"-";"-";"-";"-";"-";"-";"-";"-";"-";"-";"-";"-";"-";"-";"-";"-";"-";"-";"-";"-";"-";"-";"-";"-";"-"
"17 Lip 2024 10:25:21";"Zmodyfikowano Transakcję Sprzedaży";"O2-CZ-93XJ1D";"T2-CZ-5HGW2Y";"-";"Solana (USD)";"133 Jednost.";"153,690";"-";"-";"-";"-";"-";"-";"0,00";"-";"-";"-";"-";"-";"-";"-";"-";"-";"-";"-";"-";"-";"-";"-";"-";"-";"-";"-";"-";"-";"-";"-";"-";"-"
"17 Lip 2024 00:40:18";"Zmodyfikowano Take Profit";"O2-CZ-93XJ1D";"-";"O2-CZ-93YF17";"Solana (USD)";"133 Jednost.";"153,690";"-";"-";"153,600";"-";"-";"-";"-";"-";"-";"-";"-";"-";"-";"-";"-";"-";"-";"-";"-";"-";"-";"-";"-";"-";"-";"-";"-";"-";"-";"-";"-";"-"
"16 Lip 2024 23:01:01";"Koszty Utrzymania Pozycji";"1354866686";"-";"-";"Rachunek";"-";"-";"-";"-";"-";"-";"-";"-";"-10,05";"22 081,69";"-";"-";"-";"-";"-";"-10,05";"-";"-";"-";"-";"-";"-";"-";"-";"-";"-";"-";"-";"-";"-";"-";"-";"-";"-"
"16 Lip 2024 23:01:01";"Koszty Utrzymania Pozycji";"O2-CZ-93XJ1D";"-";"-";"Solana (USD)";"-";"-";"-";"-";"-";"-";"-";"-";"-";"-";"-";"-";"21 251,40";"-10,00000%";"22,77";"22,77";"-";"-";"-";"-";"-";"-";"-";"-";"-";"-";"-";"-";"-";"-";"-";"-";"-";"-"
"16 Lip 2024 23:01:01";"Koszty Utrzymania Pozycji";"O2-CZ-93X27G";"-";"-";"Solana (USD)";"-";"-";"-";"-";"-";"-";"-";"-";"-";"-";"-";"-";"11 025,16";"-27,50000%";"-32,82";"-32,82";"-";"-";"-";"-";"-";"-";"-";"-";"-";"-";"-";"-";"-";"-";"-";"-";"-";"-"
"16 Lip 2024 17:27:51";"Zmodyfikowano Transakcję Sprzedaży";"O2-CZ-93XJ1D";"T2-CZ-5HGW2Y";"-";"Solana (USD)";"133 Jednost.";"153,690";"-";"-";"152,000";"-";"-";"-";"0,00";"-";"-";"-";"-";"-";"-";"-";"-";"-";"-";"-";"-";"-";"-";"-";"-";"-";"-";"-";"-";"-";"-";"-";"-";"-"
"16 Lip 2024 17:12:11";"Take Profit";"O2-CZ-93XV8D";"T2-CZ-5HHM1D";"-";"Solana (USD)";"126 Jednost.";"157,200";"-";"-";"-";"-";"3,91662";"78 357,00";"106,10";"22 091,74";"-";"-";"-";"-";"-";"-";"-";"-";"-";"-";"-";"-";"-";"-";"-";"-";"-";"-";"-";"-";"-";"-";"-";"-"
"16 Lip 2024 16:08:11";"Zmodyfikowano Transakcję Sprzedaży";"O2-CZ-93XJ1D";"T2-CZ-5HGW2Y";"-";"Solana (USD)";"133 Jednost.";"153,690";"-";"-";"-";"-";"-";"-";"0,00";"-";"-";"-";"-";"-";"-";"-";"-";"-";"-";"-";"-";"-";"-";"-";"-";"-";"-";"-";"-";"-";"-";"-";"-";"-"
"16 Lip 2024 15:49:08";" Zmodyfikowano Transakcję Kupna";"O2-CZ-93XV8D";"T2-CZ-5HH4VY";"-";"Solana (USD)";"126 Jednost.";"156,985";"-";"-";"157,200";"-";"-";"-";"0,00";"-";"-";"-";"-";"-";"-";"-";"-";"-";"-";"-";"-";"-";"-";"-";"-";"-";"-";"-";"-";"-";"-";"-";"-";"-"
"16 Lip 2024 15:20:30";" Zmodyfikowano Transakcję Kupna";"O2-CZ-93XV8D";"T2-CZ-5HH4VY";"-";"Solana (USD)";"126 Jednost.";"156,985";"-";"-";"-";"-";"-";"-";"0,00";"-";"-";"-";"-";"-";"-";"-";"-";"-";"-";"-";"-";"-";"-";"-";"-";"-";"-";"-";"-";"-";"-";"-";"-";"-"
"16 Lip 2024 14:48:08";" Zmodyfikowano Transakcję Kupna";"O2-CZ-93XV8D";"T2-CZ-5HH4VY";"-";"Solana (USD)";"126 Jednost.";"156,985";"-";"153,846";"157,400";"-";"-";"-";"0,00";"-";"-";"-";"-";"-";"-";"-";"-";"-";"-";"-";"-";"-";"-";"-";"-";"-";"-";"-";"-";"-";"-";"-";"-";"-"
"16 Lip 2024 14:40:29";" Transakcja Kupna";"O2-CZ-93XV8D";"T2-CZ-5HH4VY";"-";"Solana (USD)";"126 Jednost.";"156,985";"-";"153,846";"-";"-";"3,944012";"78 012,99";"0,00";"-";"-";"-";"-";"-";"-";"-";"-";"-";"-";"-";"-";"-";"-";"-";"-";"-";"-";"-";"-";"-";"-";"-";"-";"-"
"16 Lip 2024 14:27:31";" Zamknięcie Transakcji";"O2-CZ-93XSJJ";"T2-CZ-5HH2XW";"O2-CZ-93XQY5";"Solana (USD)";"126 Jednost.";"157,390";"-";"-";"-";"-";"3,89784";"78 075,35";"14,73";"21 985,64";"-";"-";"-";"-";"-";"-";"-";"-";"-";"-";"-";"-";"-";"-";"-";"-";"-";"-";"-";"-";"-";"-";"-";"-"
"16 Lip 2024 13:43:56";" Transakcja Kupna";"O2-CZ-93XQY5";"T2-CZ-5HH1MR";"-";"Solana (USD)";"126 Jednost.";"157,360";"-";"154,213";"-";"-";"3,935956";"78 039,61";"0,00";"-";"-";"-";"-";"-";"-";"-";"-";"-";"-";"-";"-";"-";"-";"-";"-";"-";"-";"-";"-";"-";"-";"-";"-";"-"
"16 Lip 2024 13:41:19";"Zmodyfikowano Transakcję Sprzedaży";"O2-CZ-93XJ1D";"T2-CZ-5HGW2Y";"-";"Solana (USD)";"133 Jednost.";"153,690";"-";"-";"151,000";"-";"-";"-";"0,00";"-";"-";"-";"-";"-";"-";"-";"-";"-";"-";"-";"-";"-";"-";"-";"-";"-";"-";"-";"-";"-";"-";"-";"-";"-"
"16 Lip 2024 13:24:21";"Stop Loss";"O2-CZ-93XNTE";"T2-CZ-5HH130";"-";"Solana (USD)";"120 Jednost.";"157,330";"-";"-";"-";"-";"3,89669";"74 307,38";"346,03";"21 970,91";"-";"-";"-";"-";"-";"-";"-";"-";"-";"-";"-";"-";"-";"-";"-";"-";"-";"-";"-";"-";"-";"-";"-";"-"
"16 Lip 2024 13:23:39";"Zmodyfikowano Stop Loss";"O2-CZ-93XNTE";"-";"O2-CZ-93XNTF";"Solana (USD)";"120 Jednost.";"156,590";"-";"157,400";"-";"-";"-";"-";"-";"-";"-";"-";"-";"-";"-";"-";"-";"-";"-";"-";"-";"-";"-";"-";"-";"-";"-";"-";"-";"-";"-";"-";"-";"-"
"16 Lip 2024 13:22:57";"Zmodyfikowano Stop Loss";"O2-CZ-93XNTE";"-";"O2-CZ-93XNTF";"Solana (USD)";"120 Jednost.";"156,590";"-";"157,200";"-";"-";"-";"-";"-";"-";"-";"-";"-";"-";"-";"-";"-";"-";"-";"-";"-";"-";"-";"-";"-";"-";"-";"-";"-";"-";"-";"-";"-";"-"
"16 Lip 2024 13:21:01";"Zmodyfikowano Stop Loss";"O2-CZ-93XNTE";"-";"O2-CZ-93XNTF";"Solana (USD)";"120 Jednost.";"156,590";"-";"156,900";"-";"-";"-";"-";"-";"-";"-";"-";"-";"-";"-";"-";"-";"-";"-";"-";"-";"-";"-";"-";"-";"-";"-";"-";"-";"-";"-";"-";"-";"-"
"16 Lip 2024 12:40:15";" Transakcja Kupna";"O2-CZ-93XNTE";"T2-CZ-5HGZX8";"-";"Solana (USD)";"120 Jednost.";"156,590";"-";"153,459";"-";"-";"3,939834";"74 032,63";"0,00";"-";"-";"-";"-";"-";"-";"-";"-";"-";"-";"-";"-";"-";"-";"-";"-";"-";"-";"-";"-";"-";"-";"-";"-";"-"
"16 Lip 2024 10:54:44";"Zmodyfikowano Transakcję Sprzedaży";"O2-CZ-93XJ1D";"T2-CZ-5HGW2Y";"-";"Solana (USD)";"133 Jednost.";"153,690";"-";"-";"-";"-";"-";"-";"0,00";"-";"-";"-";"-";"-";"-";"-";"-";"-";"-";"-";"-";"-";"-";"-";"-";"-";"-";"-";"-";"-";"-";"-";"-";"-"
"16 Lip 2024 10:40:54";"Transakcja Sprzedaży";"O2-CZ-93XJ1D";"T2-CZ-5HGW2Y";"-";"Solana (USD)";"133 Jednost.";"153,690";"-";"156,763";"-";"-";"3,926206";"80 254,67";"0,00";"-";"-";"-";"-";"-";"-";"-";"-";"-";"-";"-";"-";"-";"-";"-";"-";"-";"-";"-";"-";"-";"-";"-";"-";"-"
"16 Lip 2024 10:38:16";"Odrzucono Zlecenie: brak wystarczających środków";"O2-CZ-93XHZ7";"-";"-";"Solana (USD)";"120 Jednost.";"-";"-";"-";"-";"-";"-";"-";"-";"-";"-";"-";"-";"-";"-";"-";"-";"-";"-";"-";"-";"-";"-";"-";"-";"-";"-";"-";"-";"-";"-";"-";"-";"-"
"16 Lip 2024 10:37:57";"Odrzucono Zlecenie: brak wystarczających środków";"O2-CZ-93XHYX";"-";"-";"Solana (USD)";"130 Jednost.";"-";"-";"-";"-";"-";"-";"-";"-";"-";"-";"-";"-";"-";"-";"-";"-";"-";"-";"-";"-";"-";"-";"-";"-";"-";"-";"-";"-";"-";"-";"-";"-";"-"
"16 Lip 2024 10:36:17";"Odrzucono Zlecenie: brak wystarczających środków";"O2-CZ-93XHWS";"-";"-";"Solana (USD)";"132 Jednost.";"-";"-";"-";"-";"-";"-";"-";"-";"-";"-";"-";"-";"-";"-";"-";"-";"-";"-";"-";"-";"-";"-";"-";"-";"-";"-";"-";"-";"-";"-";"-";"-";"-"
"16 Lip 2024 10:35:46";"Odrzucono Zlecenie: brak wystarczających środków";"O2-CZ-93XHW4";"-";"-";"Solana (USD)";"133 Jednost.";"-";"-";"-";"-";"-";"-";"-";"-";"-";"-";"-";"-";"-";"-";"-";"-";"-";"-";"-";"-";"-";"-";"-";"-";"-";"-";"-";"-";"-";"-";"-";"-";"-"
"16 Lip 2024 10:30:26";" Zamknięcie Transakcji";"O2-CZ-93XHPW";"T2-CZ-5HGVV4";"O2-CZ-93XHGY";"Solana (USD)";"132 Jednost.";"153,015";"-";"-";"-";"-";"3,88575";"79 273,11";"194,91";"21 624,88";"-";"-";"-";"-";"-";"-";"-";"-";"-";"-";"-";"-";"-";"-";"-";"-";"-";"-";"-";"-";"-";"-";"-";"-"
"16 Lip 2024 10:24:49";"Transakcja Sprzedaży";"O2-CZ-93XHGY";"T2-CZ-5HGVNK";"-";"Solana (USD)";"132 Jednost.";"153,395";"-";"156,462";"-";"-";"3,923351";"79 440,56";"0,00";"-";"-";"-";"-";"-";"-";"-";"-";"-";"-";"-";"-";"-";"-";"-";"-";"-";"-";"-";"-";"-";"-";"-";"-";"-"
"16 Lip 2024 00:26:03";" Transakcja Kupna";"O2-CZ-93X27G";"T2-CZ-5HGHD6";"-";"Solana (USD)";"69 Jednost.";"157,613";"-";"-";"-";"-";"3,926357";"42 700,29";"0,00";"-";"-";"-";"-";"-";"-";"-";"-";"-";"-";"-";"-";"-";"-";"-";"-";"-";"-";"-";"-";"-";"-";"-";"-";"-"
"16 Lip 2024 00:03:45";" Zamknięcie Transakcji";"O2-CZ-93X1LZ";"T2-CZ-5HGH67";"O2-CZ-93WYVZ";"Solana (USD)";"70 Jednost.";"156,325";"-";"-";"-";"-";"3,926307";"42 964,59";"-362,79";"21 429,97";"-";"-";"-";"-";"-";"-";"-";"-";"-";"-";"-";"-";"-";"-";"-";"-";"-";"-";"-";"-";"-";"-";"-";"-"
"15 Lip 2024 23:10:44";" Zamknięcie Transakcji";"O2-CZ-93X0QR";"T2-CZ-5HGH0M";"O2-CZ-93X0HL";"Solana (USD)";"130 Jednost.";"156,960";"-";"-";"-";"-";"3,88564";"80 082,77";"5,05";"21 792,76";"-";"-";"-";"-";"-";"-";"-";"-";"-";"-";"-";"-";"-";"-";"-";"-";"-";"-";"-";"-";"-";"-";"-";"-"
"15 Lip 2024 23:01:01";"Koszty Utrzymania Pozycji";"1354425095";"-";"-";"Rachunek";"-";"-";"-";"-";"-";"-";"-";"-";"-48,61";"21 787,71";"-";"-";"-";"-";"-";"-48,61";"-";"-";"-";"-";"-";"-";"-";"-";"-";"-";"-";"-";"-";"-";"-";"-";"-";"-"
"15 Lip 2024 23:01:01";"Koszty Utrzymania Pozycji";"O2-CZ-93WYVZ";"-";"-";"Solana (USD)";"-";"-";"-";"-";"-";"-";"-";"-";"-";"-";"-";"-";"10 974,95";"-10,00000%";"11,69";"11,69";"-";"-";"-";"-";"-";"-";"-";"-";"-";"-";"-";"-";"-";"-";"-";"-";"-";"-"
"15 Lip 2024 23:01:01";"Koszty Utrzymania Pozycji";"O2-CZ-93X0HL";"-";"-";"Solana (USD)";"-";"-";"-";"-";"-";"-";"-";"-";"-";"-";"-";"-";"20 382,05";"-27,50000%";"-60,30";"-60,30";"-";"-";"-";"-";"-";"-";"-";"-";"-";"-";"-";"-";"-";"-";"-";"-";"-";"-"
"15 Lip 2024 22:47:25";" Transakcja Kupna";"O2-CZ-93X0HL";"T2-CZ-5HGGV2";"-";"Solana (USD)";"130 Jednost.";"156,950";"-";"153,816";"-";"-";"3,925665";"80 097,30";"0,00";"-";"-";"-";"-";"-";"-";"-";"-";"-";"-";"-";"-";"-";"-";"-";"-";"-";"-";"-";"-";"-";"-";"-";"-";"-"
"15 Lip 2024 22:38:46";" Zamknięcie Transakcji";"O2-CZ-93X0EC";"T2-CZ-5HGGRE";"O2-CZ-93X0BJ";"Solana (USD)";"130 Jednost.";"157,040";"-";"-";"-";"-";"3,88642";"80 139,56";"5,05";"21 836,32";"-";"-";"-";"-";"-";"-";"-";"-";"-";"-";"-";"-";"-";"-";"-";"-";"-";"-";"-";"-";"-";"-";"-";"-"
"15 Lip 2024 22:32:41";"Zmodyfikowano Transakcję Sprzedaży";"O2-CZ-93WYVZ";"T2-CZ-5HGFFJ";"-";"Solana (USD)";"70 Jednost.";"155,005";"-";"-";"-";"-";"-";"-";"0,00";"-";"-";"-";"-";"-";"-";"-";"-";"-";"-";"-";"-";"-";"-";"-";"-";"-";"-";"-";"-";"-";"-";"-";"-";"-"
"15 Lip 2024 22:32:06";" Transakcja Kupna";"O2-CZ-93X0BJ";"T2-CZ-5HGGP1";"-";"Solana (USD)";"130 Jednost.";"157,030";"-";"153,880";"-";"-";"3,925094";"80 126,47";"0,00";"-";"-";"-";"-";"-";"-";"-";"-";"-";"-";"-";"-";"-";"-";"-";"-";"-";"-";"-";"-";"-";"-";"-";"-";"-"
"15 Lip 2024 21:51:32";"Transakcja Sprzedaży";"O2-CZ-93WYVZ";"T2-CZ-5HGFFJ";"-";"Solana (USD)";"70 Jednost.";"155,005";"-";"158,115";"-";"-";"3,925455";"42 592,56";"0,00";"-";"-";"-";"-";"-";"-";"-";"-";"-";"-";"-";"-";"-";"-";"-";"-";"-";"-";"-";"-";"-";"-";"-";"-";"-"
"15 Lip 2024 20:00:53";"Stop Loss";"O2-CZ-93WS6C";"T2-CZ-5HG9NG";"-";"Solana (USD)";"70 Jednost.";"154,424";"-";"-";"-";"-";"3,88794";"42 449,69";"66,95";"21 831,27";"-";"-";"-";"-";"-";"-";"-";"-";"-";"-";"-";"-";"-";"-";"-";"-";"-";"-";"-";"-";"-";"-";"-";"-"
"15 Lip 2024 20:00:46";"Zmodyfikowano Stop Loss";"O2-CZ-93WS6C";"-";"O2-CZ-93WS6D";"Solana (USD)";"70 Jednost.";"154,670";"-";"154,400";"-";"-";"-";"-";"-";"-";"-";"-";"-";"-";"-";"-";"-";"-";"-";"-";"-";"-";"-";"-";"-";"-";"-";"-";"-";"-";"-";"-";"-";"-"
"15 Lip 2024 19:59:00";"Zmodyfikowano Stop Loss";"O2-CZ-93WS6C";"-";"O2-CZ-93WS6D";"Solana (USD)";"70 Jednost.";"154,670";"-";"154,500";"-";"-";"-";"-";"-";"-";"-";"-";"-";"-";"-";"-";"-";"-";"-";"-";"-";"-";"-";"-";"-";"-";"-";"-";"-";"-";"-";"-";"-";"-"
"15 Lip 2024 19:56:02";"Transakcja Sprzedaży";"O2-CZ-93WS6C";"T2-CZ-5HG9EY";"-";"Solana (USD)";"70 Jednost.";"154,670";"-";"157,763";"153,800";"-";"3,925735";"42 503,54";"0,00";"-";"-";"-";"-";"-";"-";"-";"-";"-";"-";"-";"-";"-";"-";"-";"-";"-";"-";"-";"-";"-";"-";"-";"-";"-"
"15 Lip 2024 19:02:07";"Stop Loss";"O2-CZ-93WLLN";"T2-CZ-5HG69D";"-";"Solana (USD)";"68 Jednost.";"154,015";"-";"-";"-";"-";"3,88345";"41 080,09";"48,85";"21 764,32";"-";"-";"-";"-";"-";"-";"-";"-";"-";"-";"-";"-";"-";"-";"-";"-";"-";"-";"-";"-";"-";"-";"-";"-"
"15 Lip 2024 19:00:46";"Zmodyfikowano Transakcję Sprzedaży";"O2-CZ-93WLLN";"T2-CZ-5HG467";"-";"Solana (USD)";"68 Jednost.";"154,200";"-";"154,000";"152,000";"-";"-";"-";"0,00";"-";"-";"-";"-";"-";"-";"-";"-";"-";"-";"-";"-";"-";"-";"-";"-";"-";"-";"-";"-";"-";"-";"-";"-";"-"
"15 Lip 2024 18:38:45";"Zmodyfikowano Transakcję Sprzedaży";"O2-CZ-93WLLN";"T2-CZ-5HG467";"-";"Solana (USD)";"68 Jednost.";"154,200";"-";"-";"152,000";"-";"-";"-";"0,00";"-";"-";"-";"-";"-";"-";"-";"-";"-";"-";"-";"-";"-";"-";"-";"-";"-";"-";"-";"-";"-";"-";"-";"-";"-"
"15 Lip 2024 18:37:47";"Transakcja Sprzedaży";"O2-CZ-93WLLN";"T2-CZ-5HG467";"-";"Solana (USD)";"68 Jednost.";"154,200";"-";"157,284";"-";"-";"3,921838";"41 122,82";"0,00";"-";"-";"-";"-";"-";"-";"-";"-";"-";"-";"-";"-";"-";"-";"-";"-";"-";"-";"-";"-";"-";"-";"-";"-";"-"
"15 Lip 2024 18:01:55";" Zamknięcie Transakcji";"O2-CZ-93WHYX";"T2-CZ-5HG1SJ";"O2-CZ-93WGXD";"Solana (USD)";"68 Jednost.";"153,080";"-";"-";"-";"-";"3,87856";"40 779,38";"83,08";"21 715,47";"-";"-";"-";"-";"-";"-";"-";"-";"-";"-";"-";"-";"-";"-";"-";"-";"-";"-";"-";"-";"-";"-";"-";"-"
"15 Lip 2024 18:00:22";" Zmodyfikowano Transakcję Kupna";"O2-CZ-93WGXD";"T2-CZ-5HG0ZC";"-";"Solana (USD)";"68 Jednost.";"152,765";"-";"153,000";"154,300";"-";"-";"-";"0,00";"-";"-";"-";"-";"-";"-";"-";"-";"-";"-";"-";"-";"-";"-";"-";"-";"-";"-";"-";"-";"-";"-";"-";"-";"-"
"15 Lip 2024 17:53:09";" Zmodyfikowano Transakcję Kupna";"O2-CZ-93WGXD";"T2-CZ-5HG0ZC";"-";"Solana (USD)";"68 Jednost.";"152,765";"-";"-";"154,300";"-";"-";"-";"0,00";"-";"-";"-";"-";"-";"-";"-";"-";"-";"-";"-";"-";"-";"-";"-";"-";"-";"-";"-";"-";"-";"-";"-";"-";"-"
"15 Lip 2024 17:48:44";"Odrzucono Zlecenie: brak wystarczających środków";"O2-CZ-93WH3T";"-";"-";"Solana (USD)";"68 Jednost.";"-";"-";"-";"-";"-";"-";"-";"-";"-";"-";"-";"-";"-";"-";"-";"-";"-";"-";"-";"-";"-";"-";"-";"-";"-";"-";"-";"-";"-";"-";"-";"-";"-"
"15 Lip 2024 17:46:42";" Transakcja Kupna";"O2-CZ-93WGXD";"T2-CZ-5HG0ZC";"-";"Solana (USD)";"68 Jednost.";"152,765";"-";"149,710";"-";"-";"3,917248";"40 692,45";"0,00";"-";"-";"-";"-";"-";"-";"-";"-";"-";"-";"-";"-";"-";"-";"-";"-";"-";"-";"-";"-";"-";"-";"-";"-";"-"
"15 Lip 2024 17:02:59";"Take Profit";"O2-CZ-93VX9V";"T2-CZ-5HFWYR";"-";"Solana (USD)";"67 Jednost.";"154,000";"-";"-";"-";"-";"3,87466";"40 380,53";"366,04";"21 632,39";"-";"-";"-";"-";"-";"-";"-";"-";"-";"-";"-";"-";"-";"-";"-";"-";"-";"-";"-";"-";"-";"-";"-";"-"
"15 Lip 2024 15:29:32";" Zmodyfikowano Transakcję Kupna";"O2-CZ-93VX9V";"T2-CZ-5HFHP8";"-";"Solana (USD)";"67 Jednost.";"152,590";"-";"-";"154,000";"-";"-";"-";"0,00";"-";"-";"-";"-";"-";"-";"-";"-";"-";"-";"-";"-";"-";"-";"-";"-";"-";"-";"-";"-";"-";"-";"-";"-";"-"
"15 Lip 2024 14:23:48";" Transakcja Kupna";"O2-CZ-93VX9V";"T2-CZ-5HFHP8";"-";"Solana (USD)";"67 Jednost.";"152,590";"-";"149,539";"-";"-";"3,918471";"40 060,60";"0,00";"-";"-";"-";"-";"-";"-";"-";"-";"-";"-";"-";"-";"-";"-";"-";"-";"-";"-";"-";"-";"-";"-";"-";"-";"-"
"15 Lip 2024 00:06:29";" Zamknięcie Transakcji";"O2-CZ-93V522";"T2-CZ-5HEX0P";"O2-CZ-93RW0F";"Solana (USD)";"62 Jednost.";"147,839";"-";"-";"-";"-";"3,89003";"36 014,49";"2 161,95";"21 266,35";"-";"-";"-";"-";"-";"-";"-";"-";"-";"-";"-";"-";"-";"-";"-";"-";"-";"-";"-";"-";"-";"-";"-";"-"
"15 Lip 2024 00:00:52";" Zmodyfikowano Transakcję Kupna";"O2-CZ-93RW0F";"T2-CZ-5HCZ70";"-";"Solana (USD)";"62 Jednost.";"138,875";"-";"147,500";"-";"-";"-";"-";"0,00";"-";"-";"-";"-";"-";"-";"-";"-";"-";"-";"-";"-";"-";"-";"-";"-";"-";"-";"-";"-";"-";"-";"-";"-";"-"
"14 Lip 2024 23:58:32";" Zmodyfikowano Transakcję Kupna";"O2-CZ-93RW0F";"T2-CZ-5HCZ70";"-";"Solana (USD)";"62 Jednost.";"138,875";"-";"-";"-";"-";"-";"-";"0,00";"-";"-";"-";"-";"-";"-";"-";"-";"-";"-";"-";"-";"-";"-";"-";"-";"-";"-";"-";"-";"-";"-";"-";"-";"-"
"12 Lip 2024 23:00:58";"Koszty Utrzymania Pozycji";"1354030319";"-";"-";"Rachunek";"-";"-";"-";"-";"-";"-";"-";"-";"-76,10";"19 104,40";"-";"-";"-";"-";"-";"-76,10";"-";"-";"-";"-";"-";"-";"-";"-";"-";"-";"-";"-";"-";"-";"-";"-";"-";"-"
"12 Lip 2024 23:00:58";"Koszty Utrzymania Pozycji";"O2-CZ-93RW0F";"-";"-";"Solana (USD)";"-";"-";"-";"-";"-";"-";"-";"-";"-";"-";"-";"-";"8 590,72";"-27,50000%";"-76,10";"-76,10";"-";"-";"-";"-";"-";"-";"-";"-";"-";"-";"-";"-";"-";"-";"-";"-";"-";"-"
"11 Lip 2024 23:00:57";"Koszty Utrzymania Pozycji";"1353613843";"-";"-";"Rachunek";"-";"-";"-";"-";"-";"-";"-";"-";"-25,21";"19 180,50";"-";"-";"-";"-";"-";"-25,21";"-";"-";"-";"-";"-";"-";"-";"-";"-";"-";"-";"-";"-";"-";"-";"-";"-";"-"
"11 Lip 2024 23:00:57";"Koszty Utrzymania Pozycji";"O2-CZ-93RW0F";"-";"-";"Solana (USD)";"-";"-";"-";"-";"-";"-";"-";"-";"-";"-";"-";"-";"8 493,38";"-27,50000%";"-25,21";"-25,21";"-";"-";"-";"-";"-";"-";"-";"-";"-";"-";"-";"-";"-";"-";"-";"-";"-";"-"
"11 Lip 2024 22:05:49";" Zmodyfikowano Transakcję Kupna";"O2-CZ-93RW0F";"T2-CZ-5HCZ70";"-";"Solana (USD)";"62 Jednost.";"138,875";"-";"-";"145,500";"-";"-";"-";"0,00";"-";"-";"-";"-";"-";"-";"-";"-";"-";"-";"-";"-";"-";"-";"-";"-";"-";"-";"-";"-";"-";"-";"-";"-";"-"
"11 Lip 2024 22:05:07";" Zmodyfikowano Transakcję Kupna";"O2-CZ-93RW0F";"T2-CZ-5HCZ70";"-";"Solana (USD)";"62 Jednost.";"138,875";"-";"-";"-";"-";"-";"-";"0,00";"-";"-";"-";"-";"-";"-";"-";"-";"-";"-";"-";"-";"-";"-";"-";"-";"-";"-";"-";"-";"-";"-";"-";"-";"-"
"11 Lip 2024 19:20:58";" Transakcja Kupna";"O2-CZ-93RW0F";"T2-CZ-5HCZ70";"-";"Solana (USD)";"62 Jednost.";"138,875";"-";"136,098";"-";"-";"3,938701";"33 913,20";"0,00";"-";"-";"-";"-";"-";"-";"-";"-";"-";"-";"-";"-";"-";"-";"-";"-";"-";"-";"-";"-";"-";"-";"-";"-";"-"
"11 Lip 2024 11:28:06";" Wpłata";"1353359937";"BD.61670635";"-";"Rachunek";"-";"-";"-";"-";"-";"-";"-";"-";"5 000,00";"19 205,71";"5 000,00";"0,00";"-";"-";"-";"-";"-";"-";"-";"-";"-";"-";"-";"-";"-";"-";"-";"-";"-";"-";"-";"-";"-";"-"
"10 Lip 2024 21:09:58";"Stop Loss";"O2-CZ-93NBC2";"T2-CZ-5HB51Z";"-";"Solana (USD)";"50 Jednost.";"140,705";"-";"-";"-";"-";"3,91617";"27 828,10";"42,10";"14 205,71";"-";"-";"-";"-";"-";"-";"-";"-";"-";"-";"-";"-";"-";"-";"-";"-";"-";"-";"-";"-";"-";"-";"-";"-"
"10 Lip 2024 21:03:49";"Zmodyfikowano Transakcję Sprzedaży";"O2-CZ-93NBC2";"T2-CZ-5HB39J";"-";"Solana (USD)";"50 Jednost.";"140,920";"-";"140,700";"139,500";"-";"-";"-";"0,00";"-";"-";"-";"-";"-";"-";"-";"-";"-";"-";"-";"-";"-";"-";"-";"-";"-";"-";"-";"-";"-";"-";"-";"-";"-"
"10 Lip 2024 20:15:46";"Zmodyfikowano Transakcję Sprzedaży";"O2-CZ-93NBC2";"T2-CZ-5HB39J";"-";"Solana (USD)";"50 Jednost.";"140,920";"-";"-";"139,500";"-";"-";"-";"0,00";"-";"-";"-";"-";"-";"-";"-";"-";"-";"-";"-";"-";"-";"-";"-";"-";"-";"-";"-";"-";"-";"-";"-";"-";"-"
"10 Lip 2024 20:06:30";"Transakcja Sprzedaży";"O2-CZ-93NBC2";"T2-CZ-5HB39J";"-";"Solana (USD)";"50 Jednost.";"140,920";"-";"143,738";"-";"-";"3,957509";"27 884,60";"0,00";"-";"-";"-";"-";"-";"-";"-";"-";"-";"-";"-";"-";"-";"-";"-";"-";"-";"-";"-";"-";"-";"-";"-";"-";"-"
"10 Lip 2024 18:24:41";"Stop Loss";"O2-CZ-93N4FE";"T2-CZ-5H9YMJ";"-";"Solana (USD)";"50 Jednost.";"142,025";"-";"-";"-";"-";"3,91515";"28 081,84";"14,68";"14 163,61";"-";"-";"-";"-";"-";"-";"-";"-";"-";"-";"-";"-";"-";"-";"-";"-";"-";"-";"-";"-";"-";"-";"-";"-"
"10 Lip 2024 18:24:36";"Zmodyfikowano Stop Loss";"O2-CZ-93N4FE";"-";"O2-CZ-93N4FF";"Solana (USD)";"50 Jednost.";"142,100";"-";"142,000";"-";"-";"-";"-";"-";"-";"-";"-";"-";"-";"-";"-";"-";"-";"-";"-";"-";"-";"-";"-";"-";"-";"-";"-";"-";"-";"-";"-";"-";"-"
"10 Lip 2024 18:17:17";"Transakcja Sprzedaży";"O2-CZ-93N4FE";"T2-CZ-5H9Y2M";"-";"Solana (USD)";"50 Jednost.";"142,100";"-";"144,942";"-";"-";"3,955254";"28 102,07";"0,00";"-";"-";"-";"-";"-";"-";"-";"-";"-";"-";"-";"-";"-";"-";"-";"-";"-";"-";"-";"-";"-";"-";"-";"-";"-"
"10 Lip 2024 16:17:59";" Zamknięcie Transakcji";"O2-CZ-93MVXQ";"T2-CZ-5H9PX3";"O2-CZ-93LKY4";"Solana (USD)";"31 Jednost.";"141,225";"-";"-";"-";"-";"3,946306";"17 276,82";"-34,25";"14 148,93";"-";"-";"-";"-";"-";"-";"-";"-";"-";"-";"-";"-";"-";"-";"-";"-";"-";"-";"-";"-";"-";"-";"-";"-"
"10 Lip 2024 16:17:32";" Zamknięcie Transakcji";"O2-CZ-93MVVS";"T2-CZ-5H9PVW";"O2-CZ-93MKDE";"Solana (USD)";"18 Jednost.";"141,254";"-";"-";"-";"-";"3,90731";"10 034,48";"109,44";"14 183,18";"-";"-";"-";"-";"-";"-";"-";"-";"-";"-";"-";"-";"-";"-";"-";"-";"-";"-";"-";"-";"-";"-";"-";"-"
"10 Lip 2024 15:07:55";"Zmodyfikowano Transakcję Sprzedaży";"O2-CZ-93MKDE";"T2-CZ-5H9FV3";"-";"Solana (USD)";"18 Jednost.";"142,810";"-";"-";"140,000";"-";"-";"-";"0,00";"-";"-";"-";"-";"-";"-";"-";"-";"-";"-";"-";"-";"-";"-";"-";"-";"-";"-";"-";"-";"-";"-";"-";"-";"-"
"10 Lip 2024 14:19:55";"Transakcja Sprzedaży";"O2-CZ-93MKDE";"T2-CZ-5H9FV3";"-";"Solana (USD)";"18 Jednost.";"142,810";"-";"-";"-";"-";"3,948872";"10 150,89";"0,00";"-";"-";"-";"-";"-";"-";"-";"-";"-";"-";"-";"-";"-";"-";"-";"-";"-";"-";"-";"-";"-";"-";"-";"-";"-"
"10 Lip 2024 12:00:46";" Wpłata";"1352998888";"BD.25623428";"-";"Rachunek";"-";"-";"-";"-";"-";"-";"-";"-";"5 000,00";"14 073,74";"5 000,00";"0,00";"-";"-";"-";"-";"-";"-";"-";"-";"-";"-";"-";"-";"-";"-";"-";"-";"-";"-";"-";"-";"-";"-"
"10 Lip 2024 08:45:33";"Zmodyfikowano Take Profit";"O2-CZ-93LKY4";"-";"O2-CZ-93LV2S";"Solana (USD)";"31 Jednost.";"140,945";"-";"-";"140,000";"-";"-";"-";"-";"-";"-";"-";"-";"-";"-";"-";"-";"-";"-";"-";"-";"-";"-";"-";"-";"-";"-";"-";"-";"-";"-";"-";"-";"-"
"09 Lip 2024 23:28:21";"Zmodyfikowano Take Profit";"O2-CZ-93LKY4";"-";"O2-CZ-93LV2S";"Solana (USD)";"31 Jednost.";"140,945";"-";"-";"135,500";"-";"-";"-";"-";"-";"-";"-";"-";"-";"-";"-";"-";"-";"-";"-";"-";"-";"-";"-";"-";"-";"-";"-";"-";"-";"-";"-";"-";"-"
"09 Lip 2024 23:13:37";"Zmodyfikowano Transakcję Sprzedaży";"O2-CZ-93LKY4";"T2-CZ-5H8MYB";"-";"Solana (USD)";"31 Jednost.";"140,945";"-";"-";"137,500";"-";"-";"-";"0,00";"-";"-";"-";"-";"-";"-";"-";"-";"-";"-";"-";"-";"-";"-";"-";"-";"-";"-";"-";"-";"-";"-";"-";"-";"-"
"09 Lip 2024 23:00:59";"Koszty Utrzymania Pozycji";"1352816392";"-";"-";"Rachunek";"-";"-";"-";"-";"-";"-";"-";"-";"4,74";"9 073,74";"-";"-";"-";"-";"-";"4,74";"-";"-";"-";"-";"-";"-";"-";"-";"-";"-";"-";"-";"-";"-";"-";"-";"-";"-"
"09 Lip 2024 23:00:59";"Koszty Utrzymania Pozycji";"O2-CZ-93LKY4";"-";"-";"Solana (USD)";"-";"-";"-";"-";"-";"-";"-";"-";"-";"-";"-";"-";"4 421,06";"-10,00000%";"4,74";"4,74";"-";"-";"-";"-";"-";"-";"-";"-";"-";"-";"-";"-";"-";"-";"-";"-";"-";"-"
"09 Lip 2024 22:01:21";"Zmodyfikowano Transakcję Sprzedaży";"O2-CZ-93LKY4";"T2-CZ-5H8MYB";"-";"Solana (USD)";"31 Jednost.";"140,945";"-";"-";"-";"-";"-";"-";"0,00";"-";"-";"-";"-";"-";"-";"-";"-";"-";"-";"-";"-";"-";"-";"-";"-";"-";"-";"-";"-";"-";"-";"-";"-";"-"
"09 Lip 2024 18:42:56";"Transakcja Sprzedaży";"O2-CZ-93LKY4";"T2-CZ-5H8MYB";"-";"Solana (USD)";"31 Jednost.";"140,945";"-";"143,763";"-";"-";"3,959623";"17 300,76";"0,00";"-";"-";"-";"-";"-";"-";"-";"-";"-";"-";"-";"-";"-";"-";"-";"-";"-";"-";"-";"-";"-";"-";"-";"-";"-"
"09 Lip 2024 17:50:57";" Zamknięcie Transakcji";"O2-CZ-93LH3S";"T2-CZ-5H8KJ8";"O2-CZ-93LCNV";"Solana (USD)";"31 Jednost.";"140,068";"-";"-";"-";"-";"3,92271";"17 204,03";"5,23";"9 069,00";"-";"-";"-";"-";"-";"-";"-";"-";"-";"-";"-";"-";"-";"-";"-";"-";"-";"-";"-";"-";"-";"-";"-";"-"
"09 Lip 2024 16:52:37";" Transakcja Kupna";"O2-CZ-93LCNV";"T2-CZ-5H8FJV";"-";"Solana (USD)";"31 Jednost.";"140,025";"-";"-";"-";"-";"3,959934";"17 189,18";"0,00";"-";"-";"-";"-";"-";"-";"-";"-";"-";"-";"-";"-";"-";"-";"-";"-";"-";"-";"-";"-";"-";"-";"-";"-";"-"
"09 Lip 2024 12:36:14";"Stop Loss";"O2-CZ-93KLP2";"T2-CZ-5H7WQ3";"-";"Solana (USD)";"31 Jednost.";"141,555";"-";"-";"-";"-";"3,91292";"17 343,27";"157,08";"9 063,77";"-";"-";"-";"-";"-";"-";"-";"-";"-";"-";"-";"-";"-";"-";"-";"-";"-";"-";"-";"-";"-";"-";"-";"-"
"09 Lip 2024 12:26:21";"Zmodyfikowano Transakcję Sprzedaży";"O2-CZ-93KLP2";"T2-CZ-5H7SKL";"-";"Solana (USD)";"31 Jednost.";"142,850";"-";"141,500";"-";"-";"-";"-";"0,00";"-";"-";"-";"-";"-";"-";"-";"-";"-";"-";"-";"-";"-";"-";"-";"-";"-";"-";"-";"-";"-";"-";"-";"-";"-"
"09 Lip 2024 10:32:14";"Transakcja Sprzedaży";"O2-CZ-93KLP2";"T2-CZ-5H7SKL";"-";"Solana (USD)";"31 Jednost.";"142,850";"-";"-";"-";"-";"3,961998";"17 545,11";"0,00";"-";"-";"-";"-";"-";"-";"-";"-";"-";"-";"-";"-";"-";"-";"-";"-";"-";"-";"-";"-";"-";"-";"-";"-";"-"
"09 Lip 2024 10:00:48";"Stop Loss";"O2-CZ-93KH23";"T2-CZ-5H7RM5";"-";"Solana (USD)";"31 Jednost.";"142,300";"-";"-";"-";"-";"3,92505";"17 488,56";"38,94";"8 906,69";"-";"-";"-";"-";"-";"-";"-";"-";"-";"-";"-";"-";"-";"-";"-";"-";"-";"-";"-";"-";"-";"-";"-";"-"
"09 Lip 2024 09:57:39";"Zmodyfikowano Transakcję Sprzedaży";"O2-CZ-93KH23";"T2-CZ-5H7PKK";"-";"Solana (USD)";"31 Jednost.";"142,620";"-";"142,300";"-";"-";"-";"-";"0,00";"-";"-";"-";"-";"-";"-";"-";"-";"-";"-";"-";"-";"-";"-";"-";"-";"-";"-";"-";"-";"-";"-";"-";"-";"-"
"09 Lip 2024 09:16:10";"Transakcja Sprzedaży";"O2-CZ-93KH23";"T2-CZ-5H7PKK";"-";"Solana (USD)";"31 Jednost.";"142,620";"-";"-";"-";"-";"3,956998";"17 494,75";"0,00";"-";"-";"-";"-";"-";"-";"-";"-";"-";"-";"-";"-";"-";"-";"-";"-";"-";"-";"-";"-";"-";"-";"-";"-";"-"
"08 Lip 2024 18:18:23";"Stop Loss";"O2-CZ-93JRWP";"T2-CZ-5H75EG";"-";"Solana (USD)";"31 Jednost.";"136,801";"-";"-";"-";"-";"3,91928";"16 788,05";"22,96";"8 867,75";"-";"-";"-";"-";"-";"-";"-";"-";"-";"-";"-";"-";"-";"-";"-";"-";"-";"-";"-";"-";"-";"-";"-";"-"
"08 Lip 2024 18:18:16";"Zmodyfikowano Transakcję Sprzedaży";"O2-CZ-93JRWP";"T2-CZ-5H735J";"-";"Solana (USD)";"31 Jednost.";"136,990";"-";"136,800";"-";"-";"-";"-";"0,00";"-";"-";"-";"-";"-";"-";"-";"-";"-";"-";"-";"-";"-";"-";"-";"-";"-";"-";"-";"-";"-";"-";"-";"-";"-"
"08 Lip 2024 17:42:24";"Transakcja Sprzedaży";"O2-CZ-93JRWP";"T2-CZ-5H735J";"-";"Solana (USD)";"31 Jednost.";"136,990";"-";"-";"-";"-";"3,958561";"16 810,78";"0,00";"-";"-";"-";"-";"-";"-";"-";"-";"-";"-";"-";"-";"-";"-";"-";"-";"-";"-";"-";"-";"-";"-";"-";"-";"-"
"08 Lip 2024 17:38:41";"Stop Loss";"O2-CZ-93JP4X";"T2-CZ-5H730D";"-";"Solana (USD)";"31 Jednost.";"138,020";"-";"-";"-";"-";"3,91883";"16 935,71";"26,12";"8 844,79";"-";"-";"-";"-";"-";"-";"-";"-";"-";"-";"-";"-";"-";"-";"-";"-";"-";"-";"-";"-";"-";"-";"-";"-"
"08 Lip 2024 17:38:39";"Zmodyfikowano Transakcję Sprzedaży";"O2-CZ-93JP4X";"T2-CZ-5H70T0";"-";"Solana (USD)";"31 Jednost.";"138,235";"-";"138,000";"-";"-";"-";"-";"0,00";"-";"-";"-";"-";"-";"-";"-";"-";"-";"-";"-";"-";"-";"-";"-";"-";"-";"-";"-";"-";"-";"-";"-";"-";"-"
"08 Lip 2024 17:02:57";"Transakcja Sprzedaży";"O2-CZ-93JP4X";"T2-CZ-5H70T0";"-";"Solana (USD)";"31 Jednost.";"138,235";"-";"-";"-";"-";"3,95826";"16 962,27";"0,00";"-";"-";"-";"-";"-";"-";"-";"-";"-";"-";"-";"-";"-";"-";"-";"-";"-";"-";"-";"-";"-";"-";"-";"-";"-"
"08 Lip 2024 16:52:34";"Stop Loss";"O2-CZ-93JN8T";"T2-CZ-5H706Y";"-";"Solana (USD)";"31 Jednost.";"138,504";"-";"-";"-";"-";"3,91774";"16 990,33";"35,95";"8 818,67";"-";"-";"-";"-";"-";"-";"-";"-";"-";"-";"-";"-";"-";"-";"-";"-";"-";"-";"-";"-";"-";"-";"-";"-"
"08 Lip 2024 16:52:25";"Zmodyfikowano Transakcję Sprzedaży";"O2-CZ-93JN8T";"T2-CZ-5H703H";"-";"Solana (USD)";"31 Jednost.";"138,800";"-";"138,500";"-";"-";"-";"-";"0,00";"-";"-";"-";"-";"-";"-";"-";"-";"-";"-";"-";"-";"-";"-";"-";"-";"-";"-";"-";"-";"-";"-";"-";"-";"-"
"08 Lip 2024 16:50:11";"Transakcja Sprzedaży";"O2-CZ-93JN8T";"T2-CZ-5H703H";"-";"Solana (USD)";"31 Jednost.";"138,800";"-";"-";"-";"-";"3,960375";"17 040,70";"0,00";"-";"-";"-";"-";"-";"-";"-";"-";"-";"-";"-";"-";"-";"-";"-";"-";"-";"-";"-";"-";"-";"-";"-";"-";"-"
"08 Lip 2024 16:35:02";"Stop Loss";"O2-CZ-93J9KD";"T2-CZ-5H6Z5L";"-";"Solana (USD)";"27 Jednost.";"135,010";"-";"-";"-";"-";"3,91714";"14 422,53";"569,53";"8 782,72";"-";"-";"-";"-";"-";"-";"-";"-";"-";"-";"-";"-";"-";"-";"-";"-";"-";"-";"-";"-";"-";"-";"-";"-"
"08 Lip 2024 16:34:31";"Zmodyfikowano Stop Loss";"O2-CZ-93J9KD";"-";"O2-CZ-93JLSE";"Solana (USD)";"27 Jednost.";"140,395";"-";"135,000";"-";"-";"-";"-";"-";"-";"-";"-";"-";"-";"-";"-";"-";"-";"-";"-";"-";"-";"-";"-";"-";"-";"-";"-";"-";"-";"-";"-";"-";"-"
"08 Lip 2024 16:34:03";"Zmodyfikowano Stop Loss";"O2-CZ-93J9KD";"-";"O2-CZ-93JLSE";"Solana (USD)";"27 Jednost.";"140,395";"-";"135,500";"-";"-";"-";"-";"-";"-";"-";"-";"-";"-";"-";"-";"-";"-";"-";"-";"-";"-";"-";"-";"-";"-";"-";"-";"-";"-";"-";"-";"-";"-"
"08 Lip 2024 16:32:38";"Zmodyfikowano Stop Loss";"O2-CZ-93J9KD";"-";"O2-CZ-93JLSE";"Solana (USD)";"27 Jednost.";"140,395";"-";"136,500";"-";"-";"-";"-";"-";"-";"-";"-";"-";"-";"-";"-";"-";"-";"-";"-";"-";"-";"-";"-";"-";"-";"-";"-";"-";"-";"-";"-";"-";"-"
"08 Lip 2024 16:30:28";"Zmodyfikowano Stop Loss";"O2-CZ-93J9KD";"-";"O2-CZ-93JLSE";"Solana (USD)";"27 Jednost.";"140,395";"-";"138,000";"-";"-";"-";"-";"-";"-";"-";"-";"-";"-";"-";"-";"-";"-";"-";"-";"-";"-";"-";"-";"-";"-";"-";"-";"-";"-";"-";"-";"-";"-"
"08 Lip 2024 16:29:19";"Zmodyfikowano Stop Loss";"O2-CZ-93J9KD";"-";"O2-CZ-93JLSE";"Solana (USD)";"27 Jednost.";"140,395";"-";"138,500";"-";"-";"-";"-";"-";"-";"-";"-";"-";"-";"-";"-";"-";"-";"-";"-";"-";"-";"-";"-";"-";"-";"-";"-";"-";"-";"-";"-";"-";"-"
"08 Lip 2024 16:28:44";"Zmodyfikowano Transakcję Sprzedaży";"O2-CZ-93J9KD";"T2-CZ-5H6P37";"-";"Solana (USD)";"27 Jednost.";"140,395";"-";"139,000";"-";"-";"-";"-";"0,00";"-";"-";"-";"-";"-";"-";"-";"-";"-";"-";"-";"-";"-";"-";"-";"-";"-";"-";"-";"-";"-";"-";"-";"-";"-"
"08 Lip 2024 14:19:42";"Transakcja Sprzedaży";"O2-CZ-93J9KD";"T2-CZ-5H6P37";"-";"Solana (USD)";"27 Jednost.";"140,395";"-";"-";"-";"-";"3,964252";"15 027,15";"0,00";"-";"-";"-";"-";"-";"-";"-";"-";"-";"-";"-";"-";"-";"-";"-";"-";"-";"-";"-";"-";"-";"-";"-";"-";"-"
"08 Lip 2024 12:34:50";" Wpłata";"1352255390";"BD.57562814";"-";"Rachunek";"-";"-";"-";"-";"-";"-";"-";"-";"5 000,00";"8 213,19";"5 000,00";"0,00";"-";"-";"-";"-";"-";"-";"-";"-";"-";"-";"-";"-";"-";"-";"-";"-";"-";"-";"-";"-";"-";"-"
"02 Lip 2024 23:08:12";" Likwidacja";"O2-CZ-93D3BF";"T2-CZ-5H2CCJ";"O2-CY-92YP40";"Solana (USD)";"30 Jednost.";"153,347";"-";"-";"-";"-";"4,034843";"18 561,93";"-2 389,07";"3 213,19";"-";"-";"-";"-";"-";"-";"-";"-";"-";"-";"-";"-";"-";"-";"-";"-";"-";"-";"-";"-";"-";"-";"-";"-"
"02 Lip 2024 23:08:12";" Likwidacja";"O2-CZ-93D3BF";"T2-CZ-5H2CCH";"O2-CY-92PYGJ";"Solana (USD)";"51 Jednost.";"153,347";"-";"-";"-";"-";"4,034843";"31 555,28";"-4 559,81";"5 602,26";"-";"-";"-";"-";"-";"-";"-";"-";"-";"-";"-";"-";"-";"-";"-";"-";"-";"-";"-";"-";"-";"-";"-";"-"
"02 Lip 2024 23:08:12";" Likwidacja";"O2-CZ-93D3BF";"T2-CZ-5H2CCG";"O2-CX-9250PH";"Solana (USD)";"16 Jednost.";"153,347";"-";"-";"-";"-";"3,9947";"9 899,69";"1 070,13";"10 162,07";"-";"-";"-";"-";"-";"-";"-";"-";"-";"-";"-";"-";"-";"-";"-";"-";"-";"-";"-";"-";"-";"-";"-";"-"
"02 Lip 2024 23:08:12";" Likwidacja";"O2-CZ-93D3BF";"T2-CZ-5H2CCF";"O2-CX-9250P8";"Solana (USD)";"16,15 Jednost.";"153,347";"-";"-";"-";"-";"3,9947";"9 992,50";"1 095,00";"9 091,94";"-";"-";"-";"-";"-";"-";"-";"-";"-";"-";"-";"-";"-";"-";"-";"-";"-";"-";"-";"-";"-";"-";"-";"-"
"02 Lip 2024 23:08:12";" Likwidacja";"O2-CZ-93D3BE";"T2-CZ-5H2CCE";"O2-CY-92YRDC";"Solana (USD)";"29 Jednost.";"153,147";"-";"-";"-";"-";"3,9947";"17 919,79";"2 051,29";"7 996,94";"-";"-";"-";"-";"-";"-";"-";"-";"-";"-";"-";"-";"-";"-";"-";"-";"-";"-";"-";"-";"-";"-";"-";"-"
"02 Lip 2024 23:08:12";" Likwidacja";"O2-CZ-93D3BE";"T2-CZ-5H2CCD";"O2-CX-922YGK";"Solana (USD)";"20,5 Jednost.";"153,147";"-";"-";"-";"-";"4,034843";"12 667,44";"-1 683,15";"5 945,65";"-";"-";"-";"-";"-";"-";"-";"-";"-";"-";"-";"-";"-";"-";"-";"-";"-";"-";"-";"-";"-";"-";"-";"-"
"02 Lip 2024 23:08:12";" Likwidacja";"O2-CZ-93D3BE";"T2-CZ-5H2CCC";"O2-CX-922YEX";"Solana (USD)";"20,65 Jednost.";"153,147";"-";"-";"-";"-";"4,034843";"12 760,13";"-1 688,39";"7 628,80";"-";"-";"-";"-";"-";"-";"-";"-";"-";"-";"-";"-";"-";"-";"-";"-";"-";"-";"-";"-";"-";"-";"-";"-"
"02 Lip 2024 23:08:12";" Likwidacja";"O2-CZ-93D3BE";"T2-CZ-5H2CCB";"O2-CW-916WS8";"Solana (USD)";"21 Jednost.";"153,147";"-";"-";"-";"-";"4,034843";"12 976,40";"-2 709,13";"9 317,19";"-";"-";"-";"-";"-";"-";"-";"-";"-";"-";"-";"-";"-";"-";"-";"-";"-";"-";"-";"-";"-";"-";"-";"-"
"02 Lip 2024 23:01:01";"Koszty Utrzymania Pozycji";"1350956985";"-";"-";"Rachunek";"-";"-";"-";"-";"-";"-";"-";"-";"-23,42";"12 026,32";"-";"-";"-";"-";"-";"-23,42";"-";"-";"-";"-";"-";"-";"-";"-";"-";"-";"-";"-";"-";"-";"-";"-";"-";"-"
"02 Lip 2024 23:01:01";"Koszty Utrzymania Pozycji";"O2-CY-92YRDC";"-";"-";"Solana (USD)";"-";"-";"-";"-";"-";"-";"-";"-";"-";"-";"-";"-";"4 433,52";"-27,50000%";"-13,46";"-13,46";"-";"-";"-";"-";"-";"-";"-";"-";"-";"-";"-";"-";"-";"-";"-";"-";"-";"-"
"02 Lip 2024 23:01:01";"Koszty Utrzymania Pozycji";"O2-CW-916WS8";"-";"-";"Solana (USD)";"-";"-";"-";"-";"-";"-";"-";"-";"-";"-";"-";"-";"3 210,48";"-27,50000%";"-9,75";"-9,75";"-";"-";"-";"-";"-";"-";"-";"-";"-";"-";"-";"-";"-";"-";"-";"-";"-";"-"
"02 Lip 2024 23:01:01";"Koszty Utrzymania Pozycji";"O2-CX-922YGK";"-";"-";"Solana (USD)";"-";"-";"-";"-";"-";"-";"-";"-";"-";"-";"-";"-";"3 134,04";"-27,50000%";"-9,52";"-9,52";"-";"-";"-";"-";"-";"-";"-";"-";"-";"-";"-";"-";"-";"-";"-";"-";"-";"-"
"02 Lip 2024 23:01:01";"Koszty Utrzymania Pozycji";"O2-CX-9250PH";"-";"-";"Solana (USD)";"-";"-";"-";"-";"-";"-";"-";"-";"-";"-";"-";"-";"2 446,08";"-10,00000%";"2,67";"2,67";"-";"-";"-";"-";"-";"-";"-";"-";"-";"-";"-";"-";"-";"-";"-";"-";"-";"-"
"02 Lip 2024 23:01:01";"Koszty Utrzymania Pozycji";"O2-CX-9250P8";"-";"-";"Solana (USD)";"-";"-";"-";"-";"-";"-";"-";"-";"-";"-";"-";"-";"2 469,01";"-10,00000%";"2,70";"2,70";"-";"-";"-";"-";"-";"-";"-";"-";"-";"-";"-";"-";"-";"-";"-";"-";"-";"-"
"02 Lip 2024 23:01:01";"Koszty Utrzymania Pozycji";"O2-CX-922YEX";"-";"-";"Solana (USD)";"-";"-";"-";"-";"-";"-";"-";"-";"-";"-";"-";"-";"3 156,97";"-27,50000%";"-9,59";"-9,59";"-";"-";"-";"-";"-";"-";"-";"-";"-";"-";"-";"-";"-";"-";"-";"-";"-";"-"
"02 Lip 2024 23:01:01";"Koszty Utrzymania Pozycji";"O2-CY-92PYGJ";"-";"-";"Solana (USD)";"-";"-";"-";"-";"-";"-";"-";"-";"-";"-";"-";"-";"7 796,88";"-10,00000%";"8,52";"8,52";"-";"-";"-";"-";"-";"-";"-";"-";"-";"-";"-";"-";"-";"-";"-";"-";"-";"-"
"02 Lip 2024 23:01:01";"Koszty Utrzymania Pozycji";"O2-CY-92YP40";"-";"-";"Solana (USD)";"-";"-";"-";"-";"-";"-";"-";"-";"-";"-";"-";"-";"4 586,40";"-10,00000%";"5,01";"5,01";"-";"-";"-";"-";"-";"-";"-";"-";"-";"-";"-";"-";"-";"-";"-";"-";"-";"-"
"01 Lip 2024 23:01:03";"Koszty Utrzymania Pozycji";"1350523401";"-";"-";"Rachunek";"-";"-";"-";"-";"-";"-";"-";"-";"-22,61";"12 049,74";"-";"-";"-";"-";"-";"-22,61";"-";"-";"-";"-";"-";"-";"-";"-";"-";"-";"-";"-";"-";"-";"-";"-";"-";"-"
"01 Lip 2024 23:01:03";"Koszty Utrzymania Pozycji";"O2-CY-92YRDC";"-";"-";"Solana (USD)";"-";"-";"-";"-";"-";"-";"-";"-";"-";"-";"-";"-";"4 274,60";"-27,50000%";"-13,01";"-13,01";"-";"-";"-";"-";"-";"-";"-";"-";"-";"-";"-";"-";"-";"-";"-";"-";"-";"-"
"01 Lip 2024 23:01:03";"Koszty Utrzymania Pozycji";"O2-CW-916WS8";"-";"-";"Solana (USD)";"-";"-";"-";"-";"-";"-";"-";"-";"-";"-";"-";"-";"3 095,40";"-27,50000%";"-9,42";"-9,42";"-";"-";"-";"-";"-";"-";"-";"-";"-";"-";"-";"-";"-";"-";"-";"-";"-";"-"
"01 Lip 2024 23:01:03";"Koszty Utrzymania Pozycji";"O2-CX-922YGK";"-";"-";"Solana (USD)";"-";"-";"-";"-";"-";"-";"-";"-";"-";"-";"-";"-";"3 021,70";"-27,50000%";"-9,20";"-9,20";"-";"-";"-";"-";"-";"-";"-";"-";"-";"-";"-";"-";"-";"-";"-";"-";"-";"-"
"01 Lip 2024 23:01:03";"Koszty Utrzymania Pozycji";"O2-CX-9250PH";"-";"-";"Solana (USD)";"-";"-";"-";"-";"-";"-";"-";"-";"-";"-";"-";"-";"2 358,40";"-10,00000%";"2,58";"2,58";"-";"-";"-";"-";"-";"-";"-";"-";"-";"-";"-";"-";"-";"-";"-";"-";"-";"-"
"01 Lip 2024 23:01:03";"Koszty Utrzymania Pozycji";"O2-CX-9250P8";"-";"-";"Solana (USD)";"-";"-";"-";"-";"-";"-";"-";"-";"-";"-";"-";"-";"2 380,51";"-10,00000%";"2,61";"2,61";"-";"-";"-";"-";"-";"-";"-";"-";"-";"-";"-";"-";"-";"-";"-";"-";"-";"-"
"01 Lip 2024 23:01:03";"Koszty Utrzymania Pozycji";"O2-CX-922YEX";"-";"-";"Solana (USD)";"-";"-";"-";"-";"-";"-";"-";"-";"-";"-";"-";"-";"3 043,81";"-27,50000%";"-9,26";"-9,26";"-";"-";"-";"-";"-";"-";"-";"-";"-";"-";"-";"-";"-";"-";"-";"-";"-";"-"
"01 Lip 2024 23:01:03";"Koszty Utrzymania Pozycji";"O2-CY-92PYGJ";"-";"-";"Solana (USD)";"-";"-";"-";"-";"-";"-";"-";"-";"-";"-";"-";"-";"7 517,40";"-10,00000%";"8,24";"8,24";"-";"-";"-";"-";"-";"-";"-";"-";"-";"-";"-";"-";"-";"-";"-";"-";"-";"-"
"01 Lip 2024 23:01:03";"Koszty Utrzymania Pozycji";"O2-CY-92YP40";"-";"-";"Solana (USD)";"-";"-";"-";"-";"-";"-";"-";"-";"-";"-";"-";"-";"4 422,00";"-10,00000%";"4,85";"4,85";"-";"-";"-";"-";"-";"-";"-";"-";"-";"-";"-";"-";"-";"-";"-";"-";"-";"-"
"28 Cze 2024 23:01:04";"Koszty Utrzymania Pozycji";"1350098193";"-";"-";"Rachunek";"-";"-";"-";"-";"-";"-";"-";"-";"-64,80";"12 072,35";"-";"-";"-";"-";"-";"-64,80";"-";"-";"-";"-";"-";"-";"-";"-";"-";"-";"-";"-";"-";"-";"-";"-";"-";"-"
"28 Cze 2024 23:01:04";"Koszty Utrzymania Pozycji";"O2-CY-92YP40";"-";"-";"Solana (USD)";"-";"-";"-";"-";"-";"-";"-";"-";"-";"-";"-";"-";"4 218,75";"-10,00000%";"13,89";"13,89";"-";"-";"-";"-";"-";"-";"-";"-";"-";"-";"-";"-";"-";"-";"-";"-";"-";"-"
"28 Cze 2024 23:01:04";"Koszty Utrzymania Pozycji";"O2-CY-92YRDC";"-";"-";"Solana (USD)";"-";"-";"-";"-";"-";"-";"-";"-";"-";"-";"-";"-";"4 078,12";"-27,50000%";"-37,28";"-37,28";"-";"-";"-";"-";"-";"-";"-";"-";"-";"-";"-";"-";"-";"-";"-";"-";"-";"-"
"28 Cze 2024 23:01:04";"Koszty Utrzymania Pozycji";"O2-CX-9250PH";"-";"-";"Solana (USD)";"-";"-";"-";"-";"-";"-";"-";"-";"-";"-";"-";"-";"2 250,00";"-10,00000%";"7,41";"7,41";"-";"-";"-";"-";"-";"-";"-";"-";"-";"-";"-";"-";"-";"-";"-";"-";"-";"-"
"28 Cze 2024 23:01:04";"Koszty Utrzymania Pozycji";"O2-CY-92PYGJ";"-";"-";"Solana (USD)";"-";"-";"-";"-";"-";"-";"-";"-";"-";"-";"-";"-";"7 171,87";"-10,00000%";"23,61";"23,61";"-";"-";"-";"-";"-";"-";"-";"-";"-";"-";"-";"-";"-";"-";"-";"-";"-";"-"
"28 Cze 2024 23:01:04";"Koszty Utrzymania Pozycji";"O2-CX-922YGK";"-";"-";"Solana (USD)";"-";"-";"-";"-";"-";"-";"-";"-";"-";"-";"-";"-";"2 882,81";"-27,50000%";"-26,36";"-26,36";"-";"-";"-";"-";"-";"-";"-";"-";"-";"-";"-";"-";"-";"-";"-";"-";"-";"-"
"28 Cze 2024 23:01:04";"Koszty Utrzymania Pozycji";"O2-CX-922YEX";"-";"-";"Solana (USD)";"-";"-";"-";"-";"-";"-";"-";"-";"-";"-";"-";"-";"2 903,90";"-27,50000%";"-26,55";"-26,55";"-";"-";"-";"-";"-";"-";"-";"-";"-";"-";"-";"-";"-";"-";"-";"-";"-";"-"
"28 Cze 2024 23:01:04";"Koszty Utrzymania Pozycji";"O2-CX-9250P8";"-";"-";"Solana (USD)";"-";"-";"-";"-";"-";"-";"-";"-";"-";"-";"-";"-";"2 271,09";"-10,00000%";"7,48";"7,48";"-";"-";"-";"-";"-";"-";"-";"-";"-";"-";"-";"-";"-";"-";"-";"-";"-";"-"
"28 Cze 2024 23:01:04";"Koszty Utrzymania Pozycji";"O2-CW-916WS8";"-";"-";"Solana (USD)";"-";"-";"-";"-";"-";"-";"-";"-";"-";"-";"-";"-";"2 953,12";"-27,50000%";"-27,00";"-27,00";"-";"-";"-";"-";"-";"-";"-";"-";"-";"-";"-";"-";"-";"-";"-";"-";"-";"-"
"27 Cze 2024 23:01:06";"Koszty Utrzymania Pozycji";"1349667731";"-";"-";"Rachunek";"-";"-";"-";"-";"-";"-";"-";"-";"-22,94";"12 137,15";"-";"-";"-";"-";"-";"-22,94";"-";"-";"-";"-";"-";"-";"-";"-";"-";"-";"-";"-";"-";"-";"-";"-";"-";"-"
"27 Cze 2024 23:01:06";"Koszty Utrzymania Pozycji";"O2-CY-92YP40";"-";"-";"Solana (USD)";"-";"-";"-";"-";"-";"-";"-";"-";"-";"-";"-";"-";"4 478,85";"-10,00000%";"4,92";"4,92";"-";"-";"-";"-";"-";"-";"-";"-";"-";"-";"-";"-";"-";"-";"-";"-";"-";"-"
"27 Cze 2024 23:01:06";"Koszty Utrzymania Pozycji";"O2-CY-92YRDC";"-";"-";"Solana (USD)";"-";"-";"-";"-";"-";"-";"-";"-";"-";"-";"-";"-";"4 329,55";"-27,50000%";"-13,20";"-13,20";"-";"-";"-";"-";"-";"-";"-";"-";"-";"-";"-";"-";"-";"-";"-";"-";"-";"-"
"27 Cze 2024 23:01:06";"Koszty Utrzymania Pozycji";"O2-CX-9250PH";"-";"-";"Solana (USD)";"-";"-";"-";"-";"-";"-";"-";"-";"-";"-";"-";"-";"2 388,72";"-10,00000%";"2,62";"2,62";"-";"-";"-";"-";"-";"-";"-";"-";"-";"-";"-";"-";"-";"-";"-";"-";"-";"-"
"27 Cze 2024 23:01:06";"Koszty Utrzymania Pozycji";"O2-CY-92PYGJ";"-";"-";"Solana (USD)";"-";"-";"-";"-";"-";"-";"-";"-";"-";"-";"-";"-";"7 614,04";"-10,00000%";"8,36";"8,36";"-";"-";"-";"-";"-";"-";"-";"-";"-";"-";"-";"-";"-";"-";"-";"-";"-";"-"
"27 Cze 2024 23:01:06";"Koszty Utrzymania Pozycji";"O2-CX-922YGK";"-";"-";"Solana (USD)";"-";"-";"-";"-";"-";"-";"-";"-";"-";"-";"-";"-";"3 060,54";"-27,50000%";"-9,33";"-9,33";"-";"-";"-";"-";"-";"-";"-";"-";"-";"-";"-";"-";"-";"-";"-";"-";"-";"-"
"27 Cze 2024 23:01:06";"Koszty Utrzymania Pozycji";"O2-CX-922YEX";"-";"-";"Solana (USD)";"-";"-";"-";"-";"-";"-";"-";"-";"-";"-";"-";"-";"3 082,94";"-27,50000%";"-9,40";"-9,40";"-";"-";"-";"-";"-";"-";"-";"-";"-";"-";"-";"-";"-";"-";"-";"-";"-";"-"
"27 Cze 2024 23:01:06";"Koszty Utrzymania Pozycji";"O2-CX-9250P8";"-";"-";"Solana (USD)";"-";"-";"-";"-";"-";"-";"-";"-";"-";"-";"-";"-";"2 411,11";"-10,00000%";"2,65";"2,65";"-";"-";"-";"-";"-";"-";"-";"-";"-";"-";"-";"-";"-";"-";"-";"-";"-";"-"
"27 Cze 2024 23:01:06";"Koszty Utrzymania Pozycji";"O2-CW-916WS8";"-";"-";"Solana (USD)";"-";"-";"-";"-";"-";"-";"-";"-";"-";"-";"-";"-";"3 135,19";"-27,50000%";"-9,56";"-9,56";"-";"-";"-";"-";"-";"-";"-";"-";"-";"-";"-";"-";"-";"-";"-";"-";"-";"-"
"26 Cze 2024 23:01:02";"Koszty Utrzymania Pozycji";"1349286365";"-";"-";"Rachunek";"-";"-";"-";"-";"-";"-";"-";"-";"-21,12";"12 160,09";"-";"-";"-";"-";"-";"-21,12";"-";"-";"-";"-";"-";"-";"-";"-";"-";"-";"-";"-";"-";"-";"-";"-";"-";"-"
"26 Cze 2024 23:01:02";"Koszty Utrzymania Pozycji";"O2-CY-92YP40";"-";"-";"Solana (USD)";"-";"-";"-";"-";"-";"-";"-";"-";"-";"-";"-";"-";"4 111,35";"-10,00000%";"4,53";"4,53";"-";"-";"-";"-";"-";"-";"-";"-";"-";"-";"-";"-";"-";"-";"-";"-";"-";"-"
"26 Cze 2024 23:01:02";"Koszty Utrzymania Pozycji";"O2-CY-92YRDC";"-";"-";"Solana (USD)";"-";"-";"-";"-";"-";"-";"-";"-";"-";"-";"-";"-";"3 974,30";"-27,50000%";"-12,15";"-12,15";"-";"-";"-";"-";"-";"-";"-";"-";"-";"-";"-";"-";"-";"-";"-";"-";"-";"-"
"26 Cze 2024 23:01:02";"Koszty Utrzymania Pozycji";"O2-CX-9250PH";"-";"-";"Solana (USD)";"-";"-";"-";"-";"-";"-";"-";"-";"-";"-";"-";"-";"2 192,72";"-10,00000%";"2,41";"2,41";"-";"-";"-";"-";"-";"-";"-";"-";"-";"-";"-";"-";"-";"-";"-";"-";"-";"-"
"26 Cze 2024 23:01:02";"Koszty Utrzymania Pozycji";"O2-CY-92PYGJ";"-";"-";"Solana (USD)";"-";"-";"-";"-";"-";"-";"-";"-";"-";"-";"-";"-";"6 989,29";"-10,00000%";"7,70";"7,70";"-";"-";"-";"-";"-";"-";"-";"-";"-";"-";"-";"-";"-";"-";"-";"-";"-";"-"
"26 Cze 2024 23:01:02";"Koszty Utrzymania Pozycji";"O2-CX-922YGK";"-";"-";"Solana (USD)";"-";"-";"-";"-";"-";"-";"-";"-";"-";"-";"-";"-";"2 809,42";"-27,50000%";"-8,59";"-8,59";"-";"-";"-";"-";"-";"-";"-";"-";"-";"-";"-";"-";"-";"-";"-";"-";"-";"-"
"26 Cze 2024 23:01:02";"Koszty Utrzymania Pozycji";"O2-CX-922YEX";"-";"-";"Solana (USD)";"-";"-";"-";"-";"-";"-";"-";"-";"-";"-";"-";"-";"2 829,97";"-27,50000%";"-8,66";"-8,66";"-";"-";"-";"-";"-";"-";"-";"-";"-";"-";"-";"-";"-";"-";"-";"-";"-";"-"
"26 Cze 2024 23:01:02";"Koszty Utrzymania Pozycji";"O2-CX-9250P8";"-";"-";"Solana (USD)";"-";"-";"-";"-";"-";"-";"-";"-";"-";"-";"-";"-";"2 213,27";"-10,00000%";"2,44";"2,44";"-";"-";"-";"-";"-";"-";"-";"-";"-";"-";"-";"-";"-";"-";"-";"-";"-";"-"
"26 Cze 2024 23:01:02";"Koszty Utrzymania Pozycji";"O2-CW-916WS8";"-";"-";"Solana (USD)";"-";"-";"-";"-";"-";"-";"-";"-";"-";"-";"-";"-";"2 877,94";"-27,50000%";"-8,80";"-8,80";"-";"-";"-";"-";"-";"-";"-";"-";"-";"-";"-";"-";"-";"-";"-";"-";"-";"-"
"26 Cze 2024 14:37:05";" Zamknięcie Transakcji";"O2-CY-930WLQ";"T2-CY-5GTZVX";"O2-CY-92YRDC";"Solana (USD)";"1 Jedn";"136,575";"-";"-";"-";"-";"4,01491";"553,84";"4,56";"12 181,21";"-";"-";"-";"-";"-";"-";"-";"-";"-";"-";"-";"-";"-";"-";"-";"-";"-";"-";"-";"-";"-";"-";"-";"-"
"25 Cze 2024 23:01:05";"Koszty Utrzymania Pozycji";"1348871754";"-";"-";"Rachunek";"-";"-";"-";"-";"-";"-";"-";"-";"-21,60";"12 176,65";"-";"-";"-";"-";"-";"-21,60";"-";"-";"-";"-";"-";"-";"-";"-";"-";"-";"-";"-";"-";"-";"-";"-";"-";"-"
"25 Cze 2024 23:01:05";"Koszty Utrzymania Pozycji";"O2-CY-92YP40";"-";"-";"Solana (USD)";"-";"-";"-";"-";"-";"-";"-";"-";"-";"-";"-";"-";"4 147,05";"-10,00000%";"4,53";"4,53";"-";"-";"-";"-";"-";"-";"-";"-";"-";"-";"-";"-";"-";"-";"-";"-";"-";"-"
"25 Cze 2024 23:01:05";"Koszty Utrzymania Pozycji";"O2-CX-9250PH";"-";"-";"Solana (USD)";"-";"-";"-";"-";"-";"-";"-";"-";"-";"-";"-";"-";"2 211,76";"-10,00000%";"2,42";"2,42";"-";"-";"-";"-";"-";"-";"-";"-";"-";"-";"-";"-";"-";"-";"-";"-";"-";"-"
"25 Cze 2024 23:01:05";"Koszty Utrzymania Pozycji";"O2-CY-92PYGJ";"-";"-";"Solana (USD)";"-";"-";"-";"-";"-";"-";"-";"-";"-";"-";"-";"-";"7 049,98";"-10,00000%";"7,71";"7,71";"-";"-";"-";"-";"-";"-";"-";"-";"-";"-";"-";"-";"-";"-";"-";"-";"-";"-"
"25 Cze 2024 23:01:05";"Koszty Utrzymania Pozycji";"O2-CX-922YGK";"-";"-";"Solana (USD)";"-";"-";"-";"-";"-";"-";"-";"-";"-";"-";"-";"-";"2 833,81";"-27,50000%";"-8,61";"-8,61";"-";"-";"-";"-";"-";"-";"-";"-";"-";"-";"-";"-";"-";"-";"-";"-";"-";"-"
"25 Cze 2024 23:01:05";"Koszty Utrzymania Pozycji";"O2-CY-92YRDC";"-";"-";"Solana (USD)";"-";"-";"-";"-";"-";"-";"-";"-";"-";"-";"-";"-";"4 147,05";"-27,50000%";"-12,60";"-12,60";"-";"-";"-";"-";"-";"-";"-";"-";"-";"-";"-";"-";"-";"-";"-";"-";"-";"-"
"25 Cze 2024 23:01:05";"Koszty Utrzymania Pozycji";"O2-CX-922YEX";"-";"-";"Solana (USD)";"-";"-";"-";"-";"-";"-";"-";"-";"-";"-";"-";"-";"2 854,55";"-27,50000%";"-8,67";"-8,67";"-";"-";"-";"-";"-";"-";"-";"-";"-";"-";"-";"-";"-";"-";"-";"-";"-";"-"
"25 Cze 2024 23:01:05";"Koszty Utrzymania Pozycji";"O2-CX-9250P8";"-";"-";"Solana (USD)";"-";"-";"-";"-";"-";"-";"-";"-";"-";"-";"-";"-";"2 232,49";"-10,00000%";"2,44";"2,44";"-";"-";"-";"-";"-";"-";"-";"-";"-";"-";"-";"-";"-";"-";"-";"-";"-";"-"
"25 Cze 2024 23:01:05";"Koszty Utrzymania Pozycji";"O2-CW-916WS8";"-";"-";"Solana (USD)";"-";"-";"-";"-";"-";"-";"-";"-";"-";"-";"-";"-";"2 902,93";"-27,50000%";"-8,82";"-8,82";"-";"-";"-";"-";"-";"-";"-";"-";"-";"-";"-";"-";"-";"-";"-";"-";"-";"-"
"25 Cze 2024 11:54:14";"Stop Loss";"O2-CY-92R1QR";"T2-CY-5GS8ML";"-";"Solana (USD)";"36 Jednost.";"137,080";"-";"-";"-";"-";"3,98347";"19 855,54";"52,34";"12 198,25";"-";"-";"-";"-";"-";"-";"-";"-";"-";"-";"-";"-";"-";"-";"-";"-";"-";"-";"-";"-";"-";"-";"-";"-"
"25 Cze 2024 11:53:56";" Zmodyfikowano Transakcję Kupna";"O2-CY-92R1QR";"T2-CY-5GLKRP";"-";"Solana (USD)";"36 Jednost.";"136,715";"-";"137,100";"-";"-";"-";"-";"0,00";"-";"-";"-";"-";"-";"-";"-";"-";"-";"-";"-";"-";"-";"-";"-";"-";"-";"-";"-";"-";"-";"-";"-";"-";"-"
"25 Cze 2024 11:34:56";" Zmodyfikowano Transakcję Kupna";"O2-CY-92R1QR";"T2-CY-5GLKRP";"-";"Solana (USD)";"36 Jednost.";"136,715";"-";"-";"-";"-";"-";"-";"0,00";"-";"-";"-";"-";"-";"-";"-";"-";"-";"-";"-";"-";"-";"-";"-";"-";"-";"-";"-";"-";"-";"-";"-";"-";"-"
"25 Cze 2024 11:34:27";" Transakcja Kupna";"O2-CY-92YRDC";"T2-CY-5GS827";"-";"Solana (USD)";"30 Jednost.";"135,440";"-";"-";"-";"-";"4,021226";"16 339,04";"0,00";"-";"-";"-";"-";"-";"-";"-";"-";"-";"-";"-";"-";"-";"-";"-";"-";"-";"-";"-";"-";"-";"-";"-";"-";"-"
"25 Cze 2024 10:45:05";"Transakcja Sprzedaży";"O2-CY-92YP40";"T2-CY-5GS64B";"-";"Solana (USD)";"30 Jednost.";"133,610";"-";"-";"-";"-";"4,019984";"16 113,30";"0,00";"-";"-";"-";"-";"-";"-";"-";"-";"-";"-";"-";"-";"-";"-";"-";"-";"-";"-";"-";"-";"-";"-";"-";"-";"-"
"25 Cze 2024 10:44:49";"Odrzucono Zlecenie: brak wystarczających środków";"O2-CY-92YP2W";"-";"-";"Solana (USD)";"34 Jednost.";"-";"-";"-";"-";"-";"-";"-";"-";"-";"-";"-";"-";"-";"-";"-";"-";"-";"-";"-";"-";"-";"-";"-";"-";"-";"-";"-";"-";"-";"-";"-";"-";"-"
"24 Cze 2024 23:01:07";"Koszty Utrzymania Pozycji";"1348512149";"-";"-";"Rachunek";"-";"-";"-";"-";"-";"-";"-";"-";"-26,49";"12 145,91";"-";"-";"-";"-";"-";"-26,49";"-";"-";"-";"-";"-";"-";"-";"-";"-";"-";"-";"-";"-";"-";"-";"-";"-";"-"
"24 Cze 2024 23:01:07";"Koszty Utrzymania Pozycji";"O2-CY-92R1QR";"-";"-";"Solana (USD)";"-";"-";"-";"-";"-";"-";"-";"-";"-";"-";"-";"-";"4 615,74";"-27,50000%";"-13,98";"-13,98";"-";"-";"-";"-";"-";"-";"-";"-";"-";"-";"-";"-";"-";"-";"-";"-";"-";"-"
"24 Cze 2024 23:01:07";"Koszty Utrzymania Pozycji";"O2-CX-9250PH";"-";"-";"Solana (USD)";"-";"-";"-";"-";"-";"-";"-";"-";"-";"-";"-";"-";"2 051,44";"-10,00000%";"2,24";"2,24";"-";"-";"-";"-";"-";"-";"-";"-";"-";"-";"-";"-";"-";"-";"-";"-";"-";"-"
"24 Cze 2024 23:01:07";"Koszty Utrzymania Pozycji";"O2-CY-92PYGJ";"-";"-";"Solana (USD)";"-";"-";"-";"-";"-";"-";"-";"-";"-";"-";"-";"-";"6 538,96";"-10,00000%";"7,13";"7,13";"-";"-";"-";"-";"-";"-";"-";"-";"-";"-";"-";"-";"-";"-";"-";"-";"-";"-"
"24 Cze 2024 23:01:07";"Koszty Utrzymania Pozycji";"O2-CX-922YGK";"-";"-";"Solana (USD)";"-";"-";"-";"-";"-";"-";"-";"-";"-";"-";"-";"-";"2 628,40";"-27,50000%";"-7,96";"-7,96";"-";"-";"-";"-";"-";"-";"-";"-";"-";"-";"-";"-";"-";"-";"-";"-";"-";"-"
"24 Cze 2024 23:01:07";"Koszty Utrzymania Pozycji";"O2-CX-922YEX";"-";"-";"Solana (USD)";"-";"-";"-";"-";"-";"-";"-";"-";"-";"-";"-";"-";"2 647,63";"-27,50000%";"-8,02";"-8,02";"-";"-";"-";"-";"-";"-";"-";"-";"-";"-";"-";"-";"-";"-";"-";"-";"-";"-"
"24 Cze 2024 23:01:07";"Koszty Utrzymania Pozycji";"O2-CX-9250P8";"-";"-";"Solana (USD)";"-";"-";"-";"-";"-";"-";"-";"-";"-";"-";"-";"-";"2 070,67";"-10,00000%";"2,26";"2,26";"-";"-";"-";"-";"-";"-";"-";"-";"-";"-";"-";"-";"-";"-";"-";"-";"-";"-"
"24 Cze 2024 23:01:07";"Koszty Utrzymania Pozycji";"O2-CW-916WS8";"-";"-";"Solana (USD)";"-";"-";"-";"-";"-";"-";"-";"-";"-";"-";"-";"-";"2 692,51";"-27,50000%";"-8,16";"-8,16";"-";"-";"-";"-";"-";"-";"-";"-";"-";"-";"-";"-";"-";"-";"-";"-";"-";"-"
"24 Cze 2024 21:55:37";"Take Profit";"O2-CY-92Y3T6";"T2-CY-5GRRXE";"-";"Solana (USD)";"30 Jednost.";"127,000";"-";"-";"-";"-";"3,97838";"15 309,95";"305,54";"12 172,40";"-";"-";"-";"-";"-";"-";"-";"-";"-";"-";"-";"-";"-";"-";"-";"-";"-";"-";"-";"-";"-";"-";"-";"-"
"24 Cze 2024 21:05:30";"Zmodyfikowano Transakcję Sprzedaży";"O2-CY-92Y3T6";"T2-CY-5GRQ19";"-";"Solana (USD)";"30 Jednost.";"129,560";"-";"-";"127,000";"-";"-";"-";"0,00";"-";"-";"-";"-";"-";"-";"-";"-";"-";"-";"-";"-";"-";"-";"-";"-";"-";"-";"-";"-";"-";"-";"-";"-";"-"
"24 Cze 2024 21:04:26";"Transakcja Sprzedaży";"O2-CY-92Y3T6";"T2-CY-5GRQ19";"-";"Solana (USD)";"30 Jednost.";"129,560";"-";"-";"-";"-";"4,01805";"15 617,35";"0,00";"-";"-";"-";"-";"-";"-";"-";"-";"-";"-";"-";"-";"-";"-";"-";"-";"-";"-";"-";"-";"-";"-";"-";"-";"-"
"24 Cze 2024 15:25:15";" Zamknięcie Transakcji";"O2-CY-92X721";"T2-CY-5GQZB2";"O2-CY-92X4C3";"Solana (USD)";"15 Jednost.";"127,120";"-";"-";"-";"-";"3,98372";"7 672,50";"16,73";"11 866,86";"-";"-";"-";"-";"-";"-";"-";"-";"-";"-";"-";"-";"-";"-";"-";"-";"-";"-";"-";"-";"-";"-";"-";"-"
"24 Cze 2024 14:43:18";"Transakcja Sprzedaży";"O2-CY-92X4C3";"T2-CY-5GQXFV";"-";"Solana (USD)";"15 Jednost.";"127,400";"-";"-";"-";"-";"4,02842";"7 698,31";"0,00";"-";"-";"-";"-";"-";"-";"-";"-";"-";"-";"-";"-";"-";"-";"-";"-";"-";"-";"-";"-";"-";"-";"-";"-";"-"
"24 Cze 2024 14:38:16";" Zamknięcie Transakcji";"O2-CY-92X40L";"T2-CY-5GQX5C";"O2-CY-92X3R0";"Solana (USD)";"1,4 Jednost.";"127,838";"-";"-";"-";"-";"3,98694";"720,72";"1,38";"11 850,13";"-";"-";"-";"-";"-";"-";"-";"-";"-";"-";"-";"-";"-";"-";"-";"-";"-";"-";"-";"-";"-";"-";"-";"-"
"24 Cze 2024 14:32:48";"Transakcja Sprzedaży";"O2-CY-92X3R0";"T2-CY-5GQWXM";"-";"Solana (USD)";"1,4 Jednost.";"128,085";"-";"-";"-";"-";"4,027739";"722,25";"0,00";"-";"-";"-";"-";"-";"-";"-";"-";"-";"-";"-";"-";"-";"-";"-";"-";"-";"-";"-";"-";"-";"-";"-";"-";"-"
"21 Cze 2024 23:01:11";"Koszty Utrzymania Pozycji";"1348075658";"-";"-";"Rachunek";"-";"-";"-";"-";"-";"-";"-";"-";"-83,13";"11 848,75";"-";"-";"-";"-";"-";"-83,13";"-";"-";"-";"-";"-";"-";"-";"-";"-";"-";"-";"-";"-";"-";"-";"-";"-";"-"
"21 Cze 2024 23:01:11";"Koszty Utrzymania Pozycji";"O2-CY-92R1QR";"-";"-";"Solana (USD)";"-";"-";"-";"-";"-";"-";"-";"-";"-";"-";"-";"-";"4 773,60";"-27,50000%";"-43,87";"-43,87";"-";"-";"-";"-";"-";"-";"-";"-";"-";"-";"-";"-";"-";"-";"-";"-";"-";"-"
"21 Cze 2024 23:01:11";"Koszty Utrzymania Pozycji";"O2-CX-9250PH";"-";"-";"Solana (USD)";"-";"-";"-";"-";"-";"-";"-";"-";"-";"-";"-";"-";"2 121,60";"-10,00000%";"7,02";"7,02";"-";"-";"-";"-";"-";"-";"-";"-";"-";"-";"-";"-";"-";"-";"-";"-";"-";"-"
"21 Cze 2024 23:01:11";"Koszty Utrzymania Pozycji";"O2-CY-92PYGJ";"-";"-";"Solana (USD)";"-";"-";"-";"-";"-";"-";"-";"-";"-";"-";"-";"-";"6 762,60";"-10,00000%";"22,37";"22,37";"-";"-";"-";"-";"-";"-";"-";"-";"-";"-";"-";"-";"-";"-";"-";"-";"-";"-"
"21 Cze 2024 23:01:11";"Koszty Utrzymania Pozycji";"O2-CX-922YGK";"-";"-";"Solana (USD)";"-";"-";"-";"-";"-";"-";"-";"-";"-";"-";"-";"-";"2 718,30";"-27,50000%";"-24,98";"-24,98";"-";"-";"-";"-";"-";"-";"-";"-";"-";"-";"-";"-";"-";"-";"-";"-";"-";"-"
"21 Cze 2024 23:01:11";"Koszty Utrzymania Pozycji";"O2-CX-922YEX";"-";"-";"Solana (USD)";"-";"-";"-";"-";"-";"-";"-";"-";"-";"-";"-";"-";"2 738,19";"-27,50000%";"-25,16";"-25,16";"-";"-";"-";"-";"-";"-";"-";"-";"-";"-";"-";"-";"-";"-";"-";"-";"-";"-"
"21 Cze 2024 23:01:11";"Koszty Utrzymania Pozycji";"O2-CX-9250P8";"-";"-";"Solana (USD)";"-";"-";"-";"-";"-";"-";"-";"-";"-";"-";"-";"-";"2 141,49";"-10,00000%";"7,08";"7,08";"-";"-";"-";"-";"-";"-";"-";"-";"-";"-";"-";"-";"-";"-";"-";"-";"-";"-"
"21 Cze 2024 23:01:11";"Koszty Utrzymania Pozycji";"O2-CW-916WS8";"-";"-";"Solana (USD)";"-";"-";"-";"-";"-";"-";"-";"-";"-";"-";"-";"-";"2 784,60";"-27,50000%";"-25,59";"-25,59";"-";"-";"-";"-";"-";"-";"-";"-";"-";"-";"-";"-";"-";"-";"-";"-";"-";"-"
"20 Cze 2024 23:43:11";" Zmodyfikowano Transakcję Kupna";"O2-CY-92R1QR";"T2-CY-5GLKRP";"-";"Solana (USD)";"36 Jednost.";"136,715";"-";"-";"138,000";"-";"-";"-";"0,00";"-";"-";"-";"-";"-";"-";"-";"-";"-";"-";"-";"-";"-";"-";"-";"-";"-";"-";"-";"-";"-";"-";"-";"-";"-"
"20 Cze 2024 23:37:20";"Zmodyfikowano Transakcję Sprzedaży";"O2-CY-92PYGJ";"T2-CY-5GKQ25";"-";"Solana (USD)";"51 Jednost.";"131,188";"-";"-";"-";"-";"-";"-";"0,00";"-";"-";"-";"-";"-";"-";"-";"-";"-";"-";"-";"-";"-";"-";"-";"-";"-";"-";"-";"-";"-";"-";"-";"-";"-"
"20 Cze 2024 23:01:14";"Koszty Utrzymania Pozycji";"1347685858";"-";"-";"Rachunek";"-";"-";"-";"-";"-";"-";"-";"-";"-28,01";"11 931,88";"-";"-";"-";"-";"-";"-28,01";"-";"-";"-";"-";"-";"-";"-";"-";"-";"-";"-";"-";"-";"-";"-";"-";"-";"-"
"20 Cze 2024 23:01:14";"Koszty Utrzymania Pozycji";"O2-CY-92R1QR";"-";"-";"Solana (USD)";"-";"-";"-";"-";"-";"-";"-";"-";"-";"-";"-";"-";"4 830,30";"-27,50000%";"-14,79";"-14,79";"-";"-";"-";"-";"-";"-";"-";"-";"-";"-";"-";"-";"-";"-";"-";"-";"-";"-"
"20 Cze 2024 23:01:14";"Koszty Utrzymania Pozycji";"O2-CX-9250PH";"-";"-";"Solana (USD)";"-";"-";"-";"-";"-";"-";"-";"-";"-";"-";"-";"-";"2 146,80";"-10,00000%";"2,37";"2,37";"-";"-";"-";"-";"-";"-";"-";"-";"-";"-";"-";"-";"-";"-";"-";"-";"-";"-"
"20 Cze 2024 23:01:14";"Koszty Utrzymania Pozycji";"O2-CY-92PYGJ";"-";"-";"Solana (USD)";"-";"-";"-";"-";"-";"-";"-";"-";"-";"-";"-";"-";"6 842,92";"-10,00000%";"7,54";"7,54";"-";"-";"-";"-";"-";"-";"-";"-";"-";"-";"-";"-";"-";"-";"-";"-";"-";"-"
"20 Cze 2024 23:01:14";"Koszty Utrzymania Pozycji";"O2-CX-922YGK";"-";"-";"Solana (USD)";"-";"-";"-";"-";"-";"-";"-";"-";"-";"-";"-";"-";"2 750,58";"-27,50000%";"-8,42";"-8,42";"-";"-";"-";"-";"-";"-";"-";"-";"-";"-";"-";"-";"-";"-";"-";"-";"-";"-"
"20 Cze 2024 23:01:14";"Koszty Utrzymania Pozycji";"O2-CX-922YEX";"-";"-";"Solana (USD)";"-";"-";"-";"-";"-";"-";"-";"-";"-";"-";"-";"-";"2 770,71";"-27,50000%";"-8,48";"-8,48";"-";"-";"-";"-";"-";"-";"-";"-";"-";"-";"-";"-";"-";"-";"-";"-";"-";"-"
"20 Cze 2024 23:01:14";"Koszty Utrzymania Pozycji";"O2-CX-9250P8";"-";"-";"Solana (USD)";"-";"-";"-";"-";"-";"-";"-";"-";"-";"-";"-";"-";"2 166,92";"-10,00000%";"2,39";"2,39";"-";"-";"-";"-";"-";"-";"-";"-";"-";"-";"-";"-";"-";"-";"-";"-";"-";"-"
"20 Cze 2024 23:01:14";"Koszty Utrzymania Pozycji";"O2-CW-916WS8";"-";"-";"Solana (USD)";"-";"-";"-";"-";"-";"-";"-";"-";"-";"-";"-";"-";"2 817,67";"-27,50000%";"-8,62";"-8,62";"-";"-";"-";"-";"-";"-";"-";"-";"-";"-";"-";"-";"-";"-";"-";"-";"-";"-"
"20 Cze 2024 22:41:37";" Zamknięcie Transakcji";"O2-CY-92T52T";"T2-CY-5GNCHK";"O2-CY-92R24V";"Solana (USD)";"38 Jednost.";"134,033";"-";"-";"-";"-";"4,02417";"20 702,10";"131,82";"11 959,89";"-";"-";"-";"-";"-";"-";"-";"-";"-";"-";"-";"-";"-";"-";"-";"-";"-";"-";"-";"-";"-";"-";"-";"-"
"20 Cze 2024 11:30:11";"Zmodyfikowano Transakcję Sprzedaży";"O2-CY-92R24V";"T2-CY-5GLL38";"-";"Solana (USD)";"38 Jednost.";"134,895";"-";"-";"-";"-";"-";"-";"0,00";"-";"-";"-";"-";"-";"-";"-";"-";"-";"-";"-";"-";"-";"-";"-";"-";"-";"-";"-";"-";"-";"-";"-";"-";"-"
"20 Cze 2024 09:39:01";" Zamknięcie Transakcji";"O2-CY-92RG78";"T2-CY-5GLYDM";"O2-CY-92R1QR";"Solana (USD)";"5 Jednost.";"136,765";"-";"-";"-";"-";"4,00315";"2 764,96";"1,00";"11 828,07";"-";"-";"-";"-";"-";"-";"-";"-";"-";"-";"-";"-";"-";"-";"-";"-";"-";"-";"-";"-";"-";"-";"-";"-"
"20 Cze 2024 09:28:54";"Zmodyfikowano Transakcję Sprzedaży";"O2-CY-92R24V";"T2-CY-5GLL38";"-";"Solana (USD)";"38 Jednost.";"134,895";"-";"-";"132,000";"-";"-";"-";"0,00";"-";"-";"-";"-";"-";"-";"-";"-";"-";"-";"-";"-";"-";"-";"-";"-";"-";"-";"-";"-";"-";"-";"-";"-";"-"
"19 Cze 2024 23:01:04";"Koszty Utrzymania Pozycji";"1347193397";"-";"-";"Rachunek";"-";"-";"-";"-";"-";"-";"-";"-";"-24,55";"11 827,07";"-";"-";"-";"-";"-";"-24,55";"-";"-";"-";"-";"-";"-";"-";"-";"-";"-";"-";"-";"-";"-";"-";"-";"-";"-"
"19 Cze 2024 23:01:04";"Koszty Utrzymania Pozycji";"O2-CY-92R24V";"-";"-";"Solana (USD)";"-";"-";"-";"-";"-";"-";"-";"-";"-";"-";"-";"-";"5 140,45";"-10,00000%";"5,64";"5,64";"-";"-";"-";"-";"-";"-";"-";"-";"-";"-";"-";"-";"-";"-";"-";"-";"-";"-"
"19 Cze 2024 23:01:04";"Koszty Utrzymania Pozycji";"O2-CX-9250PH";"-";"-";"Solana (USD)";"-";"-";"-";"-";"-";"-";"-";"-";"-";"-";"-";"-";"2 164,40";"-10,00000%";"2,38";"2,38";"-";"-";"-";"-";"-";"-";"-";"-";"-";"-";"-";"-";"-";"-";"-";"-";"-";"-"
"19 Cze 2024 23:01:04";"Koszty Utrzymania Pozycji";"O2-CY-92PYGJ";"-";"-";"Solana (USD)";"-";"-";"-";"-";"-";"-";"-";"-";"-";"-";"-";"-";"6 899,02";"-10,00000%";"7,57";"7,57";"-";"-";"-";"-";"-";"-";"-";"-";"-";"-";"-";"-";"-";"-";"-";"-";"-";"-"
"19 Cze 2024 23:01:04";"Koszty Utrzymania Pozycji";"O2-CX-922YGK";"-";"-";"Solana (USD)";"-";"-";"-";"-";"-";"-";"-";"-";"-";"-";"-";"-";"2 773,13";"-27,50000%";"-8,45";"-8,45";"-";"-";"-";"-";"-";"-";"-";"-";"-";"-";"-";"-";"-";"-";"-";"-";"-";"-"
"19 Cze 2024 23:01:04";"Koszty Utrzymania Pozycji";"O2-CX-922YEX";"-";"-";"Solana (USD)";"-";"-";"-";"-";"-";"-";"-";"-";"-";"-";"-";"-";"2 793,42";"-27,50000%";"-8,52";"-8,52";"-";"-";"-";"-";"-";"-";"-";"-";"-";"-";"-";"-";"-";"-";"-";"-";"-";"-"
"19 Cze 2024 23:01:04";"Koszty Utrzymania Pozycji";"O2-CX-9250P8";"-";"-";"Solana (USD)";"-";"-";"-";"-";"-";"-";"-";"-";"-";"-";"-";"-";"2 184,69";"-10,00000%";"2,40";"2,40";"-";"-";"-";"-";"-";"-";"-";"-";"-";"-";"-";"-";"-";"-";"-";"-";"-";"-"
"19 Cze 2024 23:01:04";"Koszty Utrzymania Pozycji";"O2-CW-916WS8";"-";"-";"Solana (USD)";"-";"-";"-";"-";"-";"-";"-";"-";"-";"-";"-";"-";"2 840,77";"-27,50000%";"-8,66";"-8,66";"-";"-";"-";"-";"-";"-";"-";"-";"-";"-";"-";"-";"-";"-";"-";"-";"-";"-"
"19 Cze 2024 23:01:04";"Koszty Utrzymania Pozycji";"O2-CY-92R1QR";"-";"-";"Solana (USD)";"-";"-";"-";"-";"-";"-";"-";"-";"-";"-";"-";"-";"5 546,27";"-27,50000%";"-16,91";"-16,91";"-";"-";"-";"-";"-";"-";"-";"-";"-";"-";"-";"-";"-";"-";"-";"-";"-";"-"
"19 Cze 2024 22:56:02";"Transakcja Sprzedaży";"O2-CY-92R24V";"T2-CY-5GLL38";"-";"Solana (USD)";"38 Jednost.";"134,895";"-";"-";"-";"-";"4,045524";"20 737,39";"0,00";"-";"-";"-";"-";"-";"-";"-";"-";"-";"-";"-";"-";"-";"-";"-";"-";"-";"-";"-";"-";"-";"-";"-";"-";"-"
"19 Cze 2024 22:47:15";"Stop Loss";"O2-CY-92R221";"T2-CY-5GLL1T";"-";"Solana (USD)";"38 Jednost.";"134,957";"-";"-";"-";"-";"4,00498";"20 745,44";"21,00";"11 851,62";"-";"-";"-";"-";"-";"-";"-";"-";"-";"-";"-";"-";"-";"-";"-";"-";"-";"-";"-";"-";"-";"-";"-";"-"
"19 Cze 2024 22:46:23";"Zmodyfikowano Transakcję Sprzedaży";"O2-CY-92R221";"T2-CY-5GLL19";"-";"Solana (USD)";"38 Jednost.";"135,095";"-";"134,950";"-";"-";"-";"-";"0,00";"-";"-";"-";"-";"-";"-";"-";"-";"-";"-";"-";"-";"-";"-";"-";"-";"-";"-";"-";"-";"-";"-";"-";"-";"-"
"19 Cze 2024 22:43:48";"Transakcja Sprzedaży";"O2-CY-92R221";"T2-CY-5GLL19";"-";"Solana (USD)";"38 Jednost.";"135,095";"-";"-";"-";"-";"4,045124";"20 766,08";"0,00";"-";"-";"-";"-";"-";"-";"-";"-";"-";"-";"-";"-";"-";"-";"-";"-";"-";"-";"-";"-";"-";"-";"-";"-";"-"
"19 Cze 2024 22:43:36";"Odrzucono Zlecenie: brak wystarczających środków";"O2-CY-92R21Y";"-";"-";"Solana (USD)";"40 Jednost.";"-";"-";"-";"-";"-";"-";"-";"-";"-";"-";"-";"-";"-";"-";"-";"-";"-";"-";"-";"-";"-";"-";"-";"-";"-";"-";"-";"-";"-";"-";"-";"-";"-"
"19 Cze 2024 21:52:08";" Transakcja Kupna";"O2-CY-92R1QR";"T2-CY-5GLKRP";"-";"Solana (USD)";"41 Jednost.";"136,715";"-";"-";"-";"-";"4,044032";"22 668,07";"0,00";"-";"-";"-";"-";"-";"-";"-";"-";"-";"-";"-";"-";"-";"-";"-";"-";"-";"-";"-";"-";"-";"-";"-";"-";"-"
"19 Cze 2024 21:40:40";"Stop Loss";"O2-CY-92R1MM";"T2-CY-5GLKPY";"-";"Solana (USD)";"40 Jednost.";"136,300";"-";"-";"-";"-";"4,00351";"22 046,47";"7,21";"11 830,62";"-";"-";"-";"-";"-";"-";"-";"-";"-";"-";"-";"-";"-";"-";"-";"-";"-";"-";"-";"-";"-";"-";"-";"-"
"19 Cze 2024 21:38:30";" Zmodyfikowano Transakcję Kupna";"O2-CY-92R1MM";"T2-CY-5GLKPQ";"-";"Solana (USD)";"40 Jednost.";"136,255";"-";"136,300";"-";"-";"-";"-";"0,00";"-";"-";"-";"-";"-";"-";"-";"-";"-";"-";"-";"-";"-";"-";"-";"-";"-";"-";"-";"-";"-";"-";"-";"-";"-"
"19 Cze 2024 21:34:54";" Transakcja Kupna";"O2-CY-92R1MM";"T2-CY-5GLKPQ";"-";"Solana (USD)";"40 Jednost.";"136,255";"-";"-";"-";"-";"4,043911";"22 040,12";"0,00";"-";"-";"-";"-";"-";"-";"-";"-";"-";"-";"-";"-";"-";"-";"-";"-";"-";"-";"-";"-";"-";"-";"-";"-";"-"
"19 Cze 2024 21:33:11";"Odrzucono Zlecenie: brak wystarczających środków";"O2-CY-92R1M6";"-";"-";"Solana (USD)";"50 Jednost.";"-";"-";"-";"-";"-";"-";"-";"-";"-";"-";"-";"-";"-";"-";"-";"-";"-";"-";"-";"-";"-";"-";"-";"-";"-";"-";"-";"-";"-";"-";"-";"-";"-"
"18 Cze 2024 23:01:10";"Koszty Utrzymania Pozycji";"1346954810";"-";"-";"Rachunek";"-";"-";"-";"-";"-";"-";"-";"-";"-13,46";"11 823,41";"-";"-";"-";"-";"-";"-13,46";"-";"-";"-";"-";"-";"-";"-";"-";"-";"-";"-";"-";"-";"-";"-";"-";"-";"-"
"18 Cze 2024 23:01:10";"Koszty Utrzymania Pozycji";"O2-CX-9250PH";"-";"-";"Solana (USD)";"-";"-";"-";"-";"-";"-";"-";"-";"-";"-";"-";"-";"2 187,44";"-10,00000%";"2,41";"2,41";"-";"-";"-";"-";"-";"-";"-";"-";"-";"-";"-";"-";"-";"-";"-";"-";"-";"-"
"18 Cze 2024 23:01:10";"Koszty Utrzymania Pozycji";"O2-CY-92PYGJ";"-";"-";"Solana (USD)";"-";"-";"-";"-";"-";"-";"-";"-";"-";"-";"-";"-";"6 972,46";"-10,00000%";"7,68";"7,68";"-";"-";"-";"-";"-";"-";"-";"-";"-";"-";"-";"-";"-";"-";"-";"-";"-";"-"
"18 Cze 2024 23:01:10";"Koszty Utrzymania Pozycji";"O2-CX-922YGK";"-";"-";"Solana (USD)";"-";"-";"-";"-";"-";"-";"-";"-";"-";"-";"-";"-";"2 802,65";"-27,50000%";"-8,57";"-8,57";"-";"-";"-";"-";"-";"-";"-";"-";"-";"-";"-";"-";"-";"-";"-";"-";"-";"-"
"18 Cze 2024 23:01:10";"Koszty Utrzymania Pozycji";"O2-CX-922YEX";"-";"-";"Solana (USD)";"-";"-";"-";"-";"-";"-";"-";"-";"-";"-";"-";"-";"2 823,16";"-27,50000%";"-8,63";"-8,63";"-";"-";"-";"-";"-";"-";"-";"-";"-";"-";"-";"-";"-";"-";"-";"-";"-";"-"
"18 Cze 2024 23:01:10";"Koszty Utrzymania Pozycji";"O2-CX-9250P8";"-";"-";"Solana (USD)";"-";"-";"-";"-";"-";"-";"-";"-";"-";"-";"-";"-";"2 207,94";"-10,00000%";"2,43";"2,43";"-";"-";"-";"-";"-";"-";"-";"-";"-";"-";"-";"-";"-";"-";"-";"-";"-";"-"
"18 Cze 2024 23:01:10";"Koszty Utrzymania Pozycji";"O2-CW-916WS8";"-";"-";"Solana (USD)";"-";"-";"-";"-";"-";"-";"-";"-";"-";"-";"-";"-";"2 871,01";"-27,50000%";"-8,78";"-8,78";"-";"-";"-";"-";"-";"-";"-";"-";"-";"-";"-";"-";"-";"-";"-";"-";"-";"-"
"18 Cze 2024 21:58:41";"Zmodyfikowano Transakcję Sprzedaży";"O2-CY-92PYGJ";"T2-CY-5GKQ25";"-";"Solana (USD)";"51 Jednost.";"131,188";"-";"-";"130,500";"-";"-";"-";"0,00";"-";"-";"-";"-";"-";"-";"-";"-";"-";"-";"-";"-";"-";"-";"-";"-";"-";"-";"-";"-";"-";"-";"-";"-";"-"
"18 Cze 2024 21:51:29";"Transakcja Sprzedaży";"O2-CY-92PYGJ";"T2-CY-5GKQ25";"-";"Solana (USD)";"51 Jednost.";"131,188";"-";"-";"-";"-";"4,060264";"27 165,55";"0,00";"-";"-";"-";"-";"-";"-";"-";"-";"-";"-";"-";"-";"-";"-";"-";"-";"-";"-";"-";"-";"-";"-";"-";"-";"-"
"18 Cze 2024 20:33:47";"Stop Loss";"O2-CY-92PV3B";"T2-CY-5GKMPE";"-";"Solana (USD)";"50 Jednost.";"133,000";"-";"-";"-";"-";"4,02132";"27 010,48";"140,55";"11 836,87";"-";"-";"-";"-";"-";"-";"-";"-";"-";"-";"-";"-";"-";"-";"-";"-";"-";"-";"-";"-";"-";"-";"-";"-"
"18 Cze 2024 20:33:44";"Zmodyfikowano Take Profit";"O2-CY-92PV3B";"-";"O2-CY-92PVBB";"Solana (USD)";"50 Jednost.";"133,699";"-";"-";"132,000";"-";"-";"-";"-";"-";"-";"-";"-";"-";"-";"-";"-";"-";"-";"-";"-";"-";"-";"-";"-";"-";"-";"-";"-";"-";"-";"-";"-";"-"
"18 Cze 2024 20:33:44";"Zmodyfikowano Stop Loss";"O2-CY-92PV3B";"-";"O2-CY-92PVNT";"Solana (USD)";"50 Jednost.";"133,699";"-";"133,000";"-";"-";"-";"-";"-";"-";"-";"-";"-";"-";"-";"-";"-";"-";"-";"-";"-";"-";"-";"-";"-";"-";"-";"-";"-";"-";"-";"-";"-";"-"
"18 Cze 2024 20:33:06";"Zmodyfikowano Stop Loss";"O2-CY-92PV3B";"-";"O2-CY-92PVNT";"Solana (USD)";"50 Jednost.";"133,699";"-";"133,300";"-";"-";"-";"-";"-";"-";"-";"-";"-";"-";"-";"-";"-";"-";"-";"-";"-";"-";"-";"-";"-";"-";"-";"-";"-";"-";"-";"-";"-";"-"
"18 Cze 2024 20:32:45";"Zmodyfikowano Transakcję Sprzedaży";"O2-CY-92PV3B";"T2-CY-5GKM5H";"-";"Solana (USD)";"50 Jednost.";"133,699";"-";"133,500";"132,400";"-";"-";"-";"0,00";"-";"-";"-";"-";"-";"-";"-";"-";"-";"-";"-";"-";"-";"-";"-";"-";"-";"-";"-";"-";"-";"-";"-";"-";"-"
"18 Cze 2024 20:24:08";"Zmodyfikowano Transakcję Sprzedaży";"O2-CY-92PV3B";"T2-CY-5GKM5H";"-";"Solana (USD)";"50 Jednost.";"133,699";"-";"-";"132,400";"-";"-";"-";"0,00";"-";"-";"-";"-";"-";"-";"-";"-";"-";"-";"-";"-";"-";"-";"-";"-";"-";"-";"-";"-";"-";"-";"-";"-";"-"
"18 Cze 2024 20:17:30";"Transakcja Sprzedaży";"O2-CY-92PV3B";"T2-CY-5GKM5H";"-";"Solana (USD)";"50 Jednost.";"133,699";"-";"-";"-";"-";"4,061426";"27 150,42";"0,00";"-";"-";"-";"-";"-";"-";"-";"-";"-";"-";"-";"-";"-";"-";"-";"-";"-";"-";"-";"-";"-";"-";"-";"-";"-"
"18 Cze 2024 19:20:44";"Take Profit";"O2-CY-92P9HQ";"T2-CY-5GKJ62";"-";"Solana (USD)";"50 Jednost.";"133,500";"-";"-";"-";"-";"4,02142";"27 112,69";"13,07";"11 696,32";"-";"-";"-";"-";"-";"-";"-";"-";"-";"-";"-";"-";"-";"-";"-";"-";"-";"-";"-";"-";"-";"-";"-";"-"
"18 Cze 2024 19:01:29";"Zmodyfikowano Take Profit";"O2-CY-92P9HQ";"-";"O2-CY-92PCH4";"Solana (USD)";"50 Jednost.";"133,565";"-";"-";"133,500";"-";"-";"-";"-";"-";"-";"-";"-";"-";"-";"-";"-";"-";"-";"-";"-";"-";"-";"-";"-";"-";"-";"-";"-";"-";"-";"-";"-";"-"
"18 Cze 2024 16:27:40";"Zmodyfikowano Transakcję Sprzedaży";"O2-CY-92P9HQ";"T2-CY-5GK5B0";"-";"Solana (USD)";"50 Jednost.";"133,565";"-";"-";"130,000";"-";"-";"-";"0,00";"-";"-";"-";"-";"-";"-";"-";"-";"-";"-";"-";"-";"-";"-";"-";"-";"-";"-";"-";"-";"-";"-";"-";"-";"-"
"18 Cze 2024 16:09:34";"Transakcja Sprzedaży";"O2-CY-92P9HQ";"T2-CY-5GK5B0";"-";"Solana (USD)";"50 Jednost.";"133,565";"-";"-";"-";"-";"4,057138";"27 094,58";"0,00";"-";"-";"-";"-";"-";"-";"-";"-";"-";"-";"-";"-";"-";"-";"-";"-";"-";"-";"-";"-";"-";"-";"-";"-";"-"
"18 Cze 2024 16:03:11";"Stop Loss";"O2-CY-92P8DB";"T2-CY-5GK4RR";"-";"Solana (USD)";"50 Jednost.";"133,905";"-";"-";"-";"-";"4,01838";"27 174,48";"37,17";"11 683,25";"-";"-";"-";"-";"-";"-";"-";"-";"-";"-";"-";"-";"-";"-";"-";"-";"-";"-";"-";"-";"-";"-";"-";"-"
"18 Cze 2024 16:02:52";"Zmodyfikowano Transakcję Sprzedaży";"O2-CY-92P8DB";"T2-CY-5GK4E2";"-";"Solana (USD)";"50 Jednost.";"134,090";"-";"133,900";"130,000";"-";"-";"-";"0,00";"-";"-";"-";"-";"-";"-";"-";"-";"-";"-";"-";"-";"-";"-";"-";"-";"-";"-";"-";"-";"-";"-";"-";"-";"-"
"18 Cze 2024 16:00:22";"Zmodyfikowano Transakcję Sprzedaży";"O2-CY-92P8DB";"T2-CY-5GK4E2";"-";"Solana (USD)";"50 Jednost.";"134,090";"-";"-";"130,000";"-";"-";"-";"0,00";"-";"-";"-";"-";"-";"-";"-";"-";"-";"-";"-";"-";"-";"-";"-";"-";"-";"-";"-";"-";"-";"-";"-";"-";"-"
"18 Cze 2024 16:00:01";"Transakcja Sprzedaży";"O2-CY-92P8DB";"T2-CY-5GK4E2";"-";"Solana (USD)";"50 Jednost.";"134,090";"-";"-";"-";"-";"4,057629";"27 204,37";"0,00";"-";"-";"-";"-";"-";"-";"-";"-";"-";"-";"-";"-";"-";"-";"-";"-";"-";"-";"-";"-";"-";"-";"-";"-";"-"
"18 Cze 2024 15:54:31";"Stop Loss";"O2-CY-92P672";"T2-CY-5GK3QF";"-";"Solana (USD)";"49 Jednost.";"134,414";"-";"-";"-";"-";"4,01936";"26 738,69";"10,04";"11 646,08";"-";"-";"-";"-";"-";"-";"-";"-";"-";"-";"-";"-";"-";"-";"-";"-";"-";"-";"-";"-";"-";"-";"-";"-"
"18 Cze 2024 15:53:26";"Zmodyfikowano Transakcję Sprzedaży";"O2-CY-92P672";"T2-CY-5GK2CZ";"-";"Solana (USD)";"49 Jednost.";"134,465";"-";"134,400";"130,000";"-";"-";"-";"0,00";"-";"-";"-";"-";"-";"-";"-";"-";"-";"-";"-";"-";"-";"-";"-";"-";"-";"-";"-";"-";"-";"-";"-";"-";"-"
"18 Cze 2024 15:43:51";"Transakcja Sprzedaży";"O2-CY-92P672";"T2-CY-5GK2CZ";"-";"Solana (USD)";"49 Jednost.";"134,465";"-";"-";"-";"-";"4,06339";"26 772,80";"0,00";"-";"-";"-";"-";"-";"-";"-";"-";"-";"-";"-";"-";"-";"-";"-";"-";"-";"-";"-";"-";"-";"-";"-";"-";"-"
"18 Cze 2024 15:37:45";"Stop Loss";"O2-CY-92P48T";"T2-CY-5GK1EX";"-";"Solana (USD)";"50 Jednost.";"133,971";"-";"-";"-";"-";"4,0278";"27 251,51";"60,22";"11 636,04";"-";"-";"-";"-";"-";"-";"-";"-";"-";"-";"-";"-";"-";"-";"-";"-";"-";"-";"-";"-";"-";"-";"-";"-"
"18 Cze 2024 15:36:54";"Zmodyfikowano Transakcję Sprzedaży";"O2-CY-92P48T";"T2-CY-5GK0MN";"-";"Solana (USD)";"50 Jednost.";"134,270";"-";"133,950";"130,000";"-";"-";"-";"0,00";"-";"-";"-";"-";"-";"-";"-";"-";"-";"-";"-";"-";"-";"-";"-";"-";"-";"-";"-";"-";"-";"-";"-";"-";"-"
"18 Cze 2024 15:34:38";"Zmodyfikowano Transakcję Sprzedaży";"O2-CY-92P48T";"T2-CY-5GK0MN";"-";"Solana (USD)";"50 Jednost.";"134,270";"-";"-";"130,000";"-";"-";"-";"0,00";"-";"-";"-";"-";"-";"-";"-";"-";"-";"-";"-";"-";"-";"-";"-";"-";"-";"-";"-";"-";"-";"-";"-";"-";"-"
"18 Cze 2024 15:32:12";"Transakcja Sprzedaży";"O2-CY-92P48T";"T2-CY-5GK0MN";"-";"Solana (USD)";"50 Jednost.";"134,270";"-";"-";"-";"-";"4,067999";"27 310,51";"0,00";"-";"-";"-";"-";"-";"-";"-";"-";"-";"-";"-";"-";"-";"-";"-";"-";"-";"-";"-";"-";"-";"-";"-";"-";"-"
"18 Cze 2024 15:22:23";" Zamknięcie Transakcji";"O2-CY-92P3D3";"T2-CY-5GJZWP";"O2-CY-92P2WJ";"Solana (USD)";"30 Jednost.";"135,190";"-";"-";"-";"-";"4,02668";"16 495,13";"30,80";"11 575,82";"-";"-";"-";"-";"-";"-";"-";"-";"-";"-";"-";"-";"-";"-";"-";"-";"-";"-";"-";"-";"-";"-";"-";"-"
"18 Cze 2024 15:22:17";"Stop Loss";"O2-CY-92P2YW";"T2-CY-5GJZWK";"-";"Solana (USD)";"19,4 Jednost.";"135,225";"-";"-";"-";"-";"4,0266";"10 669,43";"19,22";"11 545,02";"-";"-";"-";"-";"-";"-";"-";"-";"-";"-";"-";"-";"-";"-";"-";"-";"-";"-";"-";"-";"-";"-";"-";"-"
"18 Cze 2024 15:21:36";"Zmodyfikowano Transakcję Sprzedaży";"O2-CY-92P2YW";"T2-CY-5GJZJR";"-";"Solana (USD)";"19,4 Jednost.";"135,471";"-";"135,200";"130,000";"-";"-";"-";"0,00";"-";"-";"-";"-";"-";"-";"-";"-";"-";"-";"-";"-";"-";"-";"-";"-";"-";"-";"-";"-";"-";"-";"-";"-";"-"
"18 Cze 2024 15:16:25";"Zmodyfikowano Transakcję Sprzedaży";"O2-CY-92P2YW";"T2-CY-5GJZJR";"-";"Solana (USD)";"19,4 Jednost.";"135,471";"-";"-";"130,000";"-";"-";"-";"0,00";"-";"-";"-";"-";"-";"-";"-";"-";"-";"-";"-";"-";"-";"-";"-";"-";"-";"-";"-";"-";"-";"-";"-";"-";"-"
"18 Cze 2024 15:16:08";"Zmodyfikowano Transakcję Sprzedaży";"O2-CY-92P2WJ";"T2-CY-5GJZFY";"-";"Solana (USD)";"30 Jednost.";"135,445";"-";"-";"130,000";"-";"-";"-";"0,00";"-";"-";"-";"-";"-";"-";"-";"-";"-";"-";"-";"-";"-";"-";"-";"-";"-";"-";"-";"-";"-";"-";"-";"-";"-"
"18 Cze 2024 15:15:25";"Transakcja Sprzedaży";"O2-CY-92P2YW";"T2-CY-5GJZJR";"-";"Solana (USD)";"19,4 Jednost.";"135,471";"-";"-";"-";"-";"4,066055";"10 686,15";"0,00";"-";"-";"-";"-";"-";"-";"-";"-";"-";"-";"-";"-";"-";"-";"-";"-";"-";"-";"-";"-";"-";"-";"-";"-";"-"
"18 Cze 2024 15:14:17";"Transakcja Sprzedaży";"O2-CY-92P2WJ";"T2-CY-5GJZFY";"-";"Solana (USD)";"30 Jednost.";"135,445";"-";"-";"-";"-";"4,065905";"16 521,19";"0,00";"-";"-";"-";"-";"-";"-";"-";"-";"-";"-";"-";"-";"-";"-";"-";"-";"-";"-";"-";"-";"-";"-";"-";"-";"-"
"18 Cze 2024 14:56:09";"Take Profit";"O2-CY-92P1FW";"T2-CY-5GJYD6";"-";"Solana (USD)";"19,34 Jednost.";"135,600";"-";"-";"-";"-";"4,03092";"10 677,33";"24,24";"11 525,80";"-";"-";"-";"-";"-";"-";"-";"-";"-";"-";"-";"-";"-";"-";"-";"-";"-";"-";"-";"-";"-";"-";"-";"-"
"18 Cze 2024 14:56:09";"Take Profit";"O2-CY-92NYLE";"T2-CY-5GJYD5";"-";"Solana (USD)";"30 Jednost.";"135,600";"-";"-";"-";"-";"4,03092";"16 562,56";"14,51";"11 501,56";"-";"-";"-";"-";"-";"-";"-";"-";"-";"-";"-";"-";"-";"-";"-";"-";"-";"-";"-";"-";"-";"-";"-";"-"
"18 Cze 2024 14:55:21";"Zmodyfikowano Transakcję Sprzedaży";"O2-CY-92P1FW";"T2-CY-5GJY7F";"-";"Solana (USD)";"19,34 Jednost.";"135,911";"-";"-";"135,600";"-";"-";"-";"0,00";"-";"-";"-";"-";"-";"-";"-";"-";"-";"-";"-";"-";"-";"-";"-";"-";"-";"-";"-";"-";"-";"-";"-";"-";"-"
"18 Cze 2024 14:55:01";"Zmodyfikowano Transakcję Sprzedaży";"O2-CY-92NYLE";"T2-CY-5GJVV3";"-";"Solana (USD)";"30 Jednost.";"135,720";"-";"-";"135,600";"-";"-";"-";"0,00";"-";"-";"-";"-";"-";"-";"-";"-";"-";"-";"-";"-";"-";"-";"-";"-";"-";"-";"-";"-";"-";"-";"-";"-";"-"
"18 Cze 2024 14:53:43";"Transakcja Sprzedaży";"O2-CY-92P1FW";"T2-CY-5GJY7F";"-";"Solana (USD)";"19,34 Jednost.";"135,911";"-";"-";"-";"-";"4,070925";"10 700,50";"0,00";"-";"-";"-";"-";"-";"-";"-";"-";"-";"-";"-";"-";"-";"-";"-";"-";"-";"-";"-";"-";"-";"-";"-";"-";"-"
"18 Cze 2024 14:37:25";" Zamknięcie Transakcji";"O2-CY-92P08P";"T2-CY-5GJX7L";"O2-CY-92NYNJ";"Solana (USD)";"19 Jednost.";"135,735";"-";"-";"-";"-";"4,03112";"10 500,58";"3,06";"11 487,05";"-";"-";"-";"-";"-";"-";"-";"-";"-";"-";"-";"-";"-";"-";"-";"-";"-";"-";"-";"-";"-";"-";"-";"-"
"18 Cze 2024 14:29:19";"Transakcja Sprzedaży";"O2-CY-92NYNJ";"T2-CY-5GJVVP";"-";"Solana (USD)";"19 Jednost.";"135,775";"-";"-";"-";"-";"4,076607";"10 516,52";"0,00";"-";"-";"-";"-";"-";"-";"-";"-";"-";"-";"-";"-";"-";"-";"-";"-";"-";"-";"-";"-";"-";"-";"-";"-";"-"
"18 Cze 2024 14:28:39";"Transakcja Sprzedaży";"O2-CY-92NYLE";"T2-CY-5GJVV3";"-";"Solana (USD)";"30 Jednost.";"135,720";"-";"-";"-";"-";"4,078771";"16 607,12";"0,00";"-";"-";"-";"-";"-";"-";"-";"-";"-";"-";"-";"-";"-";"-";"-";"-";"-";"-";"-";"-";"-";"-";"-";"-";"-"
"18 Cze 2024 13:37:57";" Zamknięcie Transakcji";"O2-CY-92NW0Y";"T2-CY-5GJT59";"O2-CY-92NGQW";"Solana (USD)";"30 Jednost.";"135,929";"-";"-";"-";"-";"4,04433";"16 657,98";"72,92";"11 483,99";"-";"-";"-";"-";"-";"-";"-";"-";"-";"-";"-";"-";"-";"-";"-";"-";"-";"-";"-";"-";"-";"-";"-";"-"
"18 Cze 2024 13:37:20";"Stop Loss";"O2-CY-92NGRJ";"T2-CY-5GJT4T";"-";"Solana (USD)";"19,25 Jednost.";"136,015";"-";"-";"-";"-";"4,04421";"10 695,29";"26,47";"11 411,07";"-";"-";"-";"-";"-";"-";"-";"-";"-";"-";"-";"-";"-";"-";"-";"-";"-";"-";"-";"-";"-";"-";"-";"-"
"18 Cze 2024 13:37:10";"Zmodyfikowano Transakcję Sprzedaży";"O2-CY-92NGRJ";"T2-CY-5GJJGM";"-";"Solana (USD)";"19,25 Jednost.";"136,355";"-";"136,000";"-";"-";"-";"-";"0,00";"-";"-";"-";"-";"-";"-";"-";"-";"-";"-";"-";"-";"-";"-";"-";"-";"-";"-";"-";"-";"-";"-";"-";"-";"-"
"18 Cze 2024 09:51:11";"Transakcja Sprzedaży";"O2-CY-92NGRJ";"T2-CY-5GJJGM";"-";"Solana (USD)";"19,25 Jednost.";"136,355";"-";"-";"-";"-";"4,076065";"10 698,99";"0,00";"-";"-";"-";"-";"-";"-";"-";"-";"-";"-";"-";"-";"-";"-";"-";"-";"-";"-";"-";"-";"-";"-";"-";"-";"-"
"18 Cze 2024 09:50:39";"Transakcja Sprzedaży";"O2-CY-92NGQW";"T2-CY-5GJJG2";"-";"Solana (USD)";"30 Jednost.";"136,530";"-";"-";"-";"-";"4,076727";"16 697,86";"0,00";"-";"-";"-";"-";"-";"-";"-";"-";"-";"-";"-";"-";"-";"-";"-";"-";"-";"-";"-";"-";"-";"-";"-";"-";"-"
"18 Cze 2024 03:15:27";"Take Profit";"O2-CY-92N08N";"T2-CY-5GJ8KP";"-";"Solana (USD)";"18,8 Jednost.";"140,000";"-";"-";"-";"-";"4,03037";"10 714,54";"237,54";"11 005,54";"-";"-";"-";"-";"-";"-";"-";"-";"-";"-";"-";"-";"-";"-";"-";"-";"-";"-";"-";"-";"-";"-";"-";"-"
"18 Cze 2024 03:15:27";"Take Profit";"O2-CY-92N08E";"T2-CY-5GJ8KQ";"-";"Solana (USD)";"30 Jednost.";"140,000";"-";"-";"-";"-";"4,03037";"17 097,67";"379,06";"11 384,60";"-";"-";"-";"-";"-";"-";"-";"-";"-";"-";"-";"-";"-";"-";"-";"-";"-";"-";"-";"-";"-";"-";"-";"-"
"18 Cze 2024 00:13:01";"Zmodyfikowano Transakcję Sprzedaży";"O2-CY-92N08E";"T2-CY-5GJ60P";"-";"Solana (USD)";"30 Jednost.";"143,135";"-";"-";"140,000";"-";"-";"-";"0,00";"-";"-";"-";"-";"-";"-";"-";"-";"-";"-";"-";"-";"-";"-";"-";"-";"-";"-";"-";"-";"-";"-";"-";"-";"-"
"18 Cze 2024 00:12:42";"Zmodyfikowano Transakcję Sprzedaży";"O2-CY-92N08N";"T2-CY-5GJ60Y";"-";"Solana (USD)";"18,8 Jednost.";"143,135";"-";"-";"140,000";"-";"-";"-";"0,00";"-";"-";"-";"-";"-";"-";"-";"-";"-";"-";"-";"-";"-";"-";"-";"-";"-";"-";"-";"-";"-";"-";"-";"-";"-"
"18 Cze 2024 00:11:35";"Transakcja Sprzedaży";"O2-CY-92N08N";"T2-CY-5GJ60Y";"-";"Solana (USD)";"18,8 Jednost.";"143,135";"-";"-";"-";"-";"4,070124";"10 952,45";"0,00";"-";"-";"-";"-";"-";"-";"-";"-";"-";"-";"-";"-";"-";"-";"-";"-";"-";"-";"-";"-";"-";"-";"-";"-";"-"
"18 Cze 2024 00:10:47";"Transakcja Sprzedaży";"O2-CY-92N08E";"T2-CY-5GJ60P";"-";"Solana (USD)";"30 Jednost.";"143,135";"-";"-";"-";"-";"4,070104";"17 477,23";"0,00";"-";"-";"-";"-";"-";"-";"-";"-";"-";"-";"-";"-";"-";"-";"-";"-";"-";"-";"-";"-";"-";"-";"-";"-";"-"
"17 Cze 2024 23:01:10";"Koszty Utrzymania Pozycji";"1346531276";"-";"-";"Rachunek";"-";"-";"-";"-";"-";"-";"-";"-";"-22,17";"10 768,00";"-";"-";"-";"-";"-";"-22,17";"-";"-";"-";"-";"-";"-";"-";"-";"-";"-";"-";"-";"-";"-";"-";"-";"-";"-"
"17 Cze 2024 23:01:10";"Koszty Utrzymania Pozycji";"O2-CX-9250PH";"-";"-";"Solana (USD)";"-";"-";"-";"-";"-";"-";"-";"-";"-";"-";"-";"-";"2 287,12";"-10,00000%";"2,52";"2,52";"-";"-";"-";"-";"-";"-";"-";"-";"-";"-";"-";"-";"-";"-";"-";"-";"-";"-"
"17 Cze 2024 23:01:10";"Koszty Utrzymania Pozycji";"O2-CX-922YGK";"-";"-";"Solana (USD)";"-";"-";"-";"-";"-";"-";"-";"-";"-";"-";"-";"-";"2 930,37";"-27,50000%";"-8,99";"-8,99";"-";"-";"-";"-";"-";"-";"-";"-";"-";"-";"-";"-";"-";"-";"-";"-";"-";"-"
"17 Cze 2024 23:01:10";"Koszty Utrzymania Pozycji";"O2-CX-922YEX";"-";"-";"Solana (USD)";"-";"-";"-";"-";"-";"-";"-";"-";"-";"-";"-";"-";"2 951,81";"-27,50000%";"-9,05";"-9,05";"-";"-";"-";"-";"-";"-";"-";"-";"-";"-";"-";"-";"-";"-";"-";"-";"-";"-"
"17 Cze 2024 23:01:10";"Koszty Utrzymania Pozycji";"O2-CX-9250P8";"-";"-";"Solana (USD)";"-";"-";"-";"-";"-";"-";"-";"-";"-";"-";"-";"-";"2 308,56";"-10,00000%";"2,55";"2,55";"-";"-";"-";"-";"-";"-";"-";"-";"-";"-";"-";"-";"-";"-";"-";"-";"-";"-"
"17 Cze 2024 23:01:10";"Koszty Utrzymania Pozycji";"O2-CW-916WS8";"-";"-";"Solana (USD)";"-";"-";"-";"-";"-";"-";"-";"-";"-";"-";"-";"-";"3 001,84";"-27,50000%";"-9,20";"-9,20";"-";"-";"-";"-";"-";"-";"-";"-";"-";"-";"-";"-";"-";"-";"-";"-";"-";"-"
"17 Cze 2024 22:15:26";"Stop Loss";"O2-CY-92MXLF";"T2-CY-5GJ57V";"-";"Solana (USD)";"18 Jednost.";"142,890";"-";"-";"-";"-";"4,02939";"10 467,79";"122,21";"10 790,17";"-";"-";"-";"-";"-";"-";"-";"-";"-";"-";"-";"-";"-";"-";"-";"-";"-";"-";"-";"-";"-";"-";"-";"-"
"17 Cze 2024 22:15:26";"Stop Loss";"O2-CY-92MXJK";"T2-CY-5GJ57T";"-";"Solana (USD)";"30 Jednost.";"142,890";"-";"-";"-";"-";"4,02939";"17 446,32";"214,57";"10 667,96";"-";"-";"-";"-";"-";"-";"-";"-";"-";"-";"-";"-";"-";"-";"-";"-";"-";"-";"-";"-";"-";"-";"-";"-"
"17 Cze 2024 22:11:13";"Zmodyfikowano Transakcję Sprzedaży";"O2-CY-92MXLF";"T2-CY-5GJ3N9";"-";"Solana (USD)";"18 Jednost.";"144,575";"-";"142,800";"-";"-";"-";"-";"0,00";"-";"-";"-";"-";"-";"-";"-";"-";"-";"-";"-";"-";"-";"-";"-";"-";"-";"-";"-";"-";"-";"-";"-";"-";"-"
"17 Cze 2024 22:10:53";"Zmodyfikowano Transakcję Sprzedaży";"O2-CY-92MXJK";"T2-CY-5GJ3LF";"-";"Solana (USD)";"30 Jednost.";"144,665";"-";"142,800";"-";"-";"-";"-";"0,00";"-";"-";"-";"-";"-";"-";"-";"-";"-";"-";"-";"-";"-";"-";"-";"-";"-";"-";"-";"-";"-";"-";"-";"-";"-"
"17 Cze 2024 21:47:41";"Transakcja Sprzedaży";"O2-CY-92MXLF";"T2-CY-5GJ3N9";"-";"Solana (USD)";"18 Jednost.";"144,575";"-";"-";"-";"-";"4,070885";"10 593,86";"0,00";"-";"-";"-";"-";"-";"-";"-";"-";"-";"-";"-";"-";"-";"-";"-";"-";"-";"-";"-";"-";"-";"-";"-";"-";"-"
"17 Cze 2024 21:46:56";"Transakcja Sprzedaży";"O2-CY-92MXJK";"T2-CY-5GJ3LF";"-";"Solana (USD)";"30 Jednost.";"144,665";"-";"-";"-";"-";"4,070895";"17 667,48";"0,00";"-";"-";"-";"-";"-";"-";"-";"-";"-";"-";"-";"-";"-";"-";"-";"-";"-";"-";"-";"-";"-";"-";"-";"-";"-"
"17 Cze 2024 17:24:56";" Zamknięcie Transakcji";"O2-CY-92MEJQ";"T2-CY-5GHNGB";"O2-CY-92LT5F";"Solana (USD)";"30 Jednost.";"142,820";"-";"-";"-";"-";"4,04222";"17 493,37";"91,56";"10 453,39";"-";"-";"-";"-";"-";"-";"-";"-";"-";"-";"-";"-";"-";"-";"-";"-";"-";"-";"-";"-";"-";"-";"-";"-"
"17 Cze 2024 17:24:31";" Zamknięcie Transakcji";"O2-CY-92MEHT";"T2-CY-5GHNFG";"O2-CY-92LT78";"Solana (USD)";"17 Jednost.";"142,680";"-";"-";"-";"-";"4,04206";"9 902,78";"28,86";"10 361,83";"-";"-";"-";"-";"-";"-";"-";"-";"-";"-";"-";"-";"-";"-";"-";"-";"-";"-";"-";"-";"-";"-";"-";"-"
"17 Cze 2024 12:08:17";"Transakcja Sprzedaży";"O2-CY-92LT78";"T2-CY-5GH59L";"-";"Solana (USD)";"17 Jednost.";"143,100";"-";"-";"-";"-";"4,095594";"9 963,35";"0,00";"-";"-";"-";"-";"-";"-";"-";"-";"-";"-";"-";"-";"-";"-";"-";"-";"-";"-";"-";"-";"-";"-";"-";"-";"-"
"17 Cze 2024 12:07:20";"Transakcja Sprzedaży";"O2-CY-92LT5F";"T2-CY-5GH57V";"-";"Solana (USD)";"30 Jednost.";"143,575";"-";"-";"-";"-";"4,095274";"17 639,36";"0,00";"-";"-";"-";"-";"-";"-";"-";"-";"-";"-";"-";"-";"-";"-";"-";"-";"-";"-";"-";"-";"-";"-";"-";"-";"-"
"14 Cze 2024 23:01:08";"Koszty Utrzymania Pozycji";"1346140840";"-";"-";"Rachunek";"-";"-";"-";"-";"-";"-";"-";"-";"-66,59";"10 332,97";"-";"-";"-";"-";"-";"-66,59";"-";"-";"-";"-";"-";"-";"-";"-";"-";"-";"-";"-";"-";"-";"-";"-";"-";"-"
"14 Cze 2024 23:01:08";"Koszty Utrzymania Pozycji";"O2-CX-9250PH";"-";"-";"Solana (USD)";"-";"-";"-";"-";"-";"-";"-";"-";"-";"-";"-";"-";"2 267,04";"-10,00000%";"7,59";"7,59";"-";"-";"-";"-";"-";"-";"-";"-";"-";"-";"-";"-";"-";"-";"-";"-";"-";"-"
"14 Cze 2024 23:01:08";"Koszty Utrzymania Pozycji";"O2-CX-922YGK";"-";"-";"Solana (USD)";"-";"-";"-";"-";"-";"-";"-";"-";"-";"-";"-";"-";"2 904,64";"-27,50000%";"-27,00";"-27,00";"-";"-";"-";"-";"-";"-";"-";"-";"-";"-";"-";"-";"-";"-";"-";"-";"-";"-"
"14 Cze 2024 23:01:08";"Koszty Utrzymania Pozycji";"O2-CX-922YEX";"-";"-";"Solana (USD)";"-";"-";"-";"-";"-";"-";"-";"-";"-";"-";"-";"-";"2 925,89";"-27,50000%";"-27,19";"-27,19";"-";"-";"-";"-";"-";"-";"-";"-";"-";"-";"-";"-";"-";"-";"-";"-";"-";"-"
"14 Cze 2024 23:01:08";"Koszty Utrzymania Pozycji";"O2-CX-9250P8";"-";"-";"Solana (USD)";"-";"-";"-";"-";"-";"-";"-";"-";"-";"-";"-";"-";"2 288,29";"-10,00000%";"7,66";"7,66";"-";"-";"-";"-";"-";"-";"-";"-";"-";"-";"-";"-";"-";"-";"-";"-";"-";"-"
"14 Cze 2024 23:01:08";"Koszty Utrzymania Pozycji";"O2-CW-916WS8";"-";"-";"Solana (USD)";"-";"-";"-";"-";"-";"-";"-";"-";"-";"-";"-";"-";"2 975,49";"-27,50000%";"-27,65";"-27,65";"-";"-";"-";"-";"-";"-";"-";"-";"-";"-";"-";"-";"-";"-";"-";"-";"-";"-"
"13 Cze 2024 23:01:07";"Koszty Utrzymania Pozycji";"1345692801";"-";"-";"Rachunek";"-";"-";"-";"-";"-";"-";"-";"-";"-22,82";"10 399,56";"-";"-";"-";"-";"-";"-22,82";"-";"-";"-";"-";"-";"-";"-";"-";"-";"-";"-";"-";"-";"-";"-";"-";"-";"-"
"13 Cze 2024 23:01:07";"Koszty Utrzymania Pozycji";"O2-CX-9250PH";"-";"-";"Solana (USD)";"-";"-";"-";"-";"-";"-";"-";"-";"-";"-";"-";"-";"2 354,40";"-10,00000%";"2,60";"2,60";"-";"-";"-";"-";"-";"-";"-";"-";"-";"-";"-";"-";"-";"-";"-";"-";"-";"-"
"13 Cze 2024 23:01:07";"Koszty Utrzymania Pozycji";"O2-CX-922YGK";"-";"-";"Solana (USD)";"-";"-";"-";"-";"-";"-";"-";"-";"-";"-";"-";"-";"3 016,57";"-27,50000%";"-9,25";"-9,25";"-";"-";"-";"-";"-";"-";"-";"-";"-";"-";"-";"-";"-";"-";"-";"-";"-";"-"
"13 Cze 2024 23:01:07";"Koszty Utrzymania Pozycji";"O2-CX-922YEX";"-";"-";"Solana (USD)";"-";"-";"-";"-";"-";"-";"-";"-";"-";"-";"-";"-";"3 038,64";"-27,50000%";"-9,32";"-9,32";"-";"-";"-";"-";"-";"-";"-";"-";"-";"-";"-";"-";"-";"-";"-";"-";"-";"-"
"13 Cze 2024 23:01:07";"Koszty Utrzymania Pozycji";"O2-CX-9250P8";"-";"-";"Solana (USD)";"-";"-";"-";"-";"-";"-";"-";"-";"-";"-";"-";"-";"2 376,47";"-10,00000%";"2,62";"2,62";"-";"-";"-";"-";"-";"-";"-";"-";"-";"-";"-";"-";"-";"-";"-";"-";"-";"-"
"13 Cze 2024 23:01:07";"Koszty Utrzymania Pozycji";"O2-CW-916WS8";"-";"-";"Solana (USD)";"-";"-";"-";"-";"-";"-";"-";"-";"-";"-";"-";"-";"3 090,15";"-27,50000%";"-9,47";"-9,47";"-";"-";"-";"-";"-";"-";"-";"-";"-";"-";"-";"-";"-";"-";"-";"-";"-";"-"
"12 Cze 2024 23:01:05";"Koszty Utrzymania Pozycji";"1345248139";"-";"-";"Rachunek";"-";"-";"-";"-";"-";"-";"-";"-";"-23,78";"10 422,38";"-";"-";"-";"-";"-";"-23,78";"-";"-";"-";"-";"-";"-";"-";"-";"-";"-";"-";"-";"-";"-";"-";"-";"-";"-"
"12 Cze 2024 23:01:05";"Koszty Utrzymania Pozycji";"O2-CX-9250PH";"-";"-";"Solana (USD)";"-";"-";"-";"-";"-";"-";"-";"-";"-";"-";"-";"-";"2 478,72";"-10,00000%";"2,71";"2,71";"-";"-";"-";"-";"-";"-";"-";"-";"-";"-";"-";"-";"-";"-";"-";"-";"-";"-"
"12 Cze 2024 23:01:05";"Koszty Utrzymania Pozycji";"O2-CX-922YGK";"-";"-";"Solana (USD)";"-";"-";"-";"-";"-";"-";"-";"-";"-";"-";"-";"-";"3 175,86";"-27,50000%";"-9,64";"-9,64";"-";"-";"-";"-";"-";"-";"-";"-";"-";"-";"-";"-";"-";"-";"-";"-";"-";"-"
"12 Cze 2024 23:01:05";"Koszty Utrzymania Pozycji";"O2-CX-922YEX";"-";"-";"Solana (USD)";"-";"-";"-";"-";"-";"-";"-";"-";"-";"-";"-";"-";"3 199,09";"-27,50000%";"-9,71";"-9,71";"-";"-";"-";"-";"-";"-";"-";"-";"-";"-";"-";"-";"-";"-";"-";"-";"-";"-"
"12 Cze 2024 23:01:05";"Koszty Utrzymania Pozycji";"O2-CX-9250P8";"-";"-";"Solana (USD)";"-";"-";"-";"-";"-";"-";"-";"-";"-";"-";"-";"-";"2 501,95";"-10,00000%";"2,73";"2,73";"-";"-";"-";"-";"-";"-";"-";"-";"-";"-";"-";"-";"-";"-";"-";"-";"-";"-"
"12 Cze 2024 23:01:05";"Koszty Utrzymania Pozycji";"O2-CW-916WS8";"-";"-";"Solana (USD)";"-";"-";"-";"-";"-";"-";"-";"-";"-";"-";"-";"-";"3 253,32";"-27,50000%";"-9,87";"-9,87";"-";"-";"-";"-";"-";"-";"-";"-";"-";"-";"-";"-";"-";"-";"-";"-";"-";"-"
"11 Cze 2024 23:01:08";"Koszty Utrzymania Pozycji";"1344758273";"-";"-";"Rachunek";"-";"-";"-";"-";"-";"-";"-";"-";"-22,95";"10 446,16";"-";"-";"-";"-";"-";"-22,95";"-";"-";"-";"-";"-";"-";"-";"-";"-";"-";"-";"-";"-";"-";"-";"-";"-";"-"
"11 Cze 2024 23:01:08";"Koszty Utrzymania Pozycji";"O2-CX-9250PH";"-";"-";"Solana (USD)";"-";"-";"-";"-";"-";"-";"-";"-";"-";"-";"-";"-";"2 372,81";"-10,00000%";"2,61";"2,61";"-";"-";"-";"-";"-";"-";"-";"-";"-";"-";"-";"-";"-";"-";"-";"-";"-";"-"
"11 Cze 2024 23:01:08";"Koszty Utrzymania Pozycji";"O2-CX-922YGK";"-";"-";"Solana (USD)";"-";"-";"-";"-";"-";"-";"-";"-";"-";"-";"-";"-";"3 040,17";"-27,50000%";"-9,30";"-9,30";"-";"-";"-";"-";"-";"-";"-";"-";"-";"-";"-";"-";"-";"-";"-";"-";"-";"-"
"11 Cze 2024 23:01:08";"Koszty Utrzymania Pozycji";"O2-CX-922YEX";"-";"-";"Solana (USD)";"-";"-";"-";"-";"-";"-";"-";"-";"-";"-";"-";"-";"3 062,41";"-27,50000%";"-9,37";"-9,37";"-";"-";"-";"-";"-";"-";"-";"-";"-";"-";"-";"-";"-";"-";"-";"-";"-";"-"
"11 Cze 2024 23:01:08";"Koszty Utrzymania Pozycji";"O2-CX-9250P8";"-";"-";"Solana (USD)";"-";"-";"-";"-";"-";"-";"-";"-";"-";"-";"-";"-";"2 395,06";"-10,00000%";"2,64";"2,64";"-";"-";"-";"-";"-";"-";"-";"-";"-";"-";"-";"-";"-";"-";"-";"-";"-";"-"
"11 Cze 2024 23:01:08";"Koszty Utrzymania Pozycji";"O2-CW-916WS8";"-";"-";"Solana (USD)";"-";"-";"-";"-";"-";"-";"-";"-";"-";"-";"-";"-";"3 114,32";"-27,50000%";"-9,53";"-9,53";"-";"-";"-";"-";"-";"-";"-";"-";"-";"-";"-";"-";"-";"-";"-";"-";"-";"-"
"10 Cze 2024 23:00:56";"Koszty Utrzymania Pozycji";"1344239243";"-";"-";"Rachunek";"-";"-";"-";"-";"-";"-";"-";"-";"-24,59";"10 469,11";"-";"-";"-";"-";"-";"-24,59";"-";"-";"-";"-";"-";"-";"-";"-";"-";"-";"-";"-";"-";"-";"-";"-";"-";"-"
"10 Cze 2024 23:00:56";"Koszty Utrzymania Pozycji";"O2-CX-9250PH";"-";"-";"Solana (USD)";"-";"-";"-";"-";"-";"-";"-";"-";"-";"-";"-";"-";"2 558,00";"-10,00000%";"2,80";"2,80";"-";"-";"-";"-";"-";"-";"-";"-";"-";"-";"-";"-";"-";"-";"-";"-";"-";"-"
"10 Cze 2024 23:00:56";"Koszty Utrzymania Pozycji";"O2-CX-922YGK";"-";"-";"Solana (USD)";"-";"-";"-";"-";"-";"-";"-";"-";"-";"-";"-";"-";"3 277,43";"-27,50000%";"-9,97";"-9,97";"-";"-";"-";"-";"-";"-";"-";"-";"-";"-";"-";"-";"-";"-";"-";"-";"-";"-"
"10 Cze 2024 23:00:56";"Koszty Utrzymania Pozycji";"O2-CX-922YEX";"-";"-";"Solana (USD)";"-";"-";"-";"-";"-";"-";"-";"-";"-";"-";"-";"-";"3 301,41";"-27,50000%";"-10,04";"-10,04";"-";"-";"-";"-";"-";"-";"-";"-";"-";"-";"-";"-";"-";"-";"-";"-";"-";"-"
"10 Cze 2024 23:00:56";"Koszty Utrzymania Pozycji";"O2-CX-9250P8";"-";"-";"Solana (USD)";"-";"-";"-";"-";"-";"-";"-";"-";"-";"-";"-";"-";"2 581,98";"-10,00000%";"2,83";"2,83";"-";"-";"-";"-";"-";"-";"-";"-";"-";"-";"-";"-";"-";"-";"-";"-";"-";"-"
"10 Cze 2024 23:00:56";"Koszty Utrzymania Pozycji";"O2-CW-916WS8";"-";"-";"Solana (USD)";"-";"-";"-";"-";"-";"-";"-";"-";"-";"-";"-";"-";"3 357,37";"-27,50000%";"-10,21";"-10,21";"-";"-";"-";"-";"-";"-";"-";"-";"-";"-";"-";"-";"-";"-";"-";"-";"-";"-"
"07 Cze 2024 23:01:05";"Koszty Utrzymania Pozycji";"1343863342";"-";"-";"Rachunek";"-";"-";"-";"-";"-";"-";"-";"-";"-74,31";"10 493,70";"-";"-";"-";"-";"-";"-74,31";"-";"-";"-";"-";"-";"-";"-";"-";"-";"-";"-";"-";"-";"-";"-";"-";"-";"-"
"07 Cze 2024 23:01:05";"Koszty Utrzymania Pozycji";"O2-CX-9250PH";"-";"-";"Solana (USD)";"-";"-";"-";"-";"-";"-";"-";"-";"-";"-";"-";"-";"2 591,04";"-10,00000%";"8,46";"8,46";"-";"-";"-";"-";"-";"-";"-";"-";"-";"-";"-";"-";"-";"-";"-";"-";"-";"-"
"07 Cze 2024 23:01:05";"Koszty Utrzymania Pozycji";"O2-CX-922YGK";"-";"-";"Solana (USD)";"-";"-";"-";"-";"-";"-";"-";"-";"-";"-";"-";"-";"3 319,77";"-27,50000%";"-30,12";"-30,12";"-";"-";"-";"-";"-";"-";"-";"-";"-";"-";"-";"-";"-";"-";"-";"-";"-";"-"
"07 Cze 2024 23:01:05";"Koszty Utrzymania Pozycji";"O2-CX-922YEX";"-";"-";"Solana (USD)";"-";"-";"-";"-";"-";"-";"-";"-";"-";"-";"-";"-";"3 344,06";"-27,50000%";"-30,34";"-30,34";"-";"-";"-";"-";"-";"-";"-";"-";"-";"-";"-";"-";"-";"-";"-";"-";"-";"-"
"07 Cze 2024 23:01:05";"Koszty Utrzymania Pozycji";"O2-CX-9250P8";"-";"-";"Solana (USD)";"-";"-";"-";"-";"-";"-";"-";"-";"-";"-";"-";"-";"2 615,33";"-10,00000%";"8,54";"8,54";"-";"-";"-";"-";"-";"-";"-";"-";"-";"-";"-";"-";"-";"-";"-";"-";"-";"-"
"07 Cze 2024 23:01:05";"Koszty Utrzymania Pozycji";"O2-CW-916WS8";"-";"-";"Solana (USD)";"-";"-";"-";"-";"-";"-";"-";"-";"-";"-";"-";"-";"3 400,74";"-27,50000%";"-30,85";"-30,85";"-";"-";"-";"-";"-";"-";"-";"-";"-";"-";"-";"-";"-";"-";"-";"-";"-";"-"
"07 Cze 2024 21:10:28";" Zamknięcie Transakcji";"O2-CX-92774Q";"T2-CX-5G5SNN";"O2-CX-9250PH";"Solana (USD)";"2 Jednost.";"160,775";"-";"-";"-";"-";"3,97213";"1 290,07";"74,00";"10 568,01";"-";"-";"-";"-";"-";"-";"-";"-";"-";"-";"-";"-";"-";"-";"-";"-";"-";"-";"-";"-";"-";"-";"-";"-"
"07 Cze 2024 21:08:30";" Zamknięcie Transakcji";"O2-CX-92772D";"T2-CX-5G5SL7";"O2-CX-9250PH";"Solana (USD)";"2 Jednost.";"160,725";"-";"-";"-";"-";"3,97193";"1 289,61";"74,39";"10 494,01";"-";"-";"-";"-";"-";"-";"-";"-";"-";"-";"-";"-";"-";"-";"-";"-";"-";"-";"-";"-";"-";"-";"-";"-"
"07 Cze 2024 21:07:13";" Zamknięcie Transakcji";"O2-CX-92770F";"T2-CX-5G5SJP";"O2-CX-9250PH";"Solana (USD)";"2 Jednost.";"160,875";"-";"-";"-";"-";"3,97178";"1 290,76";"73,20";"10 419,62";"-";"-";"-";"-";"-";"-";"-";"-";"-";"-";"-";"-";"-";"-";"-";"-";"-";"-";"-";"-";"-";"-";"-";"-"
"07 Cze 2024 20:00:40";"Take Profit";"O2-CX-91YH09";"T2-CX-5G5N9H";"-";"Solana (USD)";"23 Jednost.";"165,000";"-";"-";"-";"-";"3,97107";"15 221,65";"32,42";"10 175,81";"-";"-";"-";"-";"-";"-";"-";"-";"-";"-";"-";"-";"-";"-";"-";"-";"-";"-";"-";"-";"-";"-";"-";"-"
"07 Cze 2024 20:00:40";"Take Profit";"O2-CX-91YFQ8";"T2-CX-5G5N9J";"-";"Solana (USD)";"23 Jednost.";"165,000";"-";"-";"-";"-";"3,97107";"15 221,65";"170,61";"10 346,42";"-";"-";"-";"-";"-";"-";"-";"-";"-";"-";"-";"-";"-";"-";"-";"-";"-";"-";"-";"-";"-";"-";"-";"-"
"06 Cze 2024 23:06:20";"Transakcja Sprzedaży";"O2-CX-9250PH";"T2-CX-5G3SV3";"-";"Solana (USD)";"22 Jednost.";"170,090";"-";"-";"-";"-";"3,952589";"14 790,50";"0,00";"-";"-";"-";"-";"-";"-";"-";"-";"-";"-";"-";"-";"-";"-";"-";"-";"-";"-";"-";"-";"-";"-";"-";"-";"-"
"06 Cze 2024 23:05:29";"Transakcja Sprzedaży";"O2-CX-9250P8";"T2-CX-5G3STX";"-";"Solana (USD)";"16,15 Jednost.";"170,320";"-";"-";"-";"-";"3,952529";"10 872,09";"0,00";"-";"-";"-";"-";"-";"-";"-";"-";"-";"-";"-";"-";"-";"-";"-";"-";"-";"-";"-";"-";"-";"-";"-";"-";"-"
"06 Cze 2024 23:00:58";"Koszty Utrzymania Pozycji";"1343346668";"-";"-";"Rachunek";"-";"-";"-";"-";"-";"-";"-";"-";"-23,13";"10 143,39";"-";"-";"-";"-";"-";"-23,13";"-";"-";"-";"-";"-";"-";"-";"-";"-";"-";"-";"-";"-";"-";"-";"-";"-";"-"
"06 Cze 2024 23:00:58";"Koszty Utrzymania Pozycji";"O2-CX-91YFQ8";"-";"-";"Solana (USD)";"-";"-";"-";"-";"-";"-";"-";"-";"-";"-";"-";"-";"3 918,28";"-10,00000%";"4,20";"4,20";"-";"-";"-";"-";"-";"-";"-";"-";"-";"-";"-";"-";"-";"-";"-";"-";"-";"-"
"06 Cze 2024 23:00:58";"Koszty Utrzymania Pozycji";"O2-CX-91YH09";"-";"-";"Solana (USD)";"-";"-";"-";"-";"-";"-";"-";"-";"-";"-";"-";"-";"3 918,28";"-10,00000%";"4,20";"4,20";"-";"-";"-";"-";"-";"-";"-";"-";"-";"-";"-";"-";"-";"-";"-";"-";"-";"-"
"06 Cze 2024 23:00:58";"Koszty Utrzymania Pozycji";"O2-CX-922YGK";"-";"-";"Solana (USD)";"-";"-";"-";"-";"-";"-";"-";"-";"-";"-";"-";"-";"3 492,38";"-27,50000%";"-10,40";"-10,40";"-";"-";"-";"-";"-";"-";"-";"-";"-";"-";"-";"-";"-";"-";"-";"-";"-";"-"
"06 Cze 2024 23:00:58";"Koszty Utrzymania Pozycji";"O2-CX-922YEX";"-";"-";"Solana (USD)";"-";"-";"-";"-";"-";"-";"-";"-";"-";"-";"-";"-";"3 517,93";"-27,50000%";"-10,48";"-10,48";"-";"-";"-";"-";"-";"-";"-";"-";"-";"-";"-";"-";"-";"-";"-";"-";"-";"-"
"06 Cze 2024 23:00:58";"Koszty Utrzymania Pozycji";"O2-CW-916WS8";"-";"-";"Solana (USD)";"-";"-";"-";"-";"-";"-";"-";"-";"-";"-";"-";"-";"3 577,56";"-27,50000%";"-10,65";"-10,65";"-";"-";"-";"-";"-";"-";"-";"-";"-";"-";"-";"-";"-";"-";"-";"-";"-";"-"
"06 Cze 2024 22:22:50";" Zamknięcie Transakcji";"O2-CX-925063";"T2-CX-5G3SE5";"O2-CX-9226K2";"Solana (USD)";"21 Jednost.";"169,930";"-";"-";"-";"-";"3,9077";"14 084,87";"118,58";"10 166,52";"-";"-";"-";"-";"-";"-";"-";"-";"-";"-";"-";"-";"-";"-";"-";"-";"-";"-";"-";"-";"-";"-";"-";"-"
"06 Cze 2024 22:22:39";" Zamknięcie Transakcji";"O2-CX-925062";"T2-CX-5G3SE4";"O2-CX-92266N";"Solana (USD)";"22 Jednost.";"169,955";"-";"-";"-";"-";"3,9077";"14 757,75";"120,79";"10 047,94";"-";"-";"-";"-";"-";"-";"-";"-";"-";"-";"-";"-";"-";"-";"-";"-";"-";"-";"-";"-";"-";"-";"-";"-"
"06 Cze 2024 20:52:41";"Zmodyfikowano Transakcję Sprzedaży";"O2-CX-9226K2";"T2-CX-5G1FKZ";"-";"Solana (USD)";"21 Jednost.";"171,375";"-";"171,300";"-";"-";"-";"-";"0,00";"-";"-";"-";"-";"-";"-";"-";"-";"-";"-";"-";"-";"-";"-";"-";"-";"-";"-";"-";"-";"-";"-";"-";"-";"-"
"06 Cze 2024 20:52:00";"Zmodyfikowano Transakcję Sprzedaży";"O2-CX-92266N";"T2-CX-5G1F9D";"-";"Solana (USD)";"22 Jednost.";"171,360";"-";"171,300";"-";"-";"-";"-";"0,00";"-";"-";"-";"-";"-";"-";"-";"-";"-";"-";"-";"-";"-";"-";"-";"-";"-";"-";"-";"-";"-";"-";"-";"-";"-"
"05 Cze 2024 23:05:55";" Zamknięcie Transakcji";"O2-CX-92336R";"T2-CX-5G268S";"O2-CX-9221N0";"Solana (USD)";"25 Jednost.";"173,300";"-";"-";"-";"-";"3,92654";"17 182,72";"70,09";"9 927,15";"-";"-";"-";"-";"-";"-";"-";"-";"-";"-";"-";"-";"-";"-";"-";"-";"-";"-";"-";"-";"-";"-";"-";"-"
"05 Cze 2024 23:00:55";"Koszty Utrzymania Pozycji";"1342919178";"-";"-";"Rachunek";"-";"-";"-";"-";"-";"-";"-";"-";"-28,58";"9 857,06";"-";"-";"-";"-";"-";"-28,58";"-";"-";"-";"-";"-";"-";"-";"-";"-";"-";"-";"-";"-";"-";"-";"-";"-";"-"
"05 Cze 2024 23:00:55";"Koszty Utrzymania Pozycji";"O2-CX-91YFQ8";"-";"-";"Solana (USD)";"-";"-";"-";"-";"-";"-";"-";"-";"-";"-";"-";"-";"3 988,31";"-10,00000%";"4,29";"4,29";"-";"-";"-";"-";"-";"-";"-";"-";"-";"-";"-";"-";"-";"-";"-";"-";"-";"-"
"05 Cze 2024 23:00:55";"Koszty Utrzymania Pozycji";"O2-CX-91YH09";"-";"-";"Solana (USD)";"-";"-";"-";"-";"-";"-";"-";"-";"-";"-";"-";"-";"3 988,31";"-10,00000%";"4,29";"4,29";"-";"-";"-";"-";"-";"-";"-";"-";"-";"-";"-";"-";"-";"-";"-";"-";"-";"-"
"05 Cze 2024 23:00:55";"Koszty Utrzymania Pozycji";"O2-CX-922YGK";"-";"-";"Solana (USD)";"-";"-";"-";"-";"-";"-";"-";"-";"-";"-";"-";"-";"3 554,80";"-27,50000%";"-10,63";"-10,63";"-";"-";"-";"-";"-";"-";"-";"-";"-";"-";"-";"-";"-";"-";"-";"-";"-";"-"
"05 Cze 2024 23:00:55";"Koszty Utrzymania Pozycji";"O2-CX-92266N";"-";"-";"Solana (USD)";"-";"-";"-";"-";"-";"-";"-";"-";"-";"-";"-";"-";"3 814,91";"-10,00000%";"4,11";"4,11";"-";"-";"-";"-";"-";"-";"-";"-";"-";"-";"-";"-";"-";"-";"-";"-";"-";"-"
"05 Cze 2024 23:00:55";"Koszty Utrzymania Pozycji";"O2-CX-9226K2";"-";"-";"Solana (USD)";"-";"-";"-";"-";"-";"-";"-";"-";"-";"-";"-";"-";"3 641,50";"-10,00000%";"3,92";"3,92";"-";"-";"-";"-";"-";"-";"-";"-";"-";"-";"-";"-";"-";"-";"-";"-";"-";"-"
"05 Cze 2024 23:00:55";"Koszty Utrzymania Pozycji";"O2-CX-922YEX";"-";"-";"Solana (USD)";"-";"-";"-";"-";"-";"-";"-";"-";"-";"-";"-";"-";"3 580,81";"-27,50000%";"-10,71";"-10,71";"-";"-";"-";"-";"-";"-";"-";"-";"-";"-";"-";"-";"-";"-";"-";"-";"-";"-"
"05 Cze 2024 23:00:55";"Koszty Utrzymania Pozycji";"O2-CW-916WS8";"-";"-";"Solana (USD)";"-";"-";"-";"-";"-";"-";"-";"-";"-";"-";"-";"-";"3 641,50";"-27,50000%";"-10,89";"-10,89";"-";"-";"-";"-";"-";"-";"-";"-";"-";"-";"-";"-";"-";"-";"-";"-";"-";"-"
"05 Cze 2024 23:00:55";"Koszty Utrzymania Pozycji";"O2-CX-9221N0";"-";"-";"Solana (USD)";"-";"-";"-";"-";"-";"-";"-";"-";"-";"-";"-";"-";"4 335,12";"-27,50000%";"-12,96";"-12,96";"-";"-";"-";"-";"-";"-";"-";"-";"-";"-";"-";"-";"-";"-";"-";"-";"-";"-"
"05 Cze 2024 22:46:29";" Zamknięcie Transakcji";"O2-CX-9232VZ";"T2-CX-5G260N";"O2-CX-92230Z";"Solana (USD)";"22 Jednost.";"172,965";"-";"-";"-";"-";"3,92983";"15 104,22";"16,43";"9 885,64";"-";"-";"-";"-";"-";"-";"-";"-";"-";"-";"-";"-";"-";"-";"-";"-";"-";"-";"-";"-";"-";"-";"-";"-"
"05 Cze 2024 21:02:41";" Transakcja Kupna";"O2-CX-922YGK";"T2-CX-5G22B3";"-";"Solana (USD)";"20,5 Jednost.";"173,496";"-";"-";"-";"-";"3,965645";"14 104,48";"0,00";"-";"-";"-";"-";"-";"-";"-";"-";"-";"-";"-";"-";"-";"-";"-";"-";"-";"-";"-";"-";"-";"-";"-";"-";"-"
"05 Cze 2024 21:01:44";" Transakcja Kupna";"O2-CX-922YEX";"T2-CX-5G228Q";"-";"Solana (USD)";"20,65 Jednost.";"173,411";"-";"-";"-";"-";"3,965435";"14 199,97";"0,00";"-";"-";"-";"-";"-";"-";"-";"-";"-";"-";"-";"-";"-";"-";"-";"-";"-";"-";"-";"-";"-";"-";"-";"-";"-"
"05 Cze 2024 17:09:43";" Zmodyfikowano Transakcję Kupna";"O2-CX-9221N0";"T2-CX-5G1BV4";"-";"Solana (USD)";"25 Jednost.";"172,586";"-";"-";"-";"-";"-";"-";"0,00";"-";"-";"-";"-";"-";"-";"-";"-";"-";"-";"-";"-";"-";"-";"-";"-";"-";"-";"-";"-";"-";"-";"-";"-";"-"
"05 Cze 2024 17:09:35";" Zmodyfikowano Transakcję Kupna";"O2-CX-92230Z";"T2-CX-5G1C95";"-";"Solana (USD)";"22 Jednost.";"172,775";"-";"-";"-";"-";"-";"-";"0,00";"-";"-";"-";"-";"-";"-";"-";"-";"-";"-";"-";"-";"-";"-";"-";"-";"-";"-";"-";"-";"-";"-";"-";"-";"-"
"05 Cze 2024 16:14:16";"Transakcja Sprzedaży";"O2-CX-9226K2";"T2-CX-5G1FKZ";"-";"Solana (USD)";"21 Jednost.";"171,375";"-";"-";"-";"-";"3,974693";"14 304,42";"0,00";"-";"-";"-";"-";"-";"-";"-";"-";"-";"-";"-";"-";"-";"-";"-";"-";"-";"-";"-";"-";"-";"-";"-";"-";"-"
"05 Cze 2024 16:11:26";"Transakcja Sprzedaży";"O2-CX-92266N";"T2-CX-5G1F9D";"-";"Solana (USD)";"22 Jednost.";"171,360";"-";"-";"-";"-";"3,976116";"14 989,63";"0,00";"-";"-";"-";"-";"-";"-";"-";"-";"-";"-";"-";"-";"-";"-";"-";"-";"-";"-";"-";"-";"-";"-";"-";"-";"-"
"05 Cze 2024 15:56:45";" Zmodyfikowano Transakcję Kupna";"O2-CX-9221N0";"T2-CX-5G1BV4";"-";"Solana (USD)";"25 Jednost.";"172,586";"-";"-";"173,600";"-";"-";"-";"0,00";"-";"-";"-";"-";"-";"-";"-";"-";"-";"-";"-";"-";"-";"-";"-";"-";"-";"-";"-";"-";"-";"-";"-";"-";"-"
"05 Cze 2024 15:56:20";" Zmodyfikowano Transakcję Kupna";"O2-CX-92230Z";"T2-CX-5G1C95";"-";"Solana (USD)";"22 Jednost.";"172,775";"-";"-";"173,600";"-";"-";"-";"0,00";"-";"-";"-";"-";"-";"-";"-";"-";"-";"-";"-";"-";"-";"-";"-";"-";"-";"-";"-";"-";"-";"-";"-";"-";"-"
"05 Cze 2024 15:55:42";" Transakcja Kupna";"O2-CX-92230Z";"T2-CX-5G1C95";"-";"Solana (USD)";"22 Jednost.";"172,775";"-";"-";"-";"-";"3,965695";"15 073,80";"0,00";"-";"-";"-";"-";"-";"-";"-";"-";"-";"-";"-";"-";"-";"-";"-";"-";"-";"-";"-";"-";"-";"-";"-";"-";"-"
"05 Cze 2024 15:53:01";" Transakcja Kupna";"O2-CX-9221N0";"T2-CX-5G1BV4";"-";"Solana (USD)";"25 Jednost.";"172,586";"-";"-";"-";"-";"3,965455";"17 109,55";"0,00";"-";"-";"-";"-";"-";"-";"-";"-";"-";"-";"-";"-";"-";"-";"-";"-";"-";"-";"-";"-";"-";"-";"-";"-";"-"
"05 Cze 2024 15:33:13";" Zamknięcie Transakcji";"O2-CX-921Y2C";"T2-CX-5G17XJ";"O2-CX-91ZHDD";"Solana (USD)";"1,5 Jednost.";"173,459";"-";"-";"-";"-";"3,92562";"1 031,66";"48,13";"9 869,21";"-";"-";"-";"-";"-";"-";"-";"-";"-";"-";"-";"-";"-";"-";"-";"-";"-";"-";"-";"-";"-";"-";"-";"-"
"05 Cze 2024 15:30:15";"Stop Loss";"O2-CX-921JZ1";"T2-CX-5G17B3";"-";"Solana (USD)";"21 Jednost.";"173,578";"-";"-";"-";"-";"3,92615";"14 455,21";"12,04";"9 785,05";"-";"-";"-";"-";"-";"-";"-";"-";"-";"-";"-";"-";"-";"-";"-";"-";"-";"-";"-";"-";"-";"-";"-";"-"
"05 Cze 2024 15:30:15";"Stop Loss";"O2-CX-921JX6";"T2-CX-5G17B4";"-";"Solana (USD)";"23 Jednost.";"173,578";"-";"-";"-";"-";"3,92615";"15 831,90";"36,03";"9 821,08";"-";"-";"-";"-";"-";"-";"-";"-";"-";"-";"-";"-";"-";"-";"-";"-";"-";"-";"-";"-";"-";"-";"-";"-"
"05 Cze 2024 15:24:36";" Zmodyfikowano Transakcję Kupna";"O2-CX-921JZ1";"T2-CX-5G0Y0S";"-";"Solana (USD)";"21 Jednost.";"173,432";"-";"173,600";"-";"-";"-";"-";"0,00";"-";"-";"-";"-";"-";"-";"-";"-";"-";"-";"-";"-";"-";"-";"-";"-";"-";"-";"-";"-";"-";"-";"-";"-";"-"
"05 Cze 2024 15:24:36";"Zmodyfikowano Stop Loss";"O2-CX-921JZ1";"-";"O2-CX-921WN3";"Solana (USD)";"21 Jednost.";"173,432";"-";"173,600";"-";"-";"-";"-";"-";"-";"-";"-";"-";"-";"-";"-";"-";"-";"-";"-";"-";"-";"-";"-";"-";"-";"-";"-";"-";"-";"-";"-";"-";"-"
"05 Cze 2024 15:24:04";" Zmodyfikowano Transakcję Kupna";"O2-CX-921JX6";"T2-CX-5G0XZG";"-";"Solana (USD)";"23 Jednost.";"173,179";"-";"173,600";"-";"-";"-";"-";"0,00";"-";"-";"-";"-";"-";"-";"-";"-";"-";"-";"-";"-";"-";"-";"-";"-";"-";"-";"-";"-";"-";"-";"-";"-";"-"
"05 Cze 2024 15:22:13";" Zmodyfikowano Transakcję Kupna";"O2-CX-921JZ1";"T2-CX-5G0Y0S";"-";"Solana (USD)";"21 Jednost.";"173,432";"-";"173,500";"173,900";"-";"-";"-";"0,00";"-";"-";"-";"-";"-";"-";"-";"-";"-";"-";"-";"-";"-";"-";"-";"-";"-";"-";"-";"-";"-";"-";"-";"-";"-"
"05 Cze 2024 12:30:58";" Zmodyfikowano Transakcję Kupna";"O2-CX-921JX6";"T2-CX-5G0XZG";"-";"Solana (USD)";"23 Jednost.";"173,179";"-";"-";"173,900";"-";"-";"-";"0,00";"-";"-";"-";"-";"-";"-";"-";"-";"-";"-";"-";"-";"-";"-";"-";"-";"-";"-";"-";"-";"-";"-";"-";"-";"-"
"05 Cze 2024 12:30:38";" Zmodyfikowano Transakcję Kupna";"O2-CX-921JZ1";"T2-CX-5G0Y0S";"-";"Solana (USD)";"21 Jednost.";"173,432";"-";"-";"173,900";"-";"-";"-";"0,00";"-";"-";"-";"-";"-";"-";"-";"-";"-";"-";"-";"-";"-";"-";"-";"-";"-";"-";"-";"-";"-";"-";"-";"-";"-"
"05 Cze 2024 11:20:37";" Transakcja Kupna";"O2-CX-921JZ1";"T2-CX-5G0Y0S";"-";"Solana (USD)";"21 Jednost.";"173,432";"-";"-";"-";"-";"3,983611";"14 508,59";"0,00";"-";"-";"-";"-";"-";"-";"-";"-";"-";"-";"-";"-";"-";"-";"-";"-";"-";"-";"-";"-";"-";"-";"-";"-";"-"
"05 Cze 2024 11:19:19";" Transakcja Kupna";"O2-CX-921JX6";"T2-CX-5G0XZG";"-";"Solana (USD)";"23 Jednost.";"173,179";"-";"-";"-";"-";"3,98336";"15 866,18";"0,00";"-";"-";"-";"-";"-";"-";"-";"-";"-";"-";"-";"-";"-";"-";"-";"-";"-";"-";"-";"-";"-";"-";"-";"-";"-"
"04 Cze 2024 23:00:56";"Koszty Utrzymania Pozycji";"1342483372";"-";"-";"Rachunek";"-";"-";"-";"-";"-";"-";"-";"-";"-3,01";"9 773,01";"-";"-";"-";"-";"-";"-3,01";"-";"-";"-";"-";"-";"-";"-";"-";"-";"-";"-";"-";"-";"-";"-";"-";"-";"-"
"04 Cze 2024 23:00:56";"Koszty Utrzymania Pozycji";"O2-CX-91YFQ8";"-";"-";"Solana (USD)";"-";"-";"-";"-";"-";"-";"-";"-";"-";"-";"-";"-";"3 897,92";"-10,00000%";"4,21";"4,21";"-";"-";"-";"-";"-";"-";"-";"-";"-";"-";"-";"-";"-";"-";"-";"-";"-";"-"
"04 Cze 2024 23:00:56";"Koszty Utrzymania Pozycji";"O2-CX-91YH09";"-";"-";"Solana (USD)";"-";"-";"-";"-";"-";"-";"-";"-";"-";"-";"-";"-";"3 897,92";"-10,00000%";"4,21";"4,21";"-";"-";"-";"-";"-";"-";"-";"-";"-";"-";"-";"-";"-";"-";"-";"-";"-";"-"
"04 Cze 2024 23:00:56";"Koszty Utrzymania Pozycji";"O2-CX-91ZHDD";"-";"-";"Solana (USD)";"-";"-";"-";"-";"-";"-";"-";"-";"-";"-";"-";"-";"254,21";"-27,50000%";"-0,76";"-0,76";"-";"-";"-";"-";"-";"-";"-";"-";"-";"-";"-";"-";"-";"-";"-";"-";"-";"-"
"04 Cze 2024 23:00:56";"Koszty Utrzymania Pozycji";"O2-CW-916WS8";"-";"-";"Solana (USD)";"-";"-";"-";"-";"-";"-";"-";"-";"-";"-";"-";"-";"3 558,97";"-27,50000%";"-10,67";"-10,67";"-";"-";"-";"-";"-";"-";"-";"-";"-";"-";"-";"-";"-";"-";"-";"-";"-";"-"
"04 Cze 2024 21:27:13";"Zmodyfikowano Transakcję Sprzedaży";"O2-CX-91YFQ8";"T2-CX-5FYG7G";"-";"Solana (USD)";"23 Jednost.";"166,868";"-";"-";"165,000";"-";"-";"-";"0,00";"-";"-";"-";"-";"-";"-";"-";"-";"-";"-";"-";"-";"-";"-";"-";"-";"-";"-";"-";"-";"-";"-";"-";"-";"-"
"04 Cze 2024 21:26:35";"Zmodyfikowano Transakcję Sprzedaży";"O2-CX-91YH09";"T2-CX-5FYH3G";"-";"Solana (USD)";"23 Jednost.";"165,355";"-";"-";"165,000";"-";"-";"-";"0,00";"-";"-";"-";"-";"-";"-";"-";"-";"-";"-";"-";"-";"-";"-";"-";"-";"-";"-";"-";"-";"-";"-";"-";"-";"-"
"04 Cze 2024 18:27:42";" Zamknięcie Transakcji";"O2-CX-920GP6";"T2-CX-5G01DT";"O2-CX-91ZHDD";"Solana (USD)";"3,5 Jednost.";"168,700";"-";"-";"-";"-";"3,94236";"2 351,16";"47,12";"9 776,02";"-";"-";"-";"-";"-";"-";"-";"-";"-";"-";"-";"-";"-";"-";"-";"-";"-";"-";"-";"-";"-";"-";"-";"-"
"04 Cze 2024 18:25:00";" Zamknięcie Transakcji";"O2-CX-920GJX";"T2-CX-5G018T";"O2-CW-91TZBJ";"Solana (USD)";"43 Jednost.";"168,635";"-";"-";"-";"-";"3,982238";"28 876,42";"-20,89";"9 728,90";"-";"-";"-";"-";"-";"-";"-";"-";"-";"-";"-";"-";"-";"-";"-";"-";"-";"-";"-";"-";"-";"-";"-";"-"
"04 Cze 2024 12:20:28";" Transakcja Kupna";"O2-CX-91ZHDD";"T2-CX-5FZ7E3";"-";"Solana (USD)";"5 Jednost.";"165,285";"-";"-";"-";"-";"3,96811";"3 279,34";"0,00";"-";"-";"-";"-";"-";"-";"-";"-";"-";"-";"-";"-";"-";"-";"-";"-";"-";"-";"-";"-";"-";"-";"-";"-";"-"
"04 Cze 2024 12:14:51";" Zamknięcie Transakcji";"O2-CX-91ZGZB";"T2-CX-5FZ71T";"O2-CW-91V6QZ";"Solana (USD)";"41 Jednost.";"165,128";"-";"-";"-";"-";"3,93176";"26 886,45";"206,82";"9 749,79";"-";"-";"-";"-";"-";"-";"-";"-";"-";"-";"-";"-";"-";"-";"-";"-";"-";"-";"-";"-";"-";"-";"-";"-"
"03 Cze 2024 23:52:34";" Zmodyfikowano Transakcję Kupna";"O2-CW-91TZBJ";"T2-CW-5FVDMG";"-";"Solana (USD)";"43 Jednost.";"168,757";"-";"-";"-";"-";"-";"-";"0,00";"-";"-";"-";"-";"-";"-";"-";"-";"-";"-";"-";"-";"-";"-";"-";"-";"-";"-";"-";"-";"-";"-";"-";"-";"-"
"03 Cze 2024 23:48:23";"Zmodyfikowano Transakcję Sprzedaży";"O2-CW-91V6QZ";"T2-CW-5FVLGL";"-";"Solana (USD)";"41 Jednost.";"166,411";"-";"-";"163,800";"-";"-";"-";"0,00";"-";"-";"-";"-";"-";"-";"-";"-";"-";"-";"-";"-";"-";"-";"-";"-";"-";"-";"-";"-";"-";"-";"-";"-";"-"
"03 Cze 2024 23:14:16";"Transakcja Sprzedaży";"O2-CX-91YH09";"T2-CX-5FYH3G";"-";"Solana (USD)";"23 Jednost.";"165,355";"-";"-";"-";"-";"3,94284";"14 995,27";"0,00";"-";"-";"-";"-";"-";"-";"-";"-";"-";"-";"-";"-";"-";"-";"-";"-";"-";"-";"-";"-";"-";"-";"-";"-";"-"
"03 Cze 2024 23:00:59";"Koszty Utrzymania Pozycji";"1342026469";"-";"-";"Rachunek";"-";"-";"-";"-";"-";"-";"-";"-";"-20,12";"9 542,97";"-";"-";"-";"-";"-";"-20,12";"-";"-";"-";"-";"-";"-";"-";"-";"-";"-";"-";"-";"-";"-";"-";"-";"-";"-"
"03 Cze 2024 23:00:59";"Koszty Utrzymania Pozycji";"O2-CX-91YFQ8";"-";"-";"Solana (USD)";"-";"-";"-";"-";"-";"-";"-";"-";"-";"-";"-";"-";"3 807,19";"-10,00000%";"4,07";"4,07";"-";"-";"-";"-";"-";"-";"-";"-";"-";"-";"-";"-";"-";"-";"-";"-";"-";"-"
"03 Cze 2024 23:00:59";"Koszty Utrzymania Pozycji";"O2-CW-91V6QZ";"-";"-";"Solana (USD)";"-";"-";"-";"-";"-";"-";"-";"-";"-";"-";"-";"-";"6 786,73";"-10,00000%";"7,25";"7,25";"-";"-";"-";"-";"-";"-";"-";"-";"-";"-";"-";"-";"-";"-";"-";"-";"-";"-"
"03 Cze 2024 23:00:59";"Koszty Utrzymania Pozycji";"O2-CW-916WS8";"-";"-";"Solana (USD)";"-";"-";"-";"-";"-";"-";"-";"-";"-";"-";"-";"-";"3 476,13";"-27,50000%";"-10,32";"-10,32";"-";"-";"-";"-";"-";"-";"-";"-";"-";"-";"-";"-";"-";"-";"-";"-";"-";"-"
"03 Cze 2024 23:00:59";"Koszty Utrzymania Pozycji";"O2-CW-91TZBJ";"-";"-";"Solana (USD)";"-";"-";"-";"-";"-";"-";"-";"-";"-";"-";"-";"-";"7 117,79";"-27,50000%";"-21,12";"-21,12";"-";"-";"-";"-";"-";"-";"-";"-";"-";"-";"-";"-";"-";"-";"-";"-";"-";"-"
"03 Cze 2024 22:54:18";" Zamknięcie Transakcji";"O2-CX-91YGNN";"T2-CX-5FYGXT";"O2-CW-91V6QZ";"Solana (USD)";"2 Jednost.";"166,135";"-";"-";"-";"-";"3,90121";"1 309,28";"2,15";"9 563,09";"-";"-";"-";"-";"-";"-";"-";"-";"-";"-";"-";"-";"-";"-";"-";"-";"-";"-";"-";"-";"-";"-";"-";"-"
"03 Cze 2024 22:33:41";" Zamknięcie Transakcji";"O2-CX-91YGB8";"T2-CX-5FYGNN";"O2-CW-91VMH6";"Solana (USD)";"2 Jednost.";"166,085";"-";"-";"-";"-";"3,90059";"1 308,68";"13,57";"9 560,94";"-";"-";"-";"-";"-";"-";"-";"-";"-";"-";"-";"-";"-";"-";"-";"-";"-";"-";"-";"-";"-";"-";"-";"-"
"03 Cze 2024 22:12:51";"Transakcja Sprzedaży";"O2-CX-91YFQ8";"T2-CX-5FYG7G";"-";"Solana (USD)";"23 Jednost.";"166,868";"-";"-";"-";"-";"3,940645";"15 124,05";"0,00";"-";"-";"-";"-";"-";"-";"-";"-";"-";"-";"-";"-";"-";"-";"-";"-";"-";"-";"-";"-";"-";"-";"-";"-";"-"
"31 Maj 2024 23:00:54";"Koszty Utrzymania Pozycji";"1341553867";"-";"-";"Rachunek";"-";"-";"-";"-";"-";"-";"-";"-";"-75,12";"9 547,37";"-";"-";"-";"-";"-";"-75,12";"-";"-";"-";"-";"-";"-";"-";"-";"-";"-";"-";"-";"-";"-";"-";"-";"-";"-"
"31 Maj 2024 23:00:54";"Koszty Utrzymania Pozycji";"O2-CW-916WS8";"-";"-";"Solana (USD)";"-";"-";"-";"-";"-";"-";"-";"-";"-";"-";"-";"-";"3 488,20";"-27,50000%";"-31,23";"-31,23";"-";"-";"-";"-";"-";"-";"-";"-";"-";"-";"-";"-";"-";"-";"-";"-";"-";"-"
"31 Maj 2024 23:00:54";"Koszty Utrzymania Pozycji";"O2-CW-91V6QZ";"-";"-";"Solana (USD)";"-";"-";"-";"-";"-";"-";"-";"-";"-";"-";"-";"-";"7 142,51";"-10,00000%";"23,02";"23,02";"-";"-";"-";"-";"-";"-";"-";"-";"-";"-";"-";"-";"-";"-";"-";"-";"-";"-"
"31 Maj 2024 23:00:54";"Koszty Utrzymania Pozycji";"O2-CW-91TZBJ";"-";"-";"Solana (USD)";"-";"-";"-";"-";"-";"-";"-";"-";"-";"-";"-";"-";"7 142,51";"-27,50000%";"-63,94";"-63,94";"-";"-";"-";"-";"-";"-";"-";"-";"-";"-";"-";"-";"-";"-";"-";"-";"-";"-"
"31 Maj 2024 23:00:54";"Koszty Utrzymania Pozycji";"O2-CW-91VMH6";"-";"-";"Solana (USD)";"-";"-";"-";"-";"-";"-";"-";"-";"-";"-";"-";"-";"332,21";"-27,50000%";"-2,97";"-2,97";"-";"-";"-";"-";"-";"-";"-";"-";"-";"-";"-";"-";"-";"-";"-";"-";"-";"-"
"31 Maj 2024 18:16:27";" Transakcja Kupna";"O2-CW-91VMH6";"T2-CW-5FW0C5";"-";"Solana (USD)";"2 Jednost.";"164,345";"-";"-";"-";"-";"3,960685";"1 301,83";"0,00";"-";"-";"-";"-";"-";"-";"-";"-";"-";"-";"-";"-";"-";"-";"-";"-";"-";"-";"-";"-";"-";"-";"-";"-";"-"
"31 Maj 2024 18:10:15";"Take Profit";"O2-CW-91TJDY";"T2-CW-5FVZSK";"-";"Solana (USD)";"7 Jednost.";"164,000";"-";"-";"-";"-";"3,92268";"4 548,48";"84,16";"9 622,49";"-";"-";"-";"-";"-";"-";"-";"-";"-";"-";"-";"-";"-";"-";"-";"-";"-";"-";"-";"-";"-";"-";"-";"-"
"31 Maj 2024 18:10:15";"Take Profit";"O2-CW-91TJCT";"T2-CW-5FVZSJ";"-";"Solana (USD)";"20 Jednost.";"164,000";"-";"-";"-";"-";"3,92268";"12 995,68";"236,30";"9 538,33";"-";"-";"-";"-";"-";"-";"-";"-";"-";"-";"-";"-";"-";"-";"-";"-";"-";"-";"-";"-";"-";"-";"-";"-"
"31 Maj 2024 18:10:15";"Take Profit";"O2-CW-91ERKN";"T2-CW-5FVZSH";"-";"Solana (USD)";"16 Jednost.";"164,000";"-";"-";"-";"-";"3,962098";"10 396,54";"-58,32";"9 302,03";"-";"-";"-";"-";"-";"-";"-";"-";"-";"-";"-";"-";"-";"-";"-";"-";"-";"-";"-";"-";"-";"-";"-";"-"
"31 Maj 2024 16:24:59";"Transakcja Sprzedaży";"O2-CW-91V6QZ";"T2-CW-5FVLGL";"-";"Solana (USD)";"43 Jednost.";"166,411";"-";"-";"-";"-";"3,948731";"28 255,82";"0,00";"-";"-";"-";"-";"-";"-";"-";"-";"-";"-";"-";"-";"-";"-";"-";"-";"-";"-";"-";"-";"-";"-";"-";"-";"-"
"31 Maj 2024 16:05:33";" Zamknięcie Transakcji";"O2-CW-91V3PR";"T2-CW-5FVHJQ";"O2-CW-91V2H3";"Solana (USD)";"43 Jednost.";"166,955";"-";"-";"-";"-";"3,9051";"28 316,69";"45,34";"9 360,35";"-";"-";"-";"-";"-";"-";"-";"-";"-";"-";"-";"-";"-";"-";"-";"-";"-";"-";"-";"-";"-";"-";"-";"-"
"31 Maj 2024 15:57:26";"Transakcja Sprzedaży";"O2-CW-91V2H3";"T2-CW-5FVGHR";"-";"Solana (USD)";"43 Jednost.";"167,225";"-";"-";"-";"-";"3,943631";"28 357,36";"0,00";"-";"-";"-";"-";"-";"-";"-";"-";"-";"-";"-";"-";"-";"-";"-";"-";"-";"-";"-";"-";"-";"-";"-";"-";"-"
"31 Maj 2024 15:42:58";" Zmodyfikowano Transakcję Kupna";"O2-CW-91TZBJ";"T2-CW-5FVDMG";"-";"Solana (USD)";"43 Jednost.";"168,757";"-";"-";"170,000";"-";"-";"-";"0,00";"-";"-";"-";"-";"-";"-";"-";"-";"-";"-";"-";"-";"-";"-";"-";"-";"-";"-";"-";"-";"-";"-";"-";"-";"-"
"31 Maj 2024 15:38:35";" Transakcja Kupna";"O2-CW-91TZBJ";"T2-CW-5FVDMG";"-";"Solana (USD)";"43 Jednost.";"168,757";"-";"-";"-";"-";"3,941878";"28 604,43";"0,00";"-";"-";"-";"-";"-";"-";"-";"-";"-";"-";"-";"-";"-";"-";"-";"-";"-";"-";"-";"-";"-";"-";"-";"-";"-"
"31 Maj 2024 14:31:31";"Stop Loss";"O2-CW-91TP98";"T2-CW-5FV5BN";"-";"Solana (USD)";"42 Jednost.";"169,800";"-";"-";"-";"-";"3,90659";"28 140,19";"152,59";"9 315,01";"-";"-";"-";"-";"-";"-";"-";"-";"-";"-";"-";"-";"-";"-";"-";"-";"-";"-";"-";"-";"-";"-";"-";"-"
"31 Maj 2024 14:31:11";"Zmodyfikowano Stop Loss";"O2-CW-91TP98";"-";"O2-CW-91TQ12";"Solana (USD)";"42 Jednost.";"168,870";"-";"169,800";"-";"-";"-";"-";"-";"-";"-";"-";"-";"-";"-";"-";"-";"-";"-";"-";"-";"-";"-";"-";"-";"-";"-";"-";"-";"-";"-";"-";"-";"-"
"31 Maj 2024 14:30:40";" Zmodyfikowano Transakcję Kupna";"O2-CW-91TP98";"T2-CW-5FV435";"-";"Solana (USD)";"42 Jednost.";"168,870";"-";"169,700";"-";"-";"-";"-";"0,00";"-";"-";"-";"-";"-";"-";"-";"-";"-";"-";"-";"-";"-";"-";"-";"-";"-";"-";"-";"-";"-";"-";"-";"-";"-"
"31 Maj 2024 14:25:34";" Transakcja Kupna";"O2-CW-91TP98";"T2-CW-5FV435";"-";"Solana (USD)";"42 Jednost.";"168,870";"-";"-";"-";"-";"3,949453";"28 011,65";"0,00";"-";"-";"-";"-";"-";"-";"-";"-";"-";"-";"-";"-";"-";"-";"-";"-";"-";"-";"-";"-";"-";"-";"-";"-";"-"
"31 Maj 2024 14:06:10";"Stop Loss";"O2-CW-91TLV9";"T2-CW-5FV3CS";"-";"Solana (USD)";"4,5 Jednost.";"168,900";"-";"-";"-";"-";"3,90961";"3 001,36";"14,95";"9 024,14";"-";"-";"-";"-";"-";"-";"-";"-";"-";"-";"-";"-";"-";"-";"-";"-";"-";"-";"-";"-";"-";"-";"-";"-"
"31 Maj 2024 14:06:10";"Stop Loss";"O2-CW-91TLRQ";"T2-CW-5FV3CT";"-";"Solana (USD)";"19 Jednost.";"168,900";"-";"-";"-";"-";"3,90961";"12 672,42";"67,75";"9 091,89";"-";"-";"-";"-";"-";"-";"-";"-";"-";"-";"-";"-";"-";"-";"-";"-";"-";"-";"-";"-";"-";"-";"-";"-"
"31 Maj 2024 14:06:10";"Stop Loss";"O2-CW-91TLQQ";"T2-CW-5FV3CV";"-";"Solana (USD)";"20 Jednost.";"168,900";"-";"-";"-";"-";"3,90961";"13 339,39";"70,53";"9 162,42";"-";"-";"-";"-";"-";"-";"-";"-";"-";"-";"-";"-";"-";"-";"-";"-";"-";"-";"-";"-";"-";"-";"-";"-"
"31 Maj 2024 14:04:29";"Zmodyfikowano Stop Loss";"O2-CW-91TLV9";"-";"O2-CW-91TMDS";"Solana (USD)";"4,5 Jednost.";"168,050";"-";"168,900";"-";"-";"-";"-";"-";"-";"-";"-";"-";"-";"-";"-";"-";"-";"-";"-";"-";"-";"-";"-";"-";"-";"-";"-";"-";"-";"-";"-";"-";"-"
"31 Maj 2024 14:04:17";"Zmodyfikowano Stop Loss";"O2-CW-91TLRQ";"-";"O2-CW-91TME5";"Solana (USD)";"19 Jednost.";"167,988";"-";"168,900";"-";"-";"-";"-";"-";"-";"-";"-";"-";"-";"-";"-";"-";"-";"-";"-";"-";"-";"-";"-";"-";"-";"-";"-";"-";"-";"-";"-";"-";"-"
"31 Maj 2024 14:04:05";"Zmodyfikowano Stop Loss";"O2-CW-91TLQQ";"-";"O2-CW-91TMEP";"Solana (USD)";"20 Jednost.";"167,998";"-";"168,900";"-";"-";"-";"-";"-";"-";"-";"-";"-";"-";"-";"-";"-";"-";"-";"-";"-";"-";"-";"-";"-";"-";"-";"-";"-";"-";"-";"-";"-";"-"
"31 Maj 2024 14:02:44";"Zmodyfikowano Stop Loss";"O2-CW-91TLV9";"-";"O2-CW-91TMDS";"Solana (USD)";"4,5 Jednost.";"168,050";"-";"168,500";"-";"-";"-";"-";"-";"-";"-";"-";"-";"-";"-";"-";"-";"-";"-";"-";"-";"-";"-";"-";"-";"-";"-";"-";"-";"-";"-";"-";"-";"-"
"31 Maj 2024 14:02:34";"Zmodyfikowano Stop Loss";"O2-CW-91TLRQ";"-";"O2-CW-91TME5";"Solana (USD)";"19 Jednost.";"167,988";"-";"168,500";"-";"-";"-";"-";"-";"-";"-";"-";"-";"-";"-";"-";"-";"-";"-";"-";"-";"-";"-";"-";"-";"-";"-";"-";"-";"-";"-";"-";"-";"-"
"31 Maj 2024 14:02:20";"Zmodyfikowano Stop Loss";"O2-CW-91TLQQ";"-";"O2-CW-91TMEP";"Solana (USD)";"20 Jednost.";"167,998";"-";"168,500";"-";"-";"-";"-";"-";"-";"-";"-";"-";"-";"-";"-";"-";"-";"-";"-";"-";"-";"-";"-";"-";"-";"-";"-";"-";"-";"-";"-";"-";"-"
"31 Maj 2024 13:56:35";"Zmodyfikowano Stop Loss";"O2-CW-91TLV9";"-";"O2-CW-91TMDS";"Solana (USD)";"4,5 Jednost.";"168,050";"-";"168,400";"-";"-";"-";"-";"-";"-";"-";"-";"-";"-";"-";"-";"-";"-";"-";"-";"-";"-";"-";"-";"-";"-";"-";"-";"-";"-";"-";"-";"-";"-"
"31 Maj 2024 13:56:23";"Zmodyfikowano Stop Loss";"O2-CW-91TLRQ";"-";"O2-CW-91TME5";"Solana (USD)";"19 Jednost.";"167,988";"-";"168,400";"-";"-";"-";"-";"-";"-";"-";"-";"-";"-";"-";"-";"-";"-";"-";"-";"-";"-";"-";"-";"-";"-";"-";"-";"-";"-";"-";"-";"-";"-"
"31 Maj 2024 13:56:11";"Zmodyfikowano Stop Loss";"O2-CW-91TLQQ";"-";"O2-CW-91TMEP";"Solana (USD)";"20 Jednost.";"167,998";"-";"168,400";"-";"-";"-";"-";"-";"-";"-";"-";"-";"-";"-";"-";"-";"-";"-";"-";"-";"-";"-";"-";"-";"-";"-";"-";"-";"-";"-";"-";"-";"-"
"31 Maj 2024 13:40:52";" Zmodyfikowano Transakcję Kupna";"O2-CW-91TLQQ";"T2-CW-5FV1V5";"-";"Solana (USD)";"20 Jednost.";"167,998";"-";"168,100";"170,000";"-";"-";"-";"0,00";"-";"-";"-";"-";"-";"-";"-";"-";"-";"-";"-";"-";"-";"-";"-";"-";"-";"-";"-";"-";"-";"-";"-";"-";"-"
"31 Maj 2024 13:40:34";" Zmodyfikowano Transakcję Kupna";"O2-CW-91TLRQ";"T2-CW-5FV1W5";"-";"Solana (USD)";"19 Jednost.";"167,988";"-";"168,100";"170,000";"-";"-";"-";"0,00";"-";"-";"-";"-";"-";"-";"-";"-";"-";"-";"-";"-";"-";"-";"-";"-";"-";"-";"-";"-";"-";"-";"-";"-";"-"
"31 Maj 2024 13:40:16";" Zmodyfikowano Transakcję Kupna";"O2-CW-91TLV9";"T2-CW-5FV1Y7";"-";"Solana (USD)";"4,5 Jednost.";"168,050";"-";"168,100";"170,000";"-";"-";"-";"0,00";"-";"-";"-";"-";"-";"-";"-";"-";"-";"-";"-";"-";"-";"-";"-";"-";"-";"-";"-";"-";"-";"-";"-";"-";"-"
"31 Maj 2024 13:26:17";" Zmodyfikowano Transakcję Kupna";"O2-CW-91TLQQ";"T2-CW-5FV1V5";"-";"Solana (USD)";"20 Jednost.";"167,998";"-";"-";"170,000";"-";"-";"-";"0,00";"-";"-";"-";"-";"-";"-";"-";"-";"-";"-";"-";"-";"-";"-";"-";"-";"-";"-";"-";"-";"-";"-";"-";"-";"-"
"31 Maj 2024 13:25:55";" Zmodyfikowano Transakcję Kupna";"O2-CW-91TLRQ";"T2-CW-5FV1W5";"-";"Solana (USD)";"19 Jednost.";"167,988";"-";"-";"170,000";"-";"-";"-";"0,00";"-";"-";"-";"-";"-";"-";"-";"-";"-";"-";"-";"-";"-";"-";"-";"-";"-";"-";"-";"-";"-";"-";"-";"-";"-"
"31 Maj 2024 13:25:38";" Zmodyfikowano Transakcję Kupna";"O2-CW-91TLV9";"T2-CW-5FV1Y7";"-";"Solana (USD)";"4,5 Jednost.";"168,050";"-";"-";"170,000";"-";"-";"-";"0,00";"-";"-";"-";"-";"-";"-";"-";"-";"-";"-";"-";"-";"-";"-";"-";"-";"-";"-";"-";"-";"-";"-";"-";"-";"-"
"31 Maj 2024 13:25:13";" Transakcja Kupna";"O2-CW-91TLV9";"T2-CW-5FV1Y7";"-";"Solana (USD)";"4,5 Jednost.";"168,050";"-";"-";"-";"-";"3,945906";"2 983,99";"0,00";"-";"-";"-";"-";"-";"-";"-";"-";"-";"-";"-";"-";"-";"-";"-";"-";"-";"-";"-";"-";"-";"-";"-";"-";"-"
"31 Maj 2024 13:23:25";" Transakcja Kupna";"O2-CW-91TLRQ";"T2-CW-5FV1W5";"-";"Solana (USD)";"19 Jednost.";"167,988";"-";"-";"-";"-";"3,946056";"12 594,91";"0,00";"-";"-";"-";"-";"-";"-";"-";"-";"-";"-";"-";"-";"-";"-";"-";"-";"-";"-";"-";"-";"-";"-";"-";"-";"-"
"31 Maj 2024 13:22:27";" Transakcja Kupna";"O2-CW-91TLQQ";"T2-CW-5FV1V5";"-";"Solana (USD)";"20 Jednost.";"167,998";"-";"-";"-";"-";"3,946026";"13 258,48";"0,00";"-";"-";"-";"-";"-";"-";"-";"-";"-";"-";"-";"-";"-";"-";"-";"-";"-";"-";"-";"-";"-";"-";"-";"-";"-"
"31 Maj 2024 12:35:00";"Zmodyfikowano Transakcję Sprzedaży";"O2-CW-91TJDY";"T2-CW-5FTZP7";"-";"Solana (USD)";"7 Jednost.";"167,065";"-";"-";"164,000";"-";"-";"-";"0,00";"-";"-";"-";"-";"-";"-";"-";"-";"-";"-";"-";"-";"-";"-";"-";"-";"-";"-";"-";"-";"-";"-";"-";"-";"-"
"31 Maj 2024 12:34:42";"Zmodyfikowano Transakcję Sprzedaży";"O2-CW-91TJCT";"T2-CW-5FTZNC";"-";"Solana (USD)";"20 Jednost.";"167,012";"-";"-";"164,000";"-";"-";"-";"0,00";"-";"-";"-";"-";"-";"-";"-";"-";"-";"-";"-";"-";"-";"-";"-";"-";"-";"-";"-";"-";"-";"-";"-";"-";"-"
"31 Maj 2024 12:33:53";"Transakcja Sprzedaży";"O2-CW-91TJDY";"T2-CW-5FTZP7";"-";"Solana (USD)";"7 Jednost.";"167,065";"-";"-";"-";"-";"3,948661";"4 617,78";"0,00";"-";"-";"-";"-";"-";"-";"-";"-";"-";"-";"-";"-";"-";"-";"-";"-";"-";"-";"-";"-";"-";"-";"-";"-";"-"
"31 Maj 2024 12:32:42";"Transakcja Sprzedaży";"O2-CW-91TJCT";"T2-CW-5FTZNC";"-";"Solana (USD)";"20 Jednost.";"167,012";"-";"-";"-";"-";"3,948801";"13 189,94";"0,00";"-";"-";"-";"-";"-";"-";"-";"-";"-";"-";"-";"-";"-";"-";"-";"-";"-";"-";"-";"-";"-";"-";"-";"-";"-"
"31 Maj 2024 12:30:56";" Zamknięcie Transakcji";"O2-CW-91TJ9R";"T2-CW-5FTZLS";"O2-CW-91SWWJ";"Solana (USD)";"3 Jednost.";"167,085";"-";"-";"-";"-";"3,90898";"1 979,09";"5,28";"9 009,19";"-";"-";"-";"-";"-";"-";"-";"-";"-";"-";"-";"-";"-";"-";"-";"-";"-";"-";"-";"-";"-";"-";"-";"-"
"31 Maj 2024 00:18:43";" Transakcja Kupna";"O2-CW-91SWWJ";"T2-CW-5FTF3D";"-";"Solana (USD)";"3 Jednost.";"166,635";"-";"-";"-";"-";"3,971787";"1 985,51";"0,00";"-";"-";"-";"-";"-";"-";"-";"-";"-";"-";"-";"-";"-";"-";"-";"-";"-";"-";"-";"-";"-";"-";"-";"-";"-"
"30 Maj 2024 23:32:55";"Stop Loss";"O2-CW-91S8E2";"T2-CW-5FTEVE";"-";"Solana (USD)";"4,5 Jednost.";"167,300";"-";"-";"-";"-";"3,93286";"2 990,61";"21,84";"8 901,91";"-";"-";"-";"-";"-";"-";"-";"-";"-";"-";"-";"-";"-";"-";"-";"-";"-";"-";"-";"-";"-";"-";"-";"-"
"30 Maj 2024 23:32:55";"Stop Loss";"O2-CW-91S8BR";"T2-CW-5FTEVF";"-";"Solana (USD)";"21 Jednost.";"167,300";"-";"-";"-";"-";"3,93286";"13 956,19";"102,00";"9 003,91";"-";"-";"-";"-";"-";"-";"-";"-";"-";"-";"-";"-";"-";"-";"-";"-";"-";"-";"-";"-";"-";"-";"-";"-"
"30 Maj 2024 23:16:14";"Zmodyfikowano Stop Loss";"O2-CW-91S8E2";"-";"O2-CW-91SVP2";"Solana (USD)";"4,5 Jednost.";"168,534";"-";"167,300";"-";"-";"-";"-";"-";"-";"-";"-";"-";"-";"-";"-";"-";"-";"-";"-";"-";"-";"-";"-";"-";"-";"-";"-";"-";"-";"-";"-";"-";"-"
"30 Maj 2024 23:16:01";"Zmodyfikowano Stop Loss";"O2-CW-91S8BR";"-";"O2-CW-91SVP5";"Solana (USD)";"21 Jednost.";"168,535";"-";"167,300";"-";"-";"-";"-";"-";"-";"-";"-";"-";"-";"-";"-";"-";"-";"-";"-";"-";"-";"-";"-";"-";"-";"-";"-";"-";"-";"-";"-";"-";"-"
"30 Maj 2024 23:00:57";"Koszty Utrzymania Pozycji";"1341070445";"-";"-";"Rachunek";"-";"-";"-";"-";"-";"-";"-";"-";"-3,04";"8 880,07";"-";"-";"-";"-";"-";"-3,04";"-";"-";"-";"-";"-";"-";"-";"-";"-";"-";"-";"-";"-";"-";"-";"-";"-";"-"
"30 Maj 2024 23:00:57";"Koszty Utrzymania Pozycji";"O2-CW-91S8BR";"-";"-";"Solana (USD)";"-";"-";"-";"-";"-";"-";"-";"-";"-";"-";"-";"-";"3 511,62";"-10,00000%";"3,78";"3,78";"-";"-";"-";"-";"-";"-";"-";"-";"-";"-";"-";"-";"-";"-";"-";"-";"-";"-"
"30 Maj 2024 23:00:57";"Koszty Utrzymania Pozycji";"O2-CW-916WS8";"-";"-";"Solana (USD)";"-";"-";"-";"-";"-";"-";"-";"-";"-";"-";"-";"-";"3 511,62";"-27,50000%";"-10,51";"-10,51";"-";"-";"-";"-";"-";"-";"-";"-";"-";"-";"-";"-";"-";"-";"-";"-";"-";"-"
"30 Maj 2024 23:00:57";"Koszty Utrzymania Pozycji";"O2-CW-91S8E2";"-";"-";"Solana (USD)";"-";"-";"-";"-";"-";"-";"-";"-";"-";"-";"-";"-";"752,49";"-10,00000%";"0,81";"0,81";"-";"-";"-";"-";"-";"-";"-";"-";"-";"-";"-";"-";"-";"-";"-";"-";"-";"-"
"30 Maj 2024 23:00:57";"Koszty Utrzymania Pozycji";"O2-CW-91ERKN";"-";"-";"Solana (USD)";"-";"-";"-";"-";"-";"-";"-";"-";"-";"-";"-";"-";"2 675,52";"-10,00000%";"2,88";"2,88";"-";"-";"-";"-";"-";"-";"-";"-";"-";"-";"-";"-";"-";"-";"-";"-";"-";"-"
"30 Maj 2024 23:00:46";"Zmodyfikowano Stop Loss";"O2-CW-91S8E2";"-";"O2-CW-91SVP2";"Solana (USD)";"4,5 Jednost.";"168,534";"-";"167,700";"-";"-";"-";"-";"-";"-";"-";"-";"-";"-";"-";"-";"-";"-";"-";"-";"-";"-";"-";"-";"-";"-";"-";"-";"-";"-";"-";"-";"-";"-"
"30 Maj 2024 23:00:20";"Zmodyfikowano Stop Loss";"O2-CW-91S8BR";"-";"O2-CW-91SVP5";"Solana (USD)";"21 Jednost.";"168,535";"-";"167,700";"-";"-";"-";"-";"-";"-";"-";"-";"-";"-";"-";"-";"-";"-";"-";"-";"-";"-";"-";"-";"-";"-";"-";"-";"-";"-";"-";"-";"-";"-"
"30 Maj 2024 22:21:16";"Zmodyfikowano Transakcję Sprzedaży";"O2-CW-91S8BR";"T2-CW-5FSW8F";"-";"Solana (USD)";"21 Jednost.";"168,535";"-";"168,000";"164,000";"-";"-";"-";"0,00";"-";"-";"-";"-";"-";"-";"-";"-";"-";"-";"-";"-";"-";"-";"-";"-";"-";"-";"-";"-";"-";"-";"-";"-";"-"
"30 Maj 2024 22:20:53";"Zmodyfikowano Transakcję Sprzedaży";"O2-CW-91S8E2";"T2-CW-5FSWBX";"-";"Solana (USD)";"4,5 Jednost.";"168,534";"-";"168,000";"164,000";"-";"-";"-";"0,00";"-";"-";"-";"-";"-";"-";"-";"-";"-";"-";"-";"-";"-";"-";"-";"-";"-";"-";"-";"-";"-";"-";"-";"-";"-"
"30 Maj 2024 16:52:40";"Zmodyfikowano Transakcję Sprzedaży";"O2-CW-91S8BR";"T2-CW-5FSW8F";"-";"Solana (USD)";"21 Jednost.";"168,535";"-";"-";"164,000";"-";"-";"-";"0,00";"-";"-";"-";"-";"-";"-";"-";"-";"-";"-";"-";"-";"-";"-";"-";"-";"-";"-";"-";"-";"-";"-";"-";"-";"-"
"30 Maj 2024 16:52:26";"Zmodyfikowano Transakcję Sprzedaży";"O2-CW-91S8E2";"T2-CW-5FSWBX";"-";"Solana (USD)";"4,5 Jednost.";"168,534";"-";"-";"164,000";"-";"-";"-";"0,00";"-";"-";"-";"-";"-";"-";"-";"-";"-";"-";"-";"-";"-";"-";"-";"-";"-";"-";"-";"-";"-";"-";"-";"-";"-"
"30 Maj 2024 16:52:05";"Zmodyfikowano Take Profit";"O2-CW-91ERKN";"-";"O2-CW-91H0H7";"Solana (USD)";"16 Jednost.";"163,080";"-";"-";"164,000";"-";"-";"-";"-";"-";"-";"-";"-";"-";"-";"-";"-";"-";"-";"-";"-";"-";"-";"-";"-";"-";"-";"-";"-";"-";"-";"-";"-";"-"
"30 Maj 2024 16:49:44";"Transakcja Sprzedaży";"O2-CW-91S8E2";"T2-CW-5FSWBX";"-";"Solana (USD)";"4,5 Jednost.";"168,534";"-";"-";"-";"-";"3,970645";"3 011,34";"0,00";"-";"-";"-";"-";"-";"-";"-";"-";"-";"-";"-";"-";"-";"-";"-";"-";"-";"-";"-";"-";"-";"-";"-";"-";"-"
"30 Maj 2024 16:49:00";"Transakcja Sprzedaży";"O2-CW-91S8BR";"T2-CW-5FSW8F";"-";"Solana (USD)";"21 Jednost.";"168,535";"-";"-";"-";"-";"3,970164";"14 051,34";"0,00";"-";"-";"-";"-";"-";"-";"-";"-";"-";"-";"-";"-";"-";"-";"-";"-";"-";"-";"-";"-";"-";"-";"-";"-";"-"
"30 Maj 2024 15:34:10";"Stop Loss";"O2-CW-91RKDQ";"T2-CW-5FSMJJ";"-";"Solana (USD)";"16 Jednost.";"167,365";"-";"-";"-";"-";"3,93162";"10 634,04";"101,59";"8 883,11";"-";"-";"-";"-";"-";"-";"-";"-";"-";"-";"-";"-";"-";"-";"-";"-";"-";"-";"-";"-";"-";"-";"-";"-"
"30 Maj 2024 15:17:58";" Zmodyfikowano Transakcję Kupna";"O2-CW-91RKDQ";"T2-CW-5FS99C";"-";"Solana (USD)";"16 Jednost.";"165,750";"-";"167,400";"-";"-";"-";"-";"0,00";"-";"-";"-";"-";"-";"-";"-";"-";"-";"-";"-";"-";"-";"-";"-";"-";"-";"-";"-";"-";"-";"-";"-";"-";"-"
"30 Maj 2024 11:17:30";" Transakcja Kupna";"O2-CW-91RKDQ";"T2-CW-5FS99C";"-";"Solana (USD)";"16 Jednost.";"165,750";"-";"-";"-";"-";"3,984092";"10 565,81";"0,00";"-";"-";"-";"-";"-";"-";"-";"-";"-";"-";"-";"-";"-";"-";"-";"-";"-";"-";"-";"-";"-";"-";"-";"-";"-"
"30 Maj 2024 00:02:50";"Stop Loss";"O2-CW-91LXE0";"T2-CW-5FRR2S";"-";"Solana (USD)";"15 Jednost.";"168,886";"-";"-";"-";"-";"3,94152";"10 085,34";"50,02";"8 781,52";"-";"-";"-";"-";"-";"-";"-";"-";"-";"-";"-";"-";"-";"-";"-";"-";"-";"-";"-";"-";"-";"-";"-";"-"
"29 Maj 2024 23:49:14";" Zmodyfikowano Transakcję Kupna";"O2-CW-91LXE0";"T2-CW-5FRQYL";"-";"Solana (USD)";"15 Jednost.";"168,040";"-";"168,900";"-";"-";"-";"-";"0,00";"-";"-";"-";"-";"-";"-";"-";"-";"-";"-";"-";"-";"-";"-";"-";"-";"-";"-";"-";"-";"-";"-";"-";"-";"-"
"29 Maj 2024 23:22:06";" Transakcja Kupna";"O2-CW-91LXE0";"T2-CW-5FRQYL";"-";"Solana (USD)";"15 Jednost.";"168,040";"-";"-";"-";"-";"3,980525";"10 033,31";"0,00";"-";"-";"-";"-";"-";"-";"-";"-";"-";"-";"-";"-";"-";"-";"-";"-";"-";"-";"-";"-";"-";"-";"-";"-";"-"
"29 Maj 2024 23:16:39";"Stop Loss";"O2-CW-91LK3K";"T2-CW-5FRQY9";"-";"Solana (USD)";"2 Jednost.";"168,300";"-";"-";"-";"-";"3,94137";"1 339,99";"19,05";"8 731,50";"-";"-";"-";"-";"-";"-";"-";"-";"-";"-";"-";"-";"-";"-";"-";"-";"-";"-";"-";"-";"-";"-";"-";"-"
"29 Maj 2024 23:16:39";"Stop Loss";"O2-CW-91KCWK";"T2-CW-5FRQY8";"-";"Solana (USD)";"23 Jednost.";"168,300";"-";"-";"-";"-";"3,94137";"15 409,95";"39,43";"8 712,45";"-";"-";"-";"-";"-";"-";"-";"-";"-";"-";"-";"-";"-";"-";"-";"-";"-";"-";"-";"-";"-";"-";"-";"-"
"29 Maj 2024 23:13:56";"Zmodyfikowano Stop Loss";"O2-CW-91KCWK";"-";"O2-CW-91LXCK";"Solana (USD)";"23 Jednost.";"168,735";"-";"168,300";"-";"-";"-";"-";"-";"-";"-";"-";"-";"-";"-";"-";"-";"-";"-";"-";"-";"-";"-";"-";"-";"-";"-";"-";"-";"-";"-";"-";"-";"-"
"29 Maj 2024 23:12:38";"Zmodyfikowano Stop Loss";"O2-CW-91LK3K";"-";"O2-CW-91LXCR";"Solana (USD)";"2 Jednost.";"170,717";"-";"168,300";"-";"-";"-";"-";"-";"-";"-";"-";"-";"-";"-";"-";"-";"-";"-";"-";"-";"-";"-";"-";"-";"-";"-";"-";"-";"-";"-";"-";"-";"-"
"29 Maj 2024 23:12:03";"Zmodyfikowano Transakcję Sprzedaży";"O2-CW-91LK3K";"T2-CW-5FRFMD";"-";"Solana (USD)";"2 Jednost.";"170,717";"-";"168,500";"-";"-";"-";"-";"0,00";"-";"-";"-";"-";"-";"-";"-";"-";"-";"-";"-";"-";"-";"-";"-";"-";"-";"-";"-";"-";"-";"-";"-";"-";"-"
"29 Maj 2024 23:11:17";"Zmodyfikowano Transakcję Sprzedaży";"O2-CW-91KCWK";"T2-CW-5FQFBF";"-";"Solana (USD)";"23 Jednost.";"168,735";"-";"168,500";"-";"-";"-";"-";"0,00";"-";"-";"-";"-";"-";"-";"-";"-";"-";"-";"-";"-";"-";"-";"-";"-";"-";"-";"-";"-";"-";"-";"-";"-";"-"
"29 Maj 2024 23:00:55";"Koszty Utrzymania Pozycji";"1340627524";"-";"-";"Rachunek";"-";"-";"-";"-";"-";"-";"-";"-";"-3,16";"8 673,02";"-";"-";"-";"-";"-";"-3,16";"-";"-";"-";"-";"-";"-";"-";"-";"-";"-";"-";"-";"-";"-";"-";"-";"-";"-"
"29 Maj 2024 23:00:55";"Koszty Utrzymania Pozycji";"O2-CW-91KCWK";"-";"-";"Solana (USD)";"-";"-";"-";"-";"-";"-";"-";"-";"-";"-";"-";"-";"3 884,58";"-10,00000%";"4,20";"4,20";"-";"-";"-";"-";"-";"-";"-";"-";"-";"-";"-";"-";"-";"-";"-";"-";"-";"-"
"29 Maj 2024 23:00:55";"Koszty Utrzymania Pozycji";"O2-CW-916WS8";"-";"-";"Solana (USD)";"-";"-";"-";"-";"-";"-";"-";"-";"-";"-";"-";"-";"3 546,79";"-27,50000%";"-10,64";"-10,64";"-";"-";"-";"-";"-";"-";"-";"-";"-";"-";"-";"-";"-";"-";"-";"-";"-";"-"
"29 Maj 2024 23:00:55";"Koszty Utrzymania Pozycji";"O2-CW-91LK3K";"-";"-";"Solana (USD)";"-";"-";"-";"-";"-";"-";"-";"-";"-";"-";"-";"-";"337,79";"-10,00000%";"0,36";"0,36";"-";"-";"-";"-";"-";"-";"-";"-";"-";"-";"-";"-";"-";"-";"-";"-";"-";"-"
"29 Maj 2024 23:00:55";"Koszty Utrzymania Pozycji";"O2-CW-91ERKN";"-";"-";"Solana (USD)";"-";"-";"-";"-";"-";"-";"-";"-";"-";"-";"-";"-";"2 702,32";"-10,00000%";"2,92";"2,92";"-";"-";"-";"-";"-";"-";"-";"-";"-";"-";"-";"-";"-";"-";"-";"-";"-";"-"
"29 Maj 2024 20:04:45";"Zmodyfikowano Transakcję Sprzedaży";"O2-CW-91KCWK";"T2-CW-5FQFBF";"-";"Solana (USD)";"23 Jednost.";"168,735";"-";"-";"168,000";"-";"-";"-";"0,00";"-";"-";"-";"-";"-";"-";"-";"-";"-";"-";"-";"-";"-";"-";"-";"-";"-";"-";"-";"-";"-";"-";"-";"-";"-"
"29 Maj 2024 20:04:23";"Zmodyfikowano Transakcję Sprzedaży";"O2-CW-91LK3K";"T2-CW-5FRFMD";"-";"Solana (USD)";"2 Jednost.";"170,717";"-";"-";"168,000";"-";"-";"-";"0,00";"-";"-";"-";"-";"-";"-";"-";"-";"-";"-";"-";"-";"-";"-";"-";"-";"-";"-";"-";"-";"-";"-";"-";"-";"-"
"29 Maj 2024 18:49:25";"Transakcja Sprzedaży";"O2-CW-91LK3K";"T2-CW-5FRFMD";"-";"Solana (USD)";"2 Jednost.";"170,717";"-";"-";"-";"-";"3,974843";"1 357,14";"0,00";"-";"-";"-";"-";"-";"-";"-";"-";"-";"-";"-";"-";"-";"-";"-";"-";"-";"-";"-";"-";"-";"-";"-";"-";"-"
"29 Maj 2024 10:37:33";"Transakcja Sprzedaży";"O2-CW-91KCWK";"T2-CW-5FQFBF";"-";"Solana (USD)";"23 Jednost.";"168,735";"-";"-";"-";"-";"3,945926";"15 313,76";"0,00";"-";"-";"-";"-";"-";"-";"-";"-";"-";"-";"-";"-";"-";"-";"-";"-";"-";"-";"-";"-";"-";"-";"-";"-";"-"
"29 Maj 2024 09:56:53";"Stop Loss";"O2-CW-91JZ04";"T2-CW-5FQCPB";"-";"Solana (USD)";"15 Jednost.";"170,900";"-";"-";"-";"-";"3,89996";"10 098,04";"19,89";"8 676,18";"-";"-";"-";"-";"-";"-";"-";"-";"-";"-";"-";"-";"-";"-";"-";"-";"-";"-";"-";"-";"-";"-";"-";"-"
"29 Maj 2024 09:53:00";" Zmodyfikowano Transakcję Kupna";"O2-CW-91JZ04";"T2-CW-5FQ35S";"-";"Solana (USD)";"15 Jednost.";"170,560";"-";"170,900";"-";"-";"-";"-";"0,00";"-";"-";"-";"-";"-";"-";"-";"-";"-";"-";"-";"-";"-";"-";"-";"-";"-";"-";"-";"-";"-";"-";"-";"-";"-"
"29 Maj 2024 05:28:02";" Transakcja Kupna";"O2-CW-91JZ04";"T2-CW-5FQ35S";"-";"Solana (USD)";"15 Jednost.";"170,560";"-";"-";"-";"-";"3,940816";"10 082,18";"0,00";"-";"-";"-";"-";"-";"-";"-";"-";"-";"-";"-";"-";"-";"-";"-";"-";"-";"-";"-";"-";"-";"-";"-";"-";"-"
"29 Maj 2024 05:26:47";"Odrzucono Zlecenie: brak wystarczających środków";"O2-CW-91JYZ3";"-";"-";"Solana (USD)";"16 Jednost.";"-";"-";"-";"-";"-";"-";"-";"-";"-";"-";"-";"-";"-";"-";"-";"-";"-";"-";"-";"-";"-";"-";"-";"-";"-";"-";"-";"-";"-";"-";"-";"-";"-"
"29 Maj 2024 00:04:07";"Stop Loss";"O2-CW-91JRZ3";"T2-CW-5FPYG2";"-";"Solana (USD)";"24 Jednost.";"169,160";"-";"-";"-";"-";"3,89859";"15 986,67";"10,76";"8 656,29";"-";"-";"-";"-";"-";"-";"-";"-";"-";"-";"-";"-";"-";"-";"-";"-";"-";"-";"-";"-";"-";"-";"-";"-"
"28 Maj 2024 23:54:51";"Zmodyfikowano Take Profit";"O2-CW-91JRZ3";"-";"O2-CW-91JRZB";"Solana (USD)";"24 Jednost.";"169,275";"-";"-";"163,500";"-";"-";"-";"-";"-";"-";"-";"-";"-";"-";"-";"-";"-";"-";"-";"-";"-";"-";"-";"-";"-";"-";"-";"-";"-";"-";"-";"-";"-"
"28 Maj 2024 23:54:07";"Zmodyfikowano Take Profit";"O2-CW-91JRZ3";"-";"O2-CW-91JRZB";"Solana (USD)";"24 Jednost.";"169,275";"-";"-";"164,000";"-";"-";"-";"-";"-";"-";"-";"-";"-";"-";"-";"-";"-";"-";"-";"-";"-";"-";"-";"-";"-";"-";"-";"-";"-";"-";"-";"-";"-"
"28 Maj 2024 23:53:25";"Zmodyfikowano Transakcję Sprzedaży";"O2-CW-91JRZ3";"T2-CW-5FPY80";"-";"Solana (USD)";"24 Jednost.";"169,275";"-";"169,150";"167,000";"-";"-";"-";"0,00";"-";"-";"-";"-";"-";"-";"-";"-";"-";"-";"-";"-";"-";"-";"-";"-";"-";"-";"-";"-";"-";"-";"-";"-";"-"
"28 Maj 2024 23:08:48";"Zmodyfikowano Transakcję Sprzedaży";"O2-CW-91JRZ3";"T2-CW-5FPY80";"-";"Solana (USD)";"24 Jednost.";"169,275";"-";"-";"167,000";"-";"-";"-";"0,00";"-";"-";"-";"-";"-";"-";"-";"-";"-";"-";"-";"-";"-";"-";"-";"-";"-";"-";"-";"-";"-";"-";"-";"-";"-"
"28 Maj 2024 23:06:47";"Transakcja Sprzedaży";"O2-CW-91JRZ3";"T2-CW-5FPY80";"-";"Solana (USD)";"24 Jednost.";"169,275";"-";"-";"-";"-";"3,939052";"16 002,79";"0,00";"-";"-";"-";"-";"-";"-";"-";"-";"-";"-";"-";"-";"-";"-";"-";"-";"-";"-";"-";"-";"-";"-";"-";"-";"-"
"28 Maj 2024 23:00:58";"Koszty Utrzymania Pozycji";"1340203037";"-";"-";"Rachunek";"-";"-";"-";"-";"-";"-";"-";"-";"-7,66";"8 645,53";"-";"-";"-";"-";"-";"-7,66";"-";"-";"-";"-";"-";"-";"-";"-";"-";"-";"-";"-";"-";"-";"-";"-";"-";"-"
"28 Maj 2024 23:00:58";"Koszty Utrzymania Pozycji";"O2-CW-916WS8";"-";"-";"Solana (USD)";"-";"-";"-";"-";"-";"-";"-";"-";"-";"-";"-";"-";"3 559,01";"-27,50000%";"-10,56";"-10,56";"-";"-";"-";"-";"-";"-";"-";"-";"-";"-";"-";"-";"-";"-";"-";"-";"-";"-"
"28 Maj 2024 23:00:58";"Koszty Utrzymania Pozycji";"O2-CW-91ERKN";"-";"-";"Solana (USD)";"-";"-";"-";"-";"-";"-";"-";"-";"-";"-";"-";"-";"2 711,63";"-10,00000%";"2,90";"2,90";"-";"-";"-";"-";"-";"-";"-";"-";"-";"-";"-";"-";"-";"-";"-";"-";"-";"-"
"28 Maj 2024 16:11:52";"Stop Loss";"O2-CW-91HSMF";"T2-CW-5FP9VB";"-";"Solana (USD)";"21 Jednost.";"170,300";"-";"-";"-";"-";"3,89167";"14 057,63";"70,69";"8 653,19";"-";"-";"-";"-";"-";"-";"-";"-";"-";"-";"-";"-";"-";"-";"-";"-";"-";"-";"-";"-";"-";"-";"-";"-"
"28 Maj 2024 16:10:42";"Zmodyfikowano Transakcję Sprzedaży";"O2-CW-91HSMF";"T2-CW-5FP1JC";"-";"Solana (USD)";"21 Jednost.";"171,165";"-";"170,300";"-";"-";"-";"-";"0,00";"-";"-";"-";"-";"-";"-";"-";"-";"-";"-";"-";"-";"-";"-";"-";"-";"-";"-";"-";"-";"-";"-";"-";"-";"-"
"28 Maj 2024 15:02:43";"Transakcja Sprzedaży";"O2-CW-91HSMF";"T2-CW-5FP1JC";"-";"Solana (USD)";"21 Jednost.";"171,165";"-";"-";"-";"-";"3,926757";"14 114,59";"0,00";"-";"-";"-";"-";"-";"-";"-";"-";"-";"-";"-";"-";"-";"-";"-";"-";"-";"-";"-";"-";"-";"-";"-";"-";"-"
"28 Maj 2024 12:54:47";" Zamknięcie Transakcji";"O2-CW-91HLS3";"T2-CW-5FNW03";"O2-CW-91GZSE";"Solana (USD)";"15 Jednost.";"169,620";"-";"-";"-";"-";"3,88953";"9 995,59";"7,00";"8 582,50";"-";"-";"-";"-";"-";"-";"-";"-";"-";"-";"-";"-";"-";"-";"-";"-";"-";"-";"-";"-";"-";"-";"-";"-"
"28 Maj 2024 12:54:34";" Zamknięcie Transakcji";"O2-CW-91HLRW";"T2-CW-5FNVZZ";"O2-CW-91GZZ1";"Solana (USD)";"10 Jednost.";"169,570";"-";"-";"-";"-";"3,88915";"6 661,11";"27,77";"8 575,50";"-";"-";"-";"-";"-";"-";"-";"-";"-";"-";"-";"-";"-";"-";"-";"-";"-";"-";"-";"-";"-";"-";"-";"-"
"28 Maj 2024 00:15:45";"Zmodyfikowano Take Profit";"O2-CW-91ERKN";"-";"O2-CW-91H0H7";"Solana (USD)";"16 Jednost.";"163,080";"-";"-";"163,500";"-";"-";"-";"-";"-";"-";"-";"-";"-";"-";"-";"-";"-";"-";"-";"-";"-";"-";"-";"-";"-";"-";"-";"-";"-";"-";"-";"-";"-"
"28 Maj 2024 00:15:02";"Zmodyfikowano Take Profit";"O2-CW-91GZSE";"-";"O2-CW-91H0GQ";"Solana (USD)";"15 Jednost.";"169,740";"-";"-";"163,500";"-";"-";"-";"-";"-";"-";"-";"-";"-";"-";"-";"-";"-";"-";"-";"-";"-";"-";"-";"-";"-";"-";"-";"-";"-";"-";"-";"-";"-"
"28 Maj 2024 00:14:49";"Zmodyfikowano Take Profit";"O2-CW-91GZZ1";"-";"O2-CW-91H0GC";"Solana (USD)";"10 Jednost.";"170,284";"-";"-";"163,500";"-";"-";"-";"-";"-";"-";"-";"-";"-";"-";"-";"-";"-";"-";"-";"-";"-";"-";"-";"-";"-";"-";"-";"-";"-";"-";"-";"-";"-"
"28 Maj 2024 00:13:53";"Zmodyfikowano Transakcję Sprzedaży";"O2-CW-91ERKN";"T2-CW-5FLF38";"-";"Solana (USD)";"16 Jednost.";"163,080";"-";"-";"162,900";"-";"-";"-";"0,00";"-";"-";"-";"-";"-";"-";"-";"-";"-";"-";"-";"-";"-";"-";"-";"-";"-";"-";"-";"-";"-";"-";"-";"-";"-"
"28 Maj 2024 00:13:06";"Zmodyfikowano Transakcję Sprzedaży";"O2-CW-91GZSE";"T2-CW-5FNBDE";"-";"Solana (USD)";"15 Jednost.";"169,740";"-";"-";"166,500";"-";"-";"-";"0,00";"-";"-";"-";"-";"-";"-";"-";"-";"-";"-";"-";"-";"-";"-";"-";"-";"-";"-";"-";"-";"-";"-";"-";"-";"-"
"28 Maj 2024 00:12:44";"Zmodyfikowano Transakcję Sprzedaży";"O2-CW-91GZZ1";"T2-CW-5FNBHM";"-";"Solana (USD)";"10 Jednost.";"170,284";"-";"-";"166,500";"-";"-";"-";"0,00";"-";"-";"-";"-";"-";"-";"-";"-";"-";"-";"-";"-";"-";"-";"-";"-";"-";"-";"-";"-";"-";"-";"-";"-";"-"
"27 Maj 2024 23:22:17";"Transakcja Sprzedaży";"O2-CW-91GZZ1";"T2-CW-5FNBHM";"-";"Solana (USD)";"10 Jednost.";"170,284";"-";"-";"-";"-";"3,940575";"6 710,16";"0,00";"-";"-";"-";"-";"-";"-";"-";"-";"-";"-";"-";"-";"-";"-";"-";"-";"-";"-";"-";"-";"-";"-";"-";"-";"-"
"27 Maj 2024 23:22:02";"Odrzucono Zlecenie: brak wystarczających środków";"O2-CW-91GZYZ";"-";"-";"Solana (USD)";"11 Jednost.";"-";"-";"-";"-";"-";"-";"-";"-";"-";"-";"-";"-";"-";"-";"-";"-";"-";"-";"-";"-";"-";"-";"-";"-";"-";"-";"-";"-";"-";"-";"-";"-";"-"
"27 Maj 2024 23:21:48";"Odrzucono Zlecenie: brak wystarczających środków";"O2-CW-91GZYX";"-";"-";"Solana (USD)";"11,5 Jednost.";"-";"-";"-";"-";"-";"-";"-";"-";"-";"-";"-";"-";"-";"-";"-";"-";"-";"-";"-";"-";"-";"-";"-";"-";"-";"-";"-";"-";"-";"-";"-";"-";"-"
"27 Maj 2024 23:00:55";"Koszty Utrzymania Pozycji";"1339787047";"-";"-";"Rachunek";"-";"-";"-";"-";"-";"-";"-";"-";"-4,98";"8 547,73";"-";"-";"-";"-";"-";"-4,98";"-";"-";"-";"-";"-";"-";"-";"-";"-";"-";"-";"-";"-";"-";"-";"-";"-";"-"
"27 Maj 2024 23:00:55";"Koszty Utrzymania Pozycji";"O2-CW-916WS8";"-";"-";"Solana (USD)";"-";"-";"-";"-";"-";"-";"-";"-";"-";"-";"-";"-";"3 580,50";"-27,50000%";"-10,63";"-10,63";"-";"-";"-";"-";"-";"-";"-";"-";"-";"-";"-";"-";"-";"-";"-";"-";"-";"-"
"27 Maj 2024 23:00:55";"Koszty Utrzymania Pozycji";"O2-CW-91GZSE";"-";"-";"Solana (USD)";"-";"-";"-";"-";"-";"-";"-";"-";"-";"-";"-";"-";"2 557,50";"-10,00000%";"2,73";"2,73";"-";"-";"-";"-";"-";"-";"-";"-";"-";"-";"-";"-";"-";"-";"-";"-";"-";"-"
"27 Maj 2024 23:00:55";"Koszty Utrzymania Pozycji";"O2-CW-91ERKN";"-";"-";"Solana (USD)";"-";"-";"-";"-";"-";"-";"-";"-";"-";"-";"-";"-";"2 728,00";"-10,00000%";"2,92";"2,92";"-";"-";"-";"-";"-";"-";"-";"-";"-";"-";"-";"-";"-";"-";"-";"-";"-";"-"
"27 Maj 2024 22:50:38";"Transakcja Sprzedaży";"O2-CW-91GZSE";"T2-CW-5FNBDE";"-";"Solana (USD)";"15 Jednost.";"169,740";"-";"-";"-";"-";"3,940655";"10 033,30";"0,00";"-";"-";"-";"-";"-";"-";"-";"-";"-";"-";"-";"-";"-";"-";"-";"-";"-";"-";"-";"-";"-";"-";"-";"-";"-"
"27 Maj 2024 18:43:10";" Zamknięcie Transakcji";"O2-CW-91GX5Y";"T2-CW-5FN8E9";"O2-CW-91FVHT";"Solana (USD)";"20 Jednost.";"170,700";"-";"-";"-";"-";"3,90442";"13 463,62";"101,98";"8 552,71";"-";"-";"-";"-";"-";"-";"-";"-";"-";"-";"-";"-";"-";"-";"-";"-";"-";"-";"-";"-";"-";"-";"-";"-"
"27 Maj 2024 18:42:48";" Zamknięcie Transakcji";"O2-CW-91GX5Q";"T2-CW-5FN8DZ";"O2-CW-91FVL0";"Solana (USD)";"2,7 Jednost.";"170,835";"-";"-";"-";"-";"3,90446";"1 819,04";"19,94";"8 450,73";"-";"-";"-";"-";"-";"-";"-";"-";"-";"-";"-";"-";"-";"-";"-";"-";"-";"-";"-";"-";"-";"-";"-";"-"
"27 Maj 2024 00:13:38";" Zamknięcie Transakcji";"O2-CW-91G127";"T2-CW-5FMHYS";"O2-CW-91ERKN";"Solana (USD)";"4 Jednost.";"163,354";"-";"-";"-";"-";"3,941076";"2 575,16";"-4,32";"8 430,79";"-";"-";"-";"-";"-";"-";"-";"-";"-";"-";"-";"-";"-";"-";"-";"-";"-";"-";"-";"-";"-";"-";"-";"-"
"27 Maj 2024 00:11:11";" Zamknięcie Transakcji";"O2-CW-91G11D";"T2-CW-5FMHY7";"O2-CW-91ERKN";"Solana (USD)";"18 Jednost.";"163,260";"-";"-";"-";"-";"3,940655";"11 580,32";"-12,77";"8 435,11";"-";"-";"-";"-";"-";"-";"-";"-";"-";"-";"-";"-";"-";"-";"-";"-";"-";"-";"-";"-";"-";"-";"-";"-"
"24 Maj 2024 23:00:51";"Koszty Utrzymania Pozycji";"1339508088";"-";"-";"Rachunek";"-";"-";"-";"-";"-";"-";"-";"-";"-44,99";"8 447,88";"-";"-";"-";"-";"-";"-44,99";"-";"-";"-";"-";"-";"-";"-";"-";"-";"-";"-";"-";"-";"-";"-";"-";"-";"-"
"24 Maj 2024 23:00:51";"Koszty Utrzymania Pozycji";"O2-CW-916WS8";"-";"-";"Solana (USD)";"-";"-";"-";"-";"-";"-";"-";"-";"-";"-";"-";"-";"3 533,12";"-27,50000%";"-31,47";"-31,47";"-";"-";"-";"-";"-";"-";"-";"-";"-";"-";"-";"-";"-";"-";"-";"-";"-";"-"
"24 Maj 2024 23:00:51";"Koszty Utrzymania Pozycji";"O2-CW-91ERKN";"-";"-";"Solana (USD)";"-";"-";"-";"-";"-";"-";"-";"-";"-";"-";"-";"-";"6 393,27";"-10,00000%";"20,50";"20,50";"-";"-";"-";"-";"-";"-";"-";"-";"-";"-";"-";"-";"-";"-";"-";"-";"-";"-"
"24 Maj 2024 23:00:51";"Koszty Utrzymania Pozycji";"O2-CW-91FVHT";"-";"-";"Solana (USD)";"-";"-";"-";"-";"-";"-";"-";"-";"-";"-";"-";"-";"3 364,88";"-27,50000%";"-29,97";"-29,97";"-";"-";"-";"-";"-";"-";"-";"-";"-";"-";"-";"-";"-";"-";"-";"-";"-";"-"
"24 Maj 2024 23:00:51";"Koszty Utrzymania Pozycji";"O2-CW-91FVL0";"-";"-";"Solana (USD)";"-";"-";"-";"-";"-";"-";"-";"-";"-";"-";"-";"-";"454,25";"-27,50000%";"-4,05";"-4,05";"-";"-";"-";"-";"-";"-";"-";"-";"-";"-";"-";"-";"-";"-";"-";"-";"-";"-"
"24 Maj 2024 20:31:25";" Transakcja Kupna";"O2-CW-91FVL0";"T2-CW-5FMDKH";"-";"Solana (USD)";"2,7 Jednost.";"168,944";"-";"-";"-";"-";"3,940094";"1 797,26";"0,00";"-";"-";"-";"-";"-";"-";"-";"-";"-";"-";"-";"-";"-";"-";"-";"-";"-";"-";"-";"-";"-";"-";"-";"-";"-"
"24 Maj 2024 20:29:45";" Transakcja Kupna";"O2-CW-91FVHT";"T2-CW-5FMDHH";"-";"Solana (USD)";"20 Jednost.";"169,394";"-";"-";"-";"-";"3,940144";"13 348,73";"0,00";"-";"-";"-";"-";"-";"-";"-";"-";"-";"-";"-";"-";"-";"-";"-";"-";"-";"-";"-";"-";"-";"-";"-";"-";"-"
"24 Maj 2024 10:23:56";"Transakcja Sprzedaży";"O2-CW-91ERKN";"T2-CW-5FLF38";"-";"Solana (USD)";"38 Jednost.";"163,080";"-";"-";"-";"-";"3,959523";"24 537,32";"0,00";"-";"-";"-";"-";"-";"-";"-";"-";"-";"-";"-";"-";"-";"-";"-";"-";"-";"-";"-";"-";"-";"-";"-";"-";"-"
"24 Maj 2024 07:04:36";"Take Profit";"O2-CW-91E76X";"T2-CW-5FL856";"-";"Solana (USD)";"38 Jednost.";"168,600";"-";"-";"-";"-";"3,92543";"25 402,28";"452,27";"8 492,87";"-";"-";"-";"-";"-";"-";"-";"-";"-";"-";"-";"-";"-";"-";"-";"-";"-";"-";"-";"-";"-";"-";"-";"-"
"24 Maj 2024 00:31:50";"Zmodyfikowano Transakcję Sprzedaży";"O2-CW-91E76X";"T2-CW-5FL2PR";"-";"Solana (USD)";"38 Jednost.";"171,632";"-";"-";"168,600";"-";"-";"-";"0,00";"-";"-";"-";"-";"-";"-";"-";"-";"-";"-";"-";"-";"-";"-";"-";"-";"-";"-";"-";"-";"-";"-";"-";"-";"-"
"23 Maj 2024 23:16:49";"Transakcja Sprzedaży";"O2-CW-91E76X";"T2-CW-5FL2PR";"-";"Solana (USD)";"38 Jednost.";"171,632";"-";"-";"-";"-";"3,963441";"25 849,62";"0,00";"-";"-";"-";"-";"-";"-";"-";"-";"-";"-";"-";"-";"-";"-";"-";"-";"-";"-";"-";"-";"-";"-";"-";"-";"-"
"23 Maj 2024 23:01:01";"Koszty Utrzymania Pozycji";"1339133389";"-";"-";"Rachunek";"-";"-";"-";"-";"-";"-";"-";"-";"-10,79";"8 040,60";"-";"-";"-";"-";"-";"-10,79";"-";"-";"-";"-";"-";"-";"-";"-";"-";"-";"-";"-";"-";"-";"-";"-";"-";"-"
"23 Maj 2024 23:01:01";"Koszty Utrzymania Pozycji";"O2-CW-916WS8";"-";"-";"Solana (USD)";"-";"-";"-";"-";"-";"-";"-";"-";"-";"-";"-";"-";"3 613,89";"-27,50000%";"-10,79";"-10,79";"-";"-";"-";"-";"-";"-";"-";"-";"-";"-";"-";"-";"-";"-";"-";"-";"-";"-"
"23 Maj 2024 22:00:19";"Take Profit";"O2-CW-91D9MF";"T2-CW-5FL19F";"-";"Solana (USD)";"38 Jednost.";"169,900";"-";"-";"-";"-";"3,92561";"25 599,24";"118,59";"8 051,39";"-";"-";"-";"-";"-";"-";"-";"-";"-";"-";"-";"-";"-";"-";"-";"-";"-";"-";"-";"-";"-";"-";"-";"-"
"23 Maj 2024 18:38:16";"Zmodyfikowano Transakcję Sprzedaży";"O2-CW-91D9MF";"T2-CW-5FK7NQ";"-";"Solana (USD)";"38 Jednost.";"170,695";"-";"-";"169,900";"-";"-";"-";"0,00";"-";"-";"-";"-";"-";"-";"-";"-";"-";"-";"-";"-";"-";"-";"-";"-";"-";"-";"-";"-";"-";"-";"-";"-";"-"
"23 Maj 2024 16:48:06";"Transakcja Sprzedaży";"O2-CW-91D9MF";"T2-CW-5FK7NQ";"-";"Solana (USD)";"38 Jednost.";"170,695";"-";"-";"-";"-";"3,956868";"25 665,86";"0,00";"-";"-";"-";"-";"-";"-";"-";"-";"-";"-";"-";"-";"-";"-";"-";"-";"-";"-";"-";"-";"-";"-";"-";"-";"-"
"23 Maj 2024 16:44:53";"Stop Loss";"O2-CW-91D88K";"T2-CW-5FK7DH";"-";"Solana (USD)";"36 Jednost.";"171,200";"-";"-";"-";"-";"3,91669";"24 381,96";"46,81";"7 932,80";"-";"-";"-";"-";"-";"-";"-";"-";"-";"-";"-";"-";"-";"-";"-";"-";"-";"-";"-";"-";"-";"-";"-";"-"
"23 Maj 2024 16:43:52";"Zmodyfikowano Transakcję Sprzedaży";"O2-CW-91D88K";"T2-CW-5FK6HX";"-";"Solana (USD)";"36 Jednost.";"171,532";"-";"171,200";"-";"-";"-";"-";"0,00";"-";"-";"-";"-";"-";"-";"-";"-";"-";"-";"-";"-";"-";"-";"-";"-";"-";"-";"-";"-";"-";"-";"-";"-";"-"
"23 Maj 2024 16:37:13";"Transakcja Sprzedaży";"O2-CW-91D88K";"T2-CW-5FK6HX";"-";"Solana (USD)";"36 Jednost.";"171,532";"-";"-";"-";"-";"3,953661";"24 414,45";"0,00";"-";"-";"-";"-";"-";"-";"-";"-";"-";"-";"-";"-";"-";"-";"-";"-";"-";"-";"-";"-";"-";"-";"-";"-";"-"
"23 Maj 2024 00:52:58";" Zamknięcie Transakcji";"O2-CW-91BRFJ";"T2-CW-5FHY5R";"O2-CW-91BQG3";"Solana (USD)";"40 Jednost.";"177,847";"-";"-";"-";"-";"3,92366";"28 192,94";"10,67";"7 885,99";"-";"-";"-";"-";"-";"-";"-";"-";"-";"-";"-";"-";"-";"-";"-";"-";"-";"-";"-";"-";"-";"-";"-";"-"
"22 Maj 2024 23:31:22";"Transakcja Sprzedaży";"O2-CW-91BQG3";"T2-CW-5FHXEQ";"-";"Solana (USD)";"40 Jednost.";"177,915";"-";"-";"-";"-";"3,964443";"28 213,35";"0,00";"-";"-";"-";"-";"-";"-";"-";"-";"-";"-";"-";"-";"-";"-";"-";"-";"-";"-";"-";"-";"-";"-";"-";"-";"-"
"22 Maj 2024 23:00:52";"Koszty Utrzymania Pozycji";"1338628529";"-";"-";"Rachunek";"-";"-";"-";"-";"-";"-";"-";"-";"-11,13";"7 875,32";"-";"-";"-";"-";"-";"-11,13";"-";"-";"-";"-";"-";"-";"-";"-";"-";"-";"-";"-";"-";"-";"-";"-";"-";"-"
"22 Maj 2024 23:00:52";"Koszty Utrzymania Pozycji";"O2-CW-916WS8";"-";"-";"Solana (USD)";"-";"-";"-";"-";"-";"-";"-";"-";"-";"-";"-";"-";"3 726,55";"-27,50000%";"-11,13";"-11,13";"-";"-";"-";"-";"-";"-";"-";"-";"-";"-";"-";"-";"-";"-";"-";"-";"-";"-"
"22 Maj 2024 20:04:30";"Stop Loss";"O2-CW-91B73Z";"T2-CW-5FHHNK";"-";"Solana (USD)";"40 Jednost.";"179,530";"-";"-";"-";"-";"3,91352";"28 386,20";"1,57";"7 886,45";"-";"-";"-";"-";"-";"-";"-";"-";"-";"-";"-";"-";"-";"-";"-";"-";"-";"-";"-";"-";"-";"-";"-";"-"
"22 Maj 2024 20:03:43";"Zmodyfikowano Transakcję Sprzedaży";"O2-CW-91B73Z";"T2-CW-5FHFQL";"-";"Solana (USD)";"40 Jednost.";"179,540";"-";"179,500";"178,000";"-";"-";"-";"0,00";"-";"-";"-";"-";"-";"-";"-";"-";"-";"-";"-";"-";"-";"-";"-";"-";"-";"-";"-";"-";"-";"-";"-";"-";"-"
"22 Maj 2024 20:03:43";"Zmodyfikowano Take Profit";"O2-CW-91B73Z";"-";"O2-CW-91B794";"Solana (USD)";"40 Jednost.";"179,540";"-";"-";"178,000";"-";"-";"-";"-";"-";"-";"-";"-";"-";"-";"-";"-";"-";"-";"-";"-";"-";"-";"-";"-";"-";"-";"-";"-";"-";"-";"-";"-";"-"
"22 Maj 2024 19:46:49";" Zmodyfikowano Transakcję Kupna";"O2-CW-916WS8";"T2-CW-5FEL0S";"-";"Solana (USD)";"21 Jednost.";"185,120";"-";"-";"-";"-";"-";"-";"0,00";"-";"-";"-";"-";"-";"-";"-";"-";"-";"-";"-";"-";"-";"-";"-";"-";"-";"-";"-";"-";"-";"-";"-";"-";"-"
"22 Maj 2024 19:46:17";"Zmodyfikowano Transakcję Sprzedaży";"O2-CW-91B73Z";"T2-CW-5FHFQL";"-";"Solana (USD)";"40 Jednost.";"179,540";"-";"-";"177,800";"-";"-";"-";"0,00";"-";"-";"-";"-";"-";"-";"-";"-";"-";"-";"-";"-";"-";"-";"-";"-";"-";"-";"-";"-";"-";"-";"-";"-";"-"
"22 Maj 2024 19:45:08";"Transakcja Sprzedaży";"O2-CW-91B73Z";"T2-CW-5FHFQL";"-";"Solana (USD)";"40 Jednost.";"179,540";"-";"-";"-";"-";"3,949433";"28 363,24";"0,00";"-";"-";"-";"-";"-";"-";"-";"-";"-";"-";"-";"-";"-";"-";"-";"-";"-";"-";"-";"-";"-";"-";"-";"-";"-"
"22 Maj 2024 19:30:18";"Odrzucono Zlecenie: brak wystarczających środków";"O2-CW-91B5YJ";"-";"-";"Solana (USD)";"44 Jednost.";"-";"-";"-";"-";"-";"-";"-";"-";"-";"-";"-";"-";"-";"-";"-";"-";"-";"-";"-";"-";"-";"-";"-";"-";"-";"-";"-";"-";"-";"-";"-";"-";"-"
"21 Maj 2024 23:00:51";"Koszty Utrzymania Pozycji";"1338185643";"-";"-";"Rachunek";"-";"-";"-";"-";"-";"-";"-";"-";"-11,09";"7 884,88";"-";"-";"-";"-";"-";"-11,09";"-";"-";"-";"-";"-";"-";"-";"-";"-";"-";"-";"-";"-";"-";"-";"-";"-";"-"
"21 Maj 2024 23:00:51";"Koszty Utrzymania Pozycji";"O2-CW-916WS8";"-";"-";"Solana (USD)";"-";"-";"-";"-";"-";"-";"-";"-";"-";"-";"-";"-";"3 736,59";"-27,50000%";"-11,09";"-11,09";"-";"-";"-";"-";"-";"-";"-";"-";"-";"-";"-";"-";"-";"-";"-";"-";"-";"-"
"21 Maj 2024 16:00:17";" Zmodyfikowano Transakcję Kupna";"O2-CW-916WS8";"T2-CW-5FEL0S";"-";"Solana (USD)";"21 Jednost.";"185,120";"-";"-";"188,000";"-";"-";"-";"0,00";"-";"-";"-";"-";"-";"-";"-";"-";"-";"-";"-";"-";"-";"-";"-";"-";"-";"-";"-";"-";"-";"-";"-";"-";"-"
"20 Maj 2024 23:00:52";"Koszty Utrzymania Pozycji";"1337797928";"-";"-";"Rachunek";"-";"-";"-";"-";"-";"-";"-";"-";"-11,45";"7 895,97";"-";"-";"-";"-";"-";"-11,45";"-";"-";"-";"-";"-";"-";"-";"-";"-";"-";"-";"-";"-";"-";"-";"-";"-";"-"
"20 Maj 2024 23:00:52";"Koszty Utrzymania Pozycji";"O2-CW-916WS8";"-";"-";"Solana (USD)";"-";"-";"-";"-";"-";"-";"-";"-";"-";"-";"-";"-";"3 861,48";"-27,50000%";"-11,45";"-11,45";"-";"-";"-";"-";"-";"-";"-";"-";"-";"-";"-";"-";"-";"-";"-";"-";"-";"-"
"20 Maj 2024 22:27:01";" Transakcja Kupna";"O2-CW-916WS8";"T2-CW-5FEL0S";"-";"Solana (USD)";"21 Jednost.";"185,120";"-";"-";"-";"-";"3,936106";"15 301,69";"0,00";"-";"-";"-";"-";"-";"-";"-";"-";"-";"-";"-";"-";"-";"-";"-";"-";"-";"-";"-";"-";"-";"-";"-";"-";"-"
"20 Maj 2024 22:16:59";"Stop Loss";"O2-CW-916ECR";"T2-CW-5FEKXF";"-";"Solana (USD)";"23 Jednost.";"184,026";"-";"-";"-";"-";"3,935846";"16 658,85";"-780,41";"7 907,42";"-";"-";"-";"-";"-";"-";"-";"-";"-";"-";"-";"-";"-";"-";"-";"-";"-";"-";"-";"-";"-";"-";"-";"-"
"20 Maj 2024 22:16:56";"Zmodyfikowano Stop Loss";"O2-CW-916ECR";"-";"O2-CW-916WMY";"Solana (USD)";"23 Jednost.";"175,405";"-";"184,000";"-";"-";"-";"-";"-";"-";"-";"-";"-";"-";"-";"-";"-";"-";"-";"-";"-";"-";"-";"-";"-";"-";"-";"-";"-";"-";"-";"-";"-";"-"
"20 Maj 2024 22:16:31";"Zmodyfikowano Transakcję Sprzedaży";"O2-CW-916ECR";"T2-CW-5FE5LK";"-";"Solana (USD)";"23 Jednost.";"175,405";"-";"184,500";"-";"-";"-";"-";"0,00";"-";"-";"-";"-";"-";"-";"-";"-";"-";"-";"-";"-";"-";"-";"-";"-";"-";"-";"-";"-";"-";"-";"-";"-";"-"
"20 Maj 2024 16:38:54";"Transakcja Sprzedaży";"O2-CW-916ECR";"T2-CW-5FE5LK";"-";"Solana (USD)";"23 Jednost.";"175,405";"-";"-";"-";"-";"3,936176";"15 879,77";"0,00";"-";"-";"-";"-";"-";"-";"-";"-";"-";"-";"-";"-";"-";"-";"-";"-";"-";"-";"-";"-";"-";"-";"-";"-";"-"
"20 Maj 2024 16:34:30";"Stop Loss";"O2-CW-916DNR";"T2-CW-5FE5DN";"-";"Solana (USD)";"23 Jednost.";"175,850";"-";"-";"-";"-";"3,89306";"15 903,93";"24,71";"8 687,83";"-";"-";"-";"-";"-";"-";"-";"-";"-";"-";"-";"-";"-";"-";"-";"-";"-";"-";"-";"-";"-";"-";"-";"-"
"20 Maj 2024 16:34:24";"Zmodyfikowano Stop Loss";"O2-CW-916DNR";"-";"O2-CW-916E0L";"Solana (USD)";"23 Jednost.";"176,126";"-";"175,850";"-";"-";"-";"-";"-";"-";"-";"-";"-";"-";"-";"-";"-";"-";"-";"-";"-";"-";"-";"-";"-";"-";"-";"-";"-";"-";"-";"-";"-";"-"
"20 Maj 2024 16:33:16";"Zmodyfikowano Transakcję Sprzedaży";"O2-CW-916DNR";"T2-CW-5FE51Z";"-";"Solana (USD)";"23 Jednost.";"176,126";"-";"176,000";"-";"-";"-";"-";"0,00";"-";"-";"-";"-";"-";"-";"-";"-";"-";"-";"-";"-";"-";"-";"-";"-";"-";"-";"-";"-";"-";"-";"-";"-";"-"
"20 Maj 2024 16:28:55";"Transakcja Sprzedaży";"O2-CW-916DNR";"T2-CW-5FE51Z";"-";"Solana (USD)";"23 Jednost.";"176,126";"-";"-";"-";"-";"3,93314";"15 932,74";"0,00";"-";"-";"-";"-";"-";"-";"-";"-";"-";"-";"-";"-";"-";"-";"-";"-";"-";"-";"-";"-";"-";"-";"-";"-";"-"
"20 Maj 2024 10:04:08";" Likwidacja";"O2-CW-915QHS";"T2-CW-5FDL2B";"O2-CV-90T6C8";"Solana (USD)";"40 Jednost.";"179,125";"-";"-";"-";"-";"3,934804";"28 192,87";"-4 118,17";"8 663,12";"-";"-";"-";"-";"-";"-";"-";"-";"-";"-";"-";"-";"-";"-";"-";"-";"-";"-";"-";"-";"-";"-";"-";"-"
"20 Maj 2024 10:04:08";" Likwidacja";"O2-CW-915QHS";"T2-CW-5FDL29";"O2-CV-90PZ53";"Solana (USD)";"45 Jednost.";"179,125";"-";"-";"-";"-";"3,934804";"31 716,97";"-6 784,29";"12 781,29";"-";"-";"-";"-";"-";"-";"-";"-";"-";"-";"-";"-";"-";"-";"-";"-";"-";"-";"-";"-";"-";"-";"-";"-"
"20 Maj 2024 10:04:08";" Likwidacja";"O2-CW-915QHS";"T2-CW-5FDL28";"O2-CV-90PYCZ";"Solana (USD)";"2 Jednost.";"179,125";"-";"-";"-";"-";"3,934804";"1 409,64";"-301,48";"19 565,58";"-";"-";"-";"-";"-";"-";"-";"-";"-";"-";"-";"-";"-";"-";"-";"-";"-";"-";"-";"-";"-";"-";"-";"-"
"20 Maj 2024 10:04:08";" Likwidacja";"O2-CW-915QHS";"T2-CW-5FDL27";"O2-CV-90MB7Y";"Solana (USD)";"50 Jednost.";"179,125";"-";"-";"-";"-";"3,934804";"35 241,08";"-5 189,02";"19 867,06";"-";"-";"-";"-";"-";"-";"-";"-";"-";"-";"-";"-";"-";"-";"-";"-";"-";"-";"-";"-";"-";"-";"-";"-"
"20 Maj 2024 10:04:08";" Likwidacja";"O2-CW-915QHS";"T2-CW-5FDL26";"O2-CV-909KF0";"Solana (USD)";"140 Jednost.";"179,125";"-";"-";"-";"-";"3,934804";"98 675,04";"-33 041,34";"25 056,08";"-";"-";"-";"-";"-";"-";"-";"-";"-";"-";"-";"-";"-";"-";"-";"-";"-";"-";"-";"-";"-";"-";"-";"-"
"20 Maj 2024 10:04:08";" Likwidacja";"O2-CW-915QHR";"T2-CW-5FDL25";"O2-CV-9103J0";"Solana (USD)";"3 Jednost.";"178,925";"-";"-";"-";"-";"3,89564";"2 112,10";"314,48";"58 097,42";"-";"-";"-";"-";"-";"-";"-";"-";"-";"-";"-";"-";"-";"-";"-";"-";"-";"-";"-";"-";"-";"-";"-";"-"
"20 Maj 2024 10:04:08";" Likwidacja";"O2-CW-915QHR";"T2-CW-5FDL24";"O2-CV-90VNBT";"Solana (USD)";"6,5 Jednost.";"178,925";"-";"-";"-";"-";"3,89564";"4 576,22";"865,22";"57 782,94";"-";"-";"-";"-";"-";"-";"-";"-";"-";"-";"-";"-";"-";"-";"-";"-";"-";"-";"-";"-";"-";"-";"-";"-"
"20 Maj 2024 10:04:08";" Likwidacja";"O2-CW-915QHR";"T2-CW-5FDL23";"O2-CV-90T1X7";"Solana (USD)";"70 Jednost.";"178,925";"-";"-";"-";"-";"3,89564";"49 282,43";"6 683,75";"56 917,72";"-";"-";"-";"-";"-";"-";"-";"-";"-";"-";"-";"-";"-";"-";"-";"-";"-";"-";"-";"-";"-";"-";"-";"-"
"20 Maj 2024 10:04:08";" Likwidacja";"O2-CW-915QHR";"T2-CW-5FDL22";"O2-CV-90MEWZ";"Solana (USD)";"95 Jednost.";"178,925";"-";"-";"-";"-";"3,89564";"66 883,30";"8 232,56";"50 233,97";"-";"-";"-";"-";"-";"-";"-";"-";"-";"-";"-";"-";"-";"-";"-";"-";"-";"-";"-";"-";"-";"-";"-";"-"
"20 Maj 2024 10:04:08";" Likwidacja";"O2-CW-915QHR";"T2-CW-5FDL21";"O2-CR-8Z7P36";"Solana (USD)";"50 Jednost.";"178,925";"-";"-";"-";"-";"3,89564";"35 201,74";"1 089,81";"42 001,41";"-";"-";"-";"-";"-";"-";"-";"-";"-";"-";"-";"-";"-";"-";"-";"-";"-";"-";"-";"-";"-";"-";"-";"-"
"17 Maj 2024 23:00:52";"Koszty Utrzymania Pozycji";"1337413460";"-";"-";"Rachunek";"-";"-";"-";"-";"-";"-";"-";"-";"-187,74";"40 911,60";"-";"-";"-";"-";"-";"-187,74";"-";"-";"-";"-";"-";"-";"-";"-";"-";"-";"-";"-";"-";"-";"-";"-";"-";"-"
"17 Maj 2024 23:00:52";"Koszty Utrzymania Pozycji";"O2-CV-90T1X7";"-";"-";"Solana (USD)";"-";"-";"-";"-";"-";"-";"-";"-";"-";"-";"-";"-";"11 827,55";"-27,50000%";"-105,33";"-105,33";"-";"-";"-";"-";"-";"-";"-";"-";"-";"-";"-";"-";"-";"-";"-";"-";"-";"-"
"17 Maj 2024 23:00:52";"Koszty Utrzymania Pozycji";"O2-CV-90T6C8";"-";"-";"Solana (USD)";"-";"-";"-";"-";"-";"-";"-";"-";"-";"-";"-";"-";"6 758,60";"-10,00000%";"21,67";"21,67";"-";"-";"-";"-";"-";"-";"-";"-";"-";"-";"-";"-";"-";"-";"-";"-";"-";"-"
"17 Maj 2024 23:00:52";"Koszty Utrzymania Pozycji";"O2-CV-90PYCZ";"-";"-";"Solana (USD)";"-";"-";"-";"-";"-";"-";"-";"-";"-";"-";"-";"-";"337,93";"-10,00000%";"1,08";"1,08";"-";"-";"-";"-";"-";"-";"-";"-";"-";"-";"-";"-";"-";"-";"-";"-";"-";"-"
"17 Maj 2024 23:00:52";"Koszty Utrzymania Pozycji";"O2-CV-909KF0";"-";"-";"Solana (USD)";"-";"-";"-";"-";"-";"-";"-";"-";"-";"-";"-";"-";"23 655,10";"-10,00000%";"75,84";"75,84";"-";"-";"-";"-";"-";"-";"-";"-";"-";"-";"-";"-";"-";"-";"-";"-";"-";"-"
"17 Maj 2024 23:00:52";"Koszty Utrzymania Pozycji";"O2-CR-8Z7P36";"-";"-";"Solana (USD)";"-";"-";"-";"-";"-";"-";"-";"-";"-";"-";"-";"-";"8 448,25";"-27,50000%";"-75,23";"-75,23";"-";"-";"-";"-";"-";"-";"-";"-";"-";"-";"-";"-";"-";"-";"-";"-";"-";"-"
"17 Maj 2024 23:00:52";"Koszty Utrzymania Pozycji";"O2-CV-90MEWZ";"-";"-";"Solana (USD)";"-";"-";"-";"-";"-";"-";"-";"-";"-";"-";"-";"-";"16 051,67";"-27,50000%";"-142,94";"-142,94";"-";"-";"-";"-";"-";"-";"-";"-";"-";"-";"-";"-";"-";"-";"-";"-";"-";"-"
"17 Maj 2024 23:00:52";"Koszty Utrzymania Pozycji";"O2-CV-9103J0";"-";"-";"Solana (USD)";"-";"-";"-";"-";"-";"-";"-";"-";"-";"-";"-";"-";"506,89";"-27,50000%";"-4,51";"-4,51";"-";"-";"-";"-";"-";"-";"-";"-";"-";"-";"-";"-";"-";"-";"-";"-";"-";"-"
"17 Maj 2024 23:00:52";"Koszty Utrzymania Pozycji";"O2-CV-90MB7Y";"-";"-";"Solana (USD)";"-";"-";"-";"-";"-";"-";"-";"-";"-";"-";"-";"-";"8 448,25";"-10,00000%";"27,08";"27,08";"-";"-";"-";"-";"-";"-";"-";"-";"-";"-";"-";"-";"-";"-";"-";"-";"-";"-"
"17 Maj 2024 23:00:52";"Koszty Utrzymania Pozycji";"O2-CV-90PZ53";"-";"-";"Solana (USD)";"-";"-";"-";"-";"-";"-";"-";"-";"-";"-";"-";"-";"7 603,42";"-10,00000%";"24,38";"24,38";"-";"-";"-";"-";"-";"-";"-";"-";"-";"-";"-";"-";"-";"-";"-";"-";"-";"-"
"17 Maj 2024 23:00:52";"Koszty Utrzymania Pozycji";"O2-CV-90VNBT";"-";"-";"Solana (USD)";"-";"-";"-";"-";"-";"-";"-";"-";"-";"-";"-";"-";"1 098,27";"-27,50000%";"-9,78";"-9,78";"-";"-";"-";"-";"-";"-";"-";"-";"-";"-";"-";"-";"-";"-";"-";"-";"-";"-"
"17 Maj 2024 11:04:44";" Zamknięcie Transakcji";"O2-CV-913ZFM";"T2-CV-5FC4VL";"O2-CV-90MEWZ";"Solana (USD)";"5 Jednost.";"168,331";"-";"-";"-";"-";"3,91395";"3 327,29";"228,01";"41 099,34";"-";"-";"-";"-";"-";"-";"-";"-";"-";"-";"-";"-";"-";"-";"-";"-";"-";"-";"-";"-";"-";"-";"-";"-"
"16 Maj 2024 23:00:56";"Koszty Utrzymania Pozycji";"1337013964";"-";"-";"Rachunek";"-";"-";"-";"-";"-";"-";"-";"-";"-61,17";"40 871,33";"-";"-";"-";"-";"-";"-61,17";"-";"-";"-";"-";"-";"-";"-";"-";"-";"-";"-";"-";"-";"-";"-";"-";"-";"-"
"16 Maj 2024 23:00:56";"Koszty Utrzymania Pozycji";"O2-CV-90T1X7";"-";"-";"Solana (USD)";"-";"-";"-";"-";"-";"-";"-";"-";"-";"-";"-";"-";"11 117,33";"-27,50000%";"-33,00";"-33,00";"-";"-";"-";"-";"-";"-";"-";"-";"-";"-";"-";"-";"-";"-";"-";"-";"-";"-"
"16 Maj 2024 23:00:56";"Koszty Utrzymania Pozycji";"O2-CV-90T6C8";"-";"-";"Solana (USD)";"-";"-";"-";"-";"-";"-";"-";"-";"-";"-";"-";"-";"6 352,76";"-10,00000%";"6,79";"6,79";"-";"-";"-";"-";"-";"-";"-";"-";"-";"-";"-";"-";"-";"-";"-";"-";"-";"-"
"16 Maj 2024 23:00:56";"Koszty Utrzymania Pozycji";"O2-CV-90PYCZ";"-";"-";"Solana (USD)";"-";"-";"-";"-";"-";"-";"-";"-";"-";"-";"-";"-";"317,63";"-10,00000%";"0,34";"0,34";"-";"-";"-";"-";"-";"-";"-";"-";"-";"-";"-";"-";"-";"-";"-";"-";"-";"-"
"16 Maj 2024 23:00:56";"Koszty Utrzymania Pozycji";"O2-CV-909KF0";"-";"-";"Solana (USD)";"-";"-";"-";"-";"-";"-";"-";"-";"-";"-";"-";"-";"22 234,66";"-10,00000%";"23,76";"23,76";"-";"-";"-";"-";"-";"-";"-";"-";"-";"-";"-";"-";"-";"-";"-";"-";"-";"-"
"16 Maj 2024 23:00:56";"Koszty Utrzymania Pozycji";"O2-CR-8Z7P36";"-";"-";"Solana (USD)";"-";"-";"-";"-";"-";"-";"-";"-";"-";"-";"-";"-";"7 940,95";"-27,50000%";"-23,57";"-23,57";"-";"-";"-";"-";"-";"-";"-";"-";"-";"-";"-";"-";"-";"-";"-";"-";"-";"-"
"16 Maj 2024 23:00:56";"Koszty Utrzymania Pozycji";"O2-CV-9103J0";"-";"-";"Solana (USD)";"-";"-";"-";"-";"-";"-";"-";"-";"-";"-";"-";"-";"476,45";"-27,50000%";"-1,41";"-1,41";"-";"-";"-";"-";"-";"-";"-";"-";"-";"-";"-";"-";"-";"-";"-";"-";"-";"-"
"16 Maj 2024 23:00:56";"Koszty Utrzymania Pozycji";"O2-CV-90MEWZ";"-";"-";"Solana (USD)";"-";"-";"-";"-";"-";"-";"-";"-";"-";"-";"-";"-";"15 881,90";"-27,50000%";"-47,14";"-47,14";"-";"-";"-";"-";"-";"-";"-";"-";"-";"-";"-";"-";"-";"-";"-";"-";"-";"-"
"16 Maj 2024 23:00:56";"Koszty Utrzymania Pozycji";"O2-CV-90MB7Y";"-";"-";"Solana (USD)";"-";"-";"-";"-";"-";"-";"-";"-";"-";"-";"-";"-";"7 940,95";"-10,00000%";"8,48";"8,48";"-";"-";"-";"-";"-";"-";"-";"-";"-";"-";"-";"-";"-";"-";"-";"-";"-";"-"
"16 Maj 2024 23:00:56";"Koszty Utrzymania Pozycji";"O2-CV-90PZ53";"-";"-";"Solana (USD)";"-";"-";"-";"-";"-";"-";"-";"-";"-";"-";"-";"-";"7 146,85";"-10,00000%";"7,64";"7,64";"-";"-";"-";"-";"-";"-";"-";"-";"-";"-";"-";"-";"-";"-";"-";"-";"-";"-"
"16 Maj 2024 23:00:56";"Koszty Utrzymania Pozycji";"O2-CV-90VNBT";"-";"-";"Solana (USD)";"-";"-";"-";"-";"-";"-";"-";"-";"-";"-";"-";"-";"1 032,32";"-27,50000%";"-3,06";"-3,06";"-";"-";"-";"-";"-";"-";"-";"-";"-";"-";"-";"-";"-";"-";"-";"-";"-";"-"
"15 Maj 2024 23:00:55";"Koszty Utrzymania Pozycji";"1336579800";"-";"-";"Rachunek";"-";"-";"-";"-";"-";"-";"-";"-";"-60,31";"40 932,50";"-";"-";"-";"-";"-";"-60,31";"-";"-";"-";"-";"-";"-";"-";"-";"-";"-";"-";"-";"-";"-";"-";"-";"-";"-"
"15 Maj 2024 23:00:55";"Koszty Utrzymania Pozycji";"O2-CV-90T1X7";"-";"-";"Solana (USD)";"-";"-";"-";"-";"-";"-";"-";"-";"-";"-";"-";"-";"10 971,45";"-27,50000%";"-32,53";"-32,53";"-";"-";"-";"-";"-";"-";"-";"-";"-";"-";"-";"-";"-";"-";"-";"-";"-";"-"
"15 Maj 2024 23:00:55";"Koszty Utrzymania Pozycji";"O2-CV-90T6C8";"-";"-";"Solana (USD)";"-";"-";"-";"-";"-";"-";"-";"-";"-";"-";"-";"-";"6 269,40";"-10,00000%";"6,69";"6,69";"-";"-";"-";"-";"-";"-";"-";"-";"-";"-";"-";"-";"-";"-";"-";"-";"-";"-"
"15 Maj 2024 23:00:55";"Koszty Utrzymania Pozycji";"O2-CV-90PYCZ";"-";"-";"Solana (USD)";"-";"-";"-";"-";"-";"-";"-";"-";"-";"-";"-";"-";"313,47";"-10,00000%";"0,33";"0,33";"-";"-";"-";"-";"-";"-";"-";"-";"-";"-";"-";"-";"-";"-";"-";"-";"-";"-"
"15 Maj 2024 23:00:55";"Koszty Utrzymania Pozycji";"O2-CV-909KF0";"-";"-";"Solana (USD)";"-";"-";"-";"-";"-";"-";"-";"-";"-";"-";"-";"-";"21 942,90";"-10,00000%";"23,42";"23,42";"-";"-";"-";"-";"-";"-";"-";"-";"-";"-";"-";"-";"-";"-";"-";"-";"-";"-"
"15 Maj 2024 23:00:55";"Koszty Utrzymania Pozycji";"O2-CR-8Z7P36";"-";"-";"Solana (USD)";"-";"-";"-";"-";"-";"-";"-";"-";"-";"-";"-";"-";"7 836,75";"-27,50000%";"-23,24";"-23,24";"-";"-";"-";"-";"-";"-";"-";"-";"-";"-";"-";"-";"-";"-";"-";"-";"-";"-"
"15 Maj 2024 23:00:55";"Koszty Utrzymania Pozycji";"O2-CV-9103J0";"-";"-";"Solana (USD)";"-";"-";"-";"-";"-";"-";"-";"-";"-";"-";"-";"-";"470,20";"-27,50000%";"-1,39";"-1,39";"-";"-";"-";"-";"-";"-";"-";"-";"-";"-";"-";"-";"-";"-";"-";"-";"-";"-"
"15 Maj 2024 23:00:55";"Koszty Utrzymania Pozycji";"O2-CV-90MEWZ";"-";"-";"Solana (USD)";"-";"-";"-";"-";"-";"-";"-";"-";"-";"-";"-";"-";"15 673,50";"-27,50000%";"-46,47";"-46,47";"-";"-";"-";"-";"-";"-";"-";"-";"-";"-";"-";"-";"-";"-";"-";"-";"-";"-"
"15 Maj 2024 23:00:55";"Koszty Utrzymania Pozycji";"O2-CV-90MB7Y";"-";"-";"Solana (USD)";"-";"-";"-";"-";"-";"-";"-";"-";"-";"-";"-";"-";"7 836,75";"-10,00000%";"8,37";"8,37";"-";"-";"-";"-";"-";"-";"-";"-";"-";"-";"-";"-";"-";"-";"-";"-";"-";"-"
"15 Maj 2024 23:00:55";"Koszty Utrzymania Pozycji";"O2-CV-90PZ53";"-";"-";"Solana (USD)";"-";"-";"-";"-";"-";"-";"-";"-";"-";"-";"-";"-";"7 053,07";"-10,00000%";"7,53";"7,53";"-";"-";"-";"-";"-";"-";"-";"-";"-";"-";"-";"-";"-";"-";"-";"-";"-";"-"
"15 Maj 2024 23:00:55";"Koszty Utrzymania Pozycji";"O2-CV-90VNBT";"-";"-";"Solana (USD)";"-";"-";"-";"-";"-";"-";"-";"-";"-";"-";"-";"-";"1 018,77";"-27,50000%";"-3,02";"-3,02";"-";"-";"-";"-";"-";"-";"-";"-";"-";"-";"-";"-";"-";"-";"-";"-";"-";"-"
"15 Maj 2024 22:32:18";"Take Profit";"O2-CV-90L0DG";"T2-CV-5F8G7R";"-";"Solana (USD)";"90 Jednost.";"155,700";"-";"-";"-";"-";"3,89558";"55 137,55";"61,36";"40 992,81";"-";"-";"-";"-";"-";"-";"-";"-";"-";"-";"-";"-";"-";"-";"-";"-";"-";"-";"-";"-";"-";"-";"-";"-"
"15 Maj 2024 16:09:56";" Transakcja Kupna";"O2-CV-9103J0";"T2-CV-5F7QPZ";"-";"Solana (USD)";"3 Jednost.";"152,016";"-";"-";"-";"-";"3,954954";"1 803,64";"0,00";"-";"-";"-";"-";"-";"-";"-";"-";"-";"-";"-";"-";"-";"-";"-";"-";"-";"-";"-";"-";"-";"-";"-";"-";"-"
"14 Maj 2024 23:00:52";"Koszty Utrzymania Pozycji";"1336105749";"-";"-";"Rachunek";"-";"-";"-";"-";"-";"-";"-";"-";"-92,56";"40 931,45";"-";"-";"-";"-";"-";"-92,56";"-";"-";"-";"-";"-";"-";"-";"-";"-";"-";"-";"-";"-";"-";"-";"-";"-";"-"
"14 Maj 2024 23:00:52";"Koszty Utrzymania Pozycji";"O2-CV-90T1X7";"-";"-";"Solana (USD)";"-";"-";"-";"-";"-";"-";"-";"-";"-";"-";"-";"-";"10 004,40";"-27,50000%";"-29,89";"-29,89";"-";"-";"-";"-";"-";"-";"-";"-";"-";"-";"-";"-";"-";"-";"-";"-";"-";"-"
"14 Maj 2024 23:00:52";"Koszty Utrzymania Pozycji";"O2-CV-90T6C8";"-";"-";"Solana (USD)";"-";"-";"-";"-";"-";"-";"-";"-";"-";"-";"-";"-";"5 716,80";"-10,00000%";"6,15";"6,15";"-";"-";"-";"-";"-";"-";"-";"-";"-";"-";"-";"-";"-";"-";"-";"-";"-";"-"
"14 Maj 2024 23:00:52";"Koszty Utrzymania Pozycji";"O2-CV-90PYCZ";"-";"-";"Solana (USD)";"-";"-";"-";"-";"-";"-";"-";"-";"-";"-";"-";"-";"285,84";"-10,00000%";"0,31";"0,31";"-";"-";"-";"-";"-";"-";"-";"-";"-";"-";"-";"-";"-";"-";"-";"-";"-";"-"
"14 Maj 2024 23:00:52";"Koszty Utrzymania Pozycji";"O2-CV-909KF0";"-";"-";"Solana (USD)";"-";"-";"-";"-";"-";"-";"-";"-";"-";"-";"-";"-";"20 008,80";"-10,00000%";"21,52";"21,52";"-";"-";"-";"-";"-";"-";"-";"-";"-";"-";"-";"-";"-";"-";"-";"-";"-";"-"
"14 Maj 2024 23:00:52";"Koszty Utrzymania Pozycji";"O2-CR-8Z7P36";"-";"-";"Solana (USD)";"-";"-";"-";"-";"-";"-";"-";"-";"-";"-";"-";"-";"7 146,00";"-27,50000%";"-21,35";"-21,35";"-";"-";"-";"-";"-";"-";"-";"-";"-";"-";"-";"-";"-";"-";"-";"-";"-";"-"
"14 Maj 2024 23:00:52";"Koszty Utrzymania Pozycji";"O2-CV-90MEWZ";"-";"-";"Solana (USD)";"-";"-";"-";"-";"-";"-";"-";"-";"-";"-";"-";"-";"14 292,00";"-27,50000%";"-42,70";"-42,70";"-";"-";"-";"-";"-";"-";"-";"-";"-";"-";"-";"-";"-";"-";"-";"-";"-";"-"
"14 Maj 2024 23:00:52";"Koszty Utrzymania Pozycji";"O2-CV-90L0DG";"-";"-";"Solana (USD)";"-";"-";"-";"-";"-";"-";"-";"-";"-";"-";"-";"-";"12 862,80";"-27,50000%";"-38,43";"-38,43";"-";"-";"-";"-";"-";"-";"-";"-";"-";"-";"-";"-";"-";"-";"-";"-";"-";"-"
"14 Maj 2024 23:00:52";"Koszty Utrzymania Pozycji";"O2-CV-90MB7Y";"-";"-";"Solana (USD)";"-";"-";"-";"-";"-";"-";"-";"-";"-";"-";"-";"-";"7 146,00";"-10,00000%";"7,69";"7,69";"-";"-";"-";"-";"-";"-";"-";"-";"-";"-";"-";"-";"-";"-";"-";"-";"-";"-"
"14 Maj 2024 23:00:52";"Koszty Utrzymania Pozycji";"O2-CV-90PZ53";"-";"-";"Solana (USD)";"-";"-";"-";"-";"-";"-";"-";"-";"-";"-";"-";"-";"6 431,40";"-10,00000%";"6,92";"6,92";"-";"-";"-";"-";"-";"-";"-";"-";"-";"-";"-";"-";"-";"-";"-";"-";"-";"-"
"14 Maj 2024 23:00:52";"Koszty Utrzymania Pozycji";"O2-CV-90VNBT";"-";"-";"Solana (USD)";"-";"-";"-";"-";"-";"-";"-";"-";"-";"-";"-";"-";"928,98";"-27,50000%";"-2,78";"-2,78";"-";"-";"-";"-";"-";"-";"-";"-";"-";"-";"-";"-";"-";"-";"-";"-";"-";"-"
"13 Maj 2024 23:32:40";"Zmodyfikowano Transakcję Sprzedaży";"O2-CV-909KF0";"T2-CV-5EMY9V";"-";"Solana (USD)";"140 Jednost.";"119,145";"-";"-";"-";"-";"-";"-";"0,00";"-";"-";"-";"-";"-";"-";"-";"-";"-";"-";"-";"-";"-";"-";"-";"-";"-";"-";"-";"-";"-";"-";"-";"-";"-"
"13 Maj 2024 23:31:36";" Zmodyfikowano Transakcję Kupna";"O2-CV-90L0DG";"T2-CV-5EWJXP";"-";"Solana (USD)";"90 Jednost.";"155,525";"-";"-";"155,700";"-";"-";"-";"0,00";"-";"-";"-";"-";"-";"-";"-";"-";"-";"-";"-";"-";"-";"-";"-";"-";"-";"-";"-";"-";"-";"-";"-";"-";"-"
"13 Maj 2024 23:00:53";"Koszty Utrzymania Pozycji";"1335683467";"-";"-";"Rachunek";"-";"-";"-";"-";"-";"-";"-";"-";"-97,06";"41 024,01";"-";"-";"-";"-";"-";"-97,06";"-";"-";"-";"-";"-";"-";"-";"-";"-";"-";"-";"-";"-";"-";"-";"-";"-";"-"
"13 Maj 2024 23:00:53";"Koszty Utrzymania Pozycji";"O2-CV-90T1X7";"-";"-";"Solana (USD)";"-";"-";"-";"-";"-";"-";"-";"-";"-";"-";"-";"-";"10 418,80";"-27,50000%";"-31,34";"-31,34";"-";"-";"-";"-";"-";"-";"-";"-";"-";"-";"-";"-";"-";"-";"-";"-";"-";"-"
"13 Maj 2024 23:00:53";"Koszty Utrzymania Pozycji";"O2-CV-90T6C8";"-";"-";"Solana (USD)";"-";"-";"-";"-";"-";"-";"-";"-";"-";"-";"-";"-";"5 953,60";"-10,00000%";"6,45";"6,45";"-";"-";"-";"-";"-";"-";"-";"-";"-";"-";"-";"-";"-";"-";"-";"-";"-";"-"
"13 Maj 2024 23:00:53";"Koszty Utrzymania Pozycji";"O2-CV-90PYCZ";"-";"-";"Solana (USD)";"-";"-";"-";"-";"-";"-";"-";"-";"-";"-";"-";"-";"297,68";"-10,00000%";"0,32";"0,32";"-";"-";"-";"-";"-";"-";"-";"-";"-";"-";"-";"-";"-";"-";"-";"-";"-";"-"
"13 Maj 2024 23:00:53";"Koszty Utrzymania Pozycji";"O2-CV-909KF0";"-";"-";"Solana (USD)";"-";"-";"-";"-";"-";"-";"-";"-";"-";"-";"-";"-";"20 837,60";"-10,00000%";"22,57";"22,57";"-";"-";"-";"-";"-";"-";"-";"-";"-";"-";"-";"-";"-";"-";"-";"-";"-";"-"
"13 Maj 2024 23:00:53";"Koszty Utrzymania Pozycji";"O2-CR-8Z7P36";"-";"-";"Solana (USD)";"-";"-";"-";"-";"-";"-";"-";"-";"-";"-";"-";"-";"7 442,00";"-27,50000%";"-22,39";"-22,39";"-";"-";"-";"-";"-";"-";"-";"-";"-";"-";"-";"-";"-";"-";"-";"-";"-";"-"
"13 Maj 2024 23:00:53";"Koszty Utrzymania Pozycji";"O2-CV-90MEWZ";"-";"-";"Solana (USD)";"-";"-";"-";"-";"-";"-";"-";"-";"-";"-";"-";"-";"14 884,00";"-27,50000%";"-44,77";"-44,77";"-";"-";"-";"-";"-";"-";"-";"-";"-";"-";"-";"-";"-";"-";"-";"-";"-";"-"
"13 Maj 2024 23:00:53";"Koszty Utrzymania Pozycji";"O2-CV-90L0DG";"-";"-";"Solana (USD)";"-";"-";"-";"-";"-";"-";"-";"-";"-";"-";"-";"-";"13 395,60";"-27,50000%";"-40,30";"-40,30";"-";"-";"-";"-";"-";"-";"-";"-";"-";"-";"-";"-";"-";"-";"-";"-";"-";"-"
"13 Maj 2024 23:00:53";"Koszty Utrzymania Pozycji";"O2-CV-90MB7Y";"-";"-";"Solana (USD)";"-";"-";"-";"-";"-";"-";"-";"-";"-";"-";"-";"-";"7 442,00";"-10,00000%";"8,06";"8,06";"-";"-";"-";"-";"-";"-";"-";"-";"-";"-";"-";"-";"-";"-";"-";"-";"-";"-"
"13 Maj 2024 23:00:53";"Koszty Utrzymania Pozycji";"O2-CV-90PZ53";"-";"-";"Solana (USD)";"-";"-";"-";"-";"-";"-";"-";"-";"-";"-";"-";"-";"6 697,80";"-10,00000%";"7,25";"7,25";"-";"-";"-";"-";"-";"-";"-";"-";"-";"-";"-";"-";"-";"-";"-";"-";"-";"-"
"13 Maj 2024 23:00:53";"Koszty Utrzymania Pozycji";"O2-CV-90VNBT";"-";"-";"Solana (USD)";"-";"-";"-";"-";"-";"-";"-";"-";"-";"-";"-";"-";"967,46";"-27,50000%";"-2,91";"-2,91";"-";"-";"-";"-";"-";"-";"-";"-";"-";"-";"-";"-";"-";"-";"-";"-";"-";"-"
"13 Maj 2024 10:06:37";" Transakcja Kupna";"O2-CV-90VNBT";"T2-CV-5F3S64";"-";"Solana (USD)";"6,5 Jednost.";"144,756";"-";"-";"-";"-";"4,01345";"3 776,31";"0,00";"-";"-";"-";"-";"-";"-";"-";"-";"-";"-";"-";"-";"-";"-";"-";"-";"-";"-";"-";"-";"-";"-";"-";"-";"-"
"13 Maj 2024 05:03:06";"Take Profit";"O2-CV-90PZ4X";"T2-CV-5F3L4Q";"-";"Solana (USD)";"50 Jednost.";"140,000";"-";"-";"-";"-";"3,97561";"28 109,02";"178,90";"41 121,07";"-";"-";"-";"-";"-";"-";"-";"-";"-";"-";"-";"-";"-";"-";"-";"-";"-";"-";"-";"-";"-";"-";"-";"-"
"12 Maj 2024 23:11:23";"Zmodyfikowano Transakcję Sprzedaży";"O2-CV-90PZ4X";"T2-CV-5EZX0F";"-";"Solana (USD)";"50 Jednost.";"140,900";"-";"-";"140,000";"-";"-";"-";"0,00";"-";"-";"-";"-";"-";"-";"-";"-";"-";"-";"-";"-";"-";"-";"-";"-";"-";"-";"-";"-";"-";"-";"-";"-";"-"
"10 Maj 2024 23:00:53";"Koszty Utrzymania Pozycji";"1335305738";"-";"-";"Rachunek";"-";"-";"-";"-";"-";"-";"-";"-";"-256,67";"40 942,17";"-";"-";"-";"-";"-";"-256,67";"-";"-";"-";"-";"-";"-";"-";"-";"-";"-";"-";"-";"-";"-";"-";"-";"-";"-"
"10 Maj 2024 23:00:53";"Koszty Utrzymania Pozycji";"O2-CV-90T1X7";"-";"-";"Solana (USD)";"-";"-";"-";"-";"-";"-";"-";"-";"-";"-";"-";"-";"10 295,95";"-27,50000%";"-93,44";"-93,44";"-";"-";"-";"-";"-";"-";"-";"-";"-";"-";"-";"-";"-";"-";"-";"-";"-";"-"
"10 Maj 2024 23:00:53";"Koszty Utrzymania Pozycji";"O2-CV-90T6C8";"-";"-";"Solana (USD)";"-";"-";"-";"-";"-";"-";"-";"-";"-";"-";"-";"-";"5 883,40";"-10,00000%";"19,22";"19,22";"-";"-";"-";"-";"-";"-";"-";"-";"-";"-";"-";"-";"-";"-";"-";"-";"-";"-"
"10 Maj 2024 23:00:53";"Koszty Utrzymania Pozycji";"O2-CV-90PYCZ";"-";"-";"Solana (USD)";"-";"-";"-";"-";"-";"-";"-";"-";"-";"-";"-";"-";"294,17";"-10,00000%";"0,96";"0,96";"-";"-";"-";"-";"-";"-";"-";"-";"-";"-";"-";"-";"-";"-";"-";"-";"-";"-"
"10 Maj 2024 23:00:53";"Koszty Utrzymania Pozycji";"O2-CV-909KF0";"-";"-";"Solana (USD)";"-";"-";"-";"-";"-";"-";"-";"-";"-";"-";"-";"-";"20 591,90";"-10,00000%";"67,28";"67,28";"-";"-";"-";"-";"-";"-";"-";"-";"-";"-";"-";"-";"-";"-";"-";"-";"-";"-"
"10 Maj 2024 23:00:53";"Koszty Utrzymania Pozycji";"O2-CV-90PZ4X";"-";"-";"Solana (USD)";"-";"-";"-";"-";"-";"-";"-";"-";"-";"-";"-";"-";"7 354,25";"-10,00000%";"24,03";"24,03";"-";"-";"-";"-";"-";"-";"-";"-";"-";"-";"-";"-";"-";"-";"-";"-";"-";"-"
"10 Maj 2024 23:00:53";"Koszty Utrzymania Pozycji";"O2-CR-8Z7P36";"-";"-";"Solana (USD)";"-";"-";"-";"-";"-";"-";"-";"-";"-";"-";"-";"-";"7 354,25";"-27,50000%";"-66,75";"-66,75";"-";"-";"-";"-";"-";"-";"-";"-";"-";"-";"-";"-";"-";"-";"-";"-";"-";"-"
"10 Maj 2024 23:00:53";"Koszty Utrzymania Pozycji";"O2-CV-90MEWZ";"-";"-";"Solana (USD)";"-";"-";"-";"-";"-";"-";"-";"-";"-";"-";"-";"-";"14 708,50";"-27,50000%";"-133,49";"-133,49";"-";"-";"-";"-";"-";"-";"-";"-";"-";"-";"-";"-";"-";"-";"-";"-";"-";"-"
"10 Maj 2024 23:00:53";"Koszty Utrzymania Pozycji";"O2-CV-90L0DG";"-";"-";"Solana (USD)";"-";"-";"-";"-";"-";"-";"-";"-";"-";"-";"-";"-";"13 237,65";"-27,50000%";"-120,14";"-120,14";"-";"-";"-";"-";"-";"-";"-";"-";"-";"-";"-";"-";"-";"-";"-";"-";"-";"-"
"10 Maj 2024 23:00:53";"Koszty Utrzymania Pozycji";"O2-CV-90MB7Y";"-";"-";"Solana (USD)";"-";"-";"-";"-";"-";"-";"-";"-";"-";"-";"-";"-";"7 354,25";"-10,00000%";"24,03";"24,03";"-";"-";"-";"-";"-";"-";"-";"-";"-";"-";"-";"-";"-";"-";"-";"-";"-";"-"
"10 Maj 2024 23:00:53";"Koszty Utrzymania Pozycji";"O2-CV-90PZ53";"-";"-";"Solana (USD)";"-";"-";"-";"-";"-";"-";"-";"-";"-";"-";"-";"-";"6 618,82";"-10,00000%";"21,63";"21,63";"-";"-";"-";"-";"-";"-";"-";"-";"-";"-";"-";"-";"-";"-";"-";"-";"-";"-"
"10 Maj 2024 13:16:24";"Transakcja Sprzedaży";"O2-CV-90T6C8";"T2-CV-5F2KX5";"-";"Solana (USD)";"40 Jednost.";"152,960";"-";"-";"-";"-";"4,007649";"24 520,39";"0,00";"-";"-";"-";"-";"-";"-";"-";"-";"-";"-";"-";"-";"-";"-";"-";"-";"-";"-";"-";"-";"-";"-";"-";"-";"-"
"10 Maj 2024 11:43:37";" Transakcja Kupna";"O2-CV-90T1X7";"T2-CV-5F2GPM";"-";"Solana (USD)";"70 Jednost.";"154,415";"-";"-";"-";"-";"4,002078";"43 258,66";"0,00";"-";"-";"-";"-";"-";"-";"-";"-";"-";"-";"-";"-";"-";"-";"-";"-";"-";"-";"-";"-";"-";"-";"-";"-";"-"
"10 Maj 2024 00:31:19";" Zmodyfikowano Transakcję Kupna";"O2-CV-90MEWZ";"T2-CV-5EXQTK";"-";"Solana (USD)";"100 Jednost.";"156,680";"-";"-";"-";"-";"-";"-";"0,00";"-";"-";"-";"-";"-";"-";"-";"-";"-";"-";"-";"-";"-";"-";"-";"-";"-";"-";"-";"-";"-";"-";"-";"-";"-"
"09 Maj 2024 23:00:56";"Koszty Utrzymania Pozycji";"1334913661";"-";"-";"Rachunek";"-";"-";"-";"-";"-";"-";"-";"-";"-61,86";"41 198,84";"-";"-";"-";"-";"-";"-61,86";"-";"-";"-";"-";"-";"-";"-";"-";"-";"-";"-";"-";"-";"-";"-";"-";"-";"-"
"09 Maj 2024 23:00:56";"Koszty Utrzymania Pozycji";"O2-CV-90PYCZ";"-";"-";"Solana (USD)";"-";"-";"-";"-";"-";"-";"-";"-";"-";"-";"-";"-";"300,61";"-10,00000%";"0,33";"0,33";"-";"-";"-";"-";"-";"-";"-";"-";"-";"-";"-";"-";"-";"-";"-";"-";"-";"-"
"09 Maj 2024 23:00:56";"Koszty Utrzymania Pozycji";"O2-CV-909KF0";"-";"-";"Solana (USD)";"-";"-";"-";"-";"-";"-";"-";"-";"-";"-";"-";"-";"21 042,70";"-10,00000%";"22,81";"22,81";"-";"-";"-";"-";"-";"-";"-";"-";"-";"-";"-";"-";"-";"-";"-";"-";"-";"-"
"09 Maj 2024 23:00:56";"Koszty Utrzymania Pozycji";"O2-CV-90PZ4X";"-";"-";"Solana (USD)";"-";"-";"-";"-";"-";"-";"-";"-";"-";"-";"-";"-";"7 515,25";"-10,00000%";"8,15";"8,15";"-";"-";"-";"-";"-";"-";"-";"-";"-";"-";"-";"-";"-";"-";"-";"-";"-";"-"
"09 Maj 2024 23:00:56";"Koszty Utrzymania Pozycji";"O2-CR-8Z7P36";"-";"-";"Solana (USD)";"-";"-";"-";"-";"-";"-";"-";"-";"-";"-";"-";"-";"7 515,25";"-27,50000%";"-22,63";"-22,63";"-";"-";"-";"-";"-";"-";"-";"-";"-";"-";"-";"-";"-";"-";"-";"-";"-";"-"
"09 Maj 2024 23:00:56";"Koszty Utrzymania Pozycji";"O2-CV-90MEWZ";"-";"-";"Solana (USD)";"-";"-";"-";"-";"-";"-";"-";"-";"-";"-";"-";"-";"15 030,50";"-27,50000%";"-45,26";"-45,26";"-";"-";"-";"-";"-";"-";"-";"-";"-";"-";"-";"-";"-";"-";"-";"-";"-";"-"
"09 Maj 2024 23:00:56";"Koszty Utrzymania Pozycji";"O2-CV-90L0DG";"-";"-";"Solana (USD)";"-";"-";"-";"-";"-";"-";"-";"-";"-";"-";"-";"-";"13 527,45";"-27,50000%";"-40,74";"-40,74";"-";"-";"-";"-";"-";"-";"-";"-";"-";"-";"-";"-";"-";"-";"-";"-";"-";"-"
"09 Maj 2024 23:00:56";"Koszty Utrzymania Pozycji";"O2-CV-90MB7Y";"-";"-";"Solana (USD)";"-";"-";"-";"-";"-";"-";"-";"-";"-";"-";"-";"-";"7 515,25";"-10,00000%";"8,15";"8,15";"-";"-";"-";"-";"-";"-";"-";"-";"-";"-";"-";"-";"-";"-";"-";"-";"-";"-"
"09 Maj 2024 23:00:56";"Koszty Utrzymania Pozycji";"O2-CV-90PZ53";"-";"-";"Solana (USD)";"-";"-";"-";"-";"-";"-";"-";"-";"-";"-";"-";"-";"6 763,72";"-10,00000%";"7,33";"7,33";"-";"-";"-";"-";"-";"-";"-";"-";"-";"-";"-";"-";"-";"-";"-";"-";"-";"-"
"09 Maj 2024 00:11:04";"Transakcja Sprzedaży";"O2-CV-90PZ53";"T2-CV-5EZX0J";"-";"Solana (USD)";"45 Jednost.";"140,810";"-";"-";"-";"-";"4,021086";"25 479,41";"0,00";"-";"-";"-";"-";"-";"-";"-";"-";"-";"-";"-";"-";"-";"-";"-";"-";"-";"-";"-";"-";"-";"-";"-";"-";"-"
"09 Maj 2024 00:10:28";"Transakcja Sprzedaży";"O2-CV-90PZ4X";"T2-CV-5EZX0F";"-";"Solana (USD)";"50 Jednost.";"140,900";"-";"-";"-";"-";"4,021046";"28 328,26";"0,00";"-";"-";"-";"-";"-";"-";"-";"-";"-";"-";"-";"-";"-";"-";"-";"-";"-";"-";"-";"-";"-";"-";"-";"-";"-"
"08 Maj 2024 23:26:01";" Zamknięcie Transakcji";"O2-CV-90PYRN";"T2-CV-5EZWRM";"O2-CV-90PY1Y";"Solana (USD)";"50 Jednost.";"141,605";"-";"-";"-";"-";"3,98361";"28 488,38";"186,03";"41 260,70";"-";"-";"-";"-";"-";"-";"-";"-";"-";"-";"-";"-";"-";"-";"-";"-";"-";"-";"-";"-";"-";"-";"-";"-"
"08 Maj 2024 23:25:53";" Zamknięcie Transakcji";"O2-CV-90PYRL";"T2-CV-5EZWRL";"O2-CV-90PY29";"Solana (USD)";"45 Jednost.";"141,555";"-";"-";"-";"-";"3,98276";"25 625,06";"119,18";"41 074,67";"-";"-";"-";"-";"-";"-";"-";"-";"-";"-";"-";"-";"-";"-";"-";"-";"-";"-";"-";"-";"-";"-";"-";"-"
"08 Maj 2024 23:00:53";"Koszty Utrzymania Pozycji";"1334461469";"-";"-";"Rachunek";"-";"-";"-";"-";"-";"-";"-";"-";"-58,43";"40 955,49";"-";"-";"-";"-";"-";"-58,43";"-";"-";"-";"-";"-";"-";"-";"-";"-";"-";"-";"-";"-";"-";"-";"-";"-";"-"
"08 Maj 2024 23:00:53";"Koszty Utrzymania Pozycji";"O2-CV-90PY1Y";"-";"-";"Solana (USD)";"-";"-";"-";"-";"-";"-";"-";"-";"-";"-";"-";"-";"7 055,00";"-10,00000%";"7,70";"7,70";"-";"-";"-";"-";"-";"-";"-";"-";"-";"-";"-";"-";"-";"-";"-";"-";"-";"-"
"08 Maj 2024 23:00:53";"Koszty Utrzymania Pozycji";"O2-CV-90PY29";"-";"-";"Solana (USD)";"-";"-";"-";"-";"-";"-";"-";"-";"-";"-";"-";"-";"6 349,50";"-10,00000%";"6,93";"6,93";"-";"-";"-";"-";"-";"-";"-";"-";"-";"-";"-";"-";"-";"-";"-";"-";"-";"-"
"08 Maj 2024 23:00:53";"Koszty Utrzymania Pozycji";"O2-CV-90PYCZ";"-";"-";"Solana (USD)";"-";"-";"-";"-";"-";"-";"-";"-";"-";"-";"-";"-";"282,20";"-10,00000%";"0,31";"0,31";"-";"-";"-";"-";"-";"-";"-";"-";"-";"-";"-";"-";"-";"-";"-";"-";"-";"-"
"08 Maj 2024 23:00:53";"Koszty Utrzymania Pozycji";"O2-CV-909KF0";"-";"-";"Solana (USD)";"-";"-";"-";"-";"-";"-";"-";"-";"-";"-";"-";"-";"19 754,00";"-10,00000%";"21,55";"21,55";"-";"-";"-";"-";"-";"-";"-";"-";"-";"-";"-";"-";"-";"-";"-";"-";"-";"-"
"08 Maj 2024 23:00:53";"Koszty Utrzymania Pozycji";"O2-CR-8Z7P36";"-";"-";"Solana (USD)";"-";"-";"-";"-";"-";"-";"-";"-";"-";"-";"-";"-";"7 055,00";"-27,50000%";"-21,38";"-21,38";"-";"-";"-";"-";"-";"-";"-";"-";"-";"-";"-";"-";"-";"-";"-";"-";"-";"-"
"08 Maj 2024 23:00:53";"Koszty Utrzymania Pozycji";"O2-CV-90MEWZ";"-";"-";"Solana (USD)";"-";"-";"-";"-";"-";"-";"-";"-";"-";"-";"-";"-";"14 110,00";"-27,50000%";"-42,76";"-42,76";"-";"-";"-";"-";"-";"-";"-";"-";"-";"-";"-";"-";"-";"-";"-";"-";"-";"-"
"08 Maj 2024 23:00:53";"Koszty Utrzymania Pozycji";"O2-CV-90L0DG";"-";"-";"Solana (USD)";"-";"-";"-";"-";"-";"-";"-";"-";"-";"-";"-";"-";"12 699,00";"-27,50000%";"-38,48";"-38,48";"-";"-";"-";"-";"-";"-";"-";"-";"-";"-";"-";"-";"-";"-";"-";"-";"-";"-"
"08 Maj 2024 23:00:53";"Koszty Utrzymania Pozycji";"O2-CV-90MB7Y";"-";"-";"Solana (USD)";"-";"-";"-";"-";"-";"-";"-";"-";"-";"-";"-";"-";"7 055,00";"-10,00000%";"7,70";"7,70";"-";"-";"-";"-";"-";"-";"-";"-";"-";"-";"-";"-";"-";"-";"-";"-";"-";"-"
"08 Maj 2024 22:51:28";"Transakcja Sprzedaży";"O2-CV-90PYCZ";"T2-CV-5EZWFY";"-";"Solana (USD)";"2 Jednost.";"140,815";"-";"-";"-";"-";"4,022799";"1 132,94";"0,00";"-";"-";"-";"-";"-";"-";"-";"-";"-";"-";"-";"-";"-";"-";"-";"-";"-";"-";"-";"-";"-";"-";"-";"-";"-"
"08 Maj 2024 22:24:04";"Transakcja Sprzedaży";"O2-CV-90PY29";"T2-CV-5EZW9C";"-";"Solana (USD)";"45 Jednost.";"142,220";"-";"-";"-";"-";"4,023961";"25 752,94";"0,00";"-";"-";"-";"-";"-";"-";"-";"-";"-";"-";"-";"-";"-";"-";"-";"-";"-";"-";"-";"-";"-";"-";"-";"-";"-"
"08 Maj 2024 22:22:36";"Transakcja Sprzedaży";"O2-CV-90PY1Y";"T2-CV-5EZW8W";"-";"Solana (USD)";"50 Jednost.";"142,539";"-";"-";"-";"-";"4,024112";"28 679,64";"0,00";"-";"-";"-";"-";"-";"-";"-";"-";"-";"-";"-";"-";"-";"-";"-";"-";"-";"-";"-";"-";"-";"-";"-";"-";"-"
"08 Maj 2024 21:33:41";" Zamknięcie Transakcji";"O2-CV-90PWEQ";"T2-CV-5EZTL6";"O2-CV-90NZTW";"Solana (USD)";"50 Jednost.";"145,645";"-";"-";"-";"-";"3,98281";"29 295,31";"58,75";"41 013,92";"-";"-";"-";"-";"-";"-";"-";"-";"-";"-";"-";"-";"-";"-";"-";"-";"-";"-";"-";"-";"-";"-";"-";"-"
"08 Maj 2024 21:33:34";" Zamknięcie Transakcji";"O2-CV-90PWEH";"T2-CV-5EZTL3";"O2-CV-90P06C";"Solana (USD)";"45 Jednost.";"145,640";"-";"-";"-";"-";"3,98281";"26 364,88";"39,43";"40 955,17";"-";"-";"-";"-";"-";"-";"-";"-";"-";"-";"-";"-";"-";"-";"-";"-";"-";"-";"-";"-";"-";"-";"-";"-"
"08 Maj 2024 20:27:16";"Take Profit";"O2-CV-90PCLK";"T2-CV-5EZRBZ";"-";"Solana (USD)";"90 Jednost.";"148,700";"-";"-";"-";"-";"3,98272";"53 836,44";"100,36";"40 915,74";"-";"-";"-";"-";"-";"-";"-";"-";"-";"-";"-";"-";"-";"-";"-";"-";"-";"-";"-";"-";"-";"-";"-";"-"
"08 Maj 2024 17:09:39";"Odrzucono Zlecenie: brak wystarczających środków";"O2-CV-90PH1X";"-";"-";"Solana (USD)";"90 Jednost.";"-";"-";"-";"-";"-";"-";"-";"-";"-";"-";"-";"-";"-";"-";"-";"-";"-";"-";"-";"-";"-";"-";"-";"-";"-";"-";"-";"-";"-";"-";"-";"-";"-"
"08 Maj 2024 17:07:13";" Zmodyfikowano Transakcję Kupna";"O2-CV-90PCLK";"T2-CV-5EZCZS";"-";"Solana (USD)";"90 Jednost.";"148,420";"-";"-";"148,700";"-";"-";"-";"0,00";"-";"-";"-";"-";"-";"-";"-";"-";"-";"-";"-";"-";"-";"-";"-";"-";"-";"-";"-";"-";"-";"-";"-";"-";"-"
"08 Maj 2024 16:24:52";" Transakcja Kupna";"O2-CV-90PCLK";"T2-CV-5EZCZS";"-";"Solana (USD)";"90 Jednost.";"148,420";"-";"-";"-";"-";"4,020124";"53 700,01";"0,00";"-";"-";"-";"-";"-";"-";"-";"-";"-";"-";"-";"-";"-";"-";"-";"-";"-";"-";"-";"-";"-";"-";"-";"-";"-"
"08 Maj 2024 14:17:39";"Transakcja Sprzedaży";"O2-CV-90P06C";"T2-CV-5EZ1MT";"-";"Solana (USD)";"45 Jednost.";"145,860";"-";"-";"-";"-";"4,030675";"26 456,14";"0,00";"-";"-";"-";"-";"-";"-";"-";"-";"-";"-";"-";"-";"-";"-";"-";"-";"-";"-";"-";"-";"-";"-";"-";"-";"-"
"08 Maj 2024 14:15:54";" Zamknięcie Transakcji";"O2-CV-90P022";"T2-CV-5EZ1JE";"O2-CV-90NZZ9";"Solana (USD)";"46 Jednost.";"145,905";"-";"-";"-";"-";"4,030515";"27 051,32";"-57,48";"40 815,38";"-";"-";"-";"-";"-";"-";"-";"-";"-";"-";"-";"-";"-";"-";"-";"-";"-";"-";"-";"-";"-";"-";"-";"-"
"08 Maj 2024 14:15:14";" Transakcja Kupna";"O2-CV-90NZZ9";"T2-CV-5EZ1FN";"-";"Solana (USD)";"46 Jednost.";"146,215";"-";"-";"-";"-";"4,030775";"27 110,54";"0,00";"-";"-";"-";"-";"-";"-";"-";"-";"-";"-";"-";"-";"-";"-";"-";"-";"-";"-";"-";"-";"-";"-";"-";"-";"-"
"08 Maj 2024 14:14:06";"Transakcja Sprzedaży";"O2-CV-90NZTW";"T2-CV-5EZ19K";"-";"Solana (USD)";"50 Jednost.";"145,940";"-";"-";"-";"-";"4,030955";"29 413,87";"0,00";"-";"-";"-";"-";"-";"-";"-";"-";"-";"-";"-";"-";"-";"-";"-";"-";"-";"-";"-";"-";"-";"-";"-";"-";"-"
"08 Maj 2024 13:40:33";" Zamknięcie Transakcji";"O2-CV-90NY3F";"T2-CV-5EYZTD";"O2-CV-90NVX7";"Solana (USD)";"50 Jednost.";"145,820";"-";"-";"-";"-";"3,98977";"29 381,80";"107,72";"40 872,86";"-";"-";"-";"-";"-";"-";"-";"-";"-";"-";"-";"-";"-";"-";"-";"-";"-";"-";"-";"-";"-";"-";"-";"-"
"08 Maj 2024 13:40:26";" Zamknięcie Transakcji";"O2-CV-90NY3C";"T2-CV-5EYZT6";"O2-CV-90NWJ2";"Solana (USD)";"45 Jednost.";"145,815";"-";"-";"-";"-";"3,98978";"26 442,78";"39,50";"40 765,14";"-";"-";"-";"-";"-";"-";"-";"-";"-";"-";"-";"-";"-";"-";"-";"-";"-";"-";"-";"-";"-";"-";"-";"-"
"08 Maj 2024 13:09:18";"Transakcja Sprzedaży";"O2-CV-90NWJ2";"T2-CV-5EYYFY";"-";"Solana (USD)";"45 Jednost.";"146,035";"-";"-";"-";"-";"4,026106";"26 457,85";"0,00";"-";"-";"-";"-";"-";"-";"-";"-";"-";"-";"-";"-";"-";"-";"-";"-";"-";"-";"-";"-";"-";"-";"-";"-";"-"
"08 Maj 2024 13:02:00";"Transakcja Sprzedaży";"O2-CV-90NVX7";"T2-CV-5EYXZB";"-";"Solana (USD)";"50 Jednost.";"146,360";"-";"-";"-";"-";"4,026857";"29 468,53";"0,00";"-";"-";"-";"-";"-";"-";"-";"-";"-";"-";"-";"-";"-";"-";"-";"-";"-";"-";"-";"-";"-";"-";"-";"-";"-"
"08 Maj 2024 11:51:13";"Stop Loss";"O2-CV-90NH8D";"T2-CV-5EYVGT";"-";"Solana (USD)";"20 Jednost.";"145,800";"-";"-";"-";"-";"3,99293";"11 760,40";"51,11";"40 725,64";"-";"-";"-";"-";"-";"-";"-";"-";"-";"-";"-";"-";"-";"-";"-";"-";"-";"-";"-";"-";"-";"-";"-";"-"
"08 Maj 2024 11:51:13";"Stop Loss";"O2-CV-90NH6S";"T2-CV-5EYVGS";"-";"Solana (USD)";"25 Jednost.";"145,800";"-";"-";"-";"-";"3,99293";"14 700,50";"64,89";"40 674,53";"-";"-";"-";"-";"-";"-";"-";"-";"-";"-";"-";"-";"-";"-";"-";"-";"-";"-";"-";"-";"-";"-";"-";"-"
"08 Maj 2024 11:51:13";"Stop Loss";"O2-CV-90NH2Y";"T2-CV-5EYVGR";"-";"Solana (USD)";"50 Jednost.";"145,800";"-";"-";"-";"-";"3,99293";"29 401,00";"218,61";"40 609,64";"-";"-";"-";"-";"-";"-";"-";"-";"-";"-";"-";"-";"-";"-";"-";"-";"-";"-";"-";"-";"-";"-";"-";"-"
"08 Maj 2024 11:37:57";"Zmodyfikowano Transakcję Sprzedaży";"O2-CV-90NH8D";"T2-CV-5EYLNM";"-";"Solana (USD)";"20 Jednost.";"146,440";"-";"145,800";"-";"-";"-";"-";"0,00";"-";"-";"-";"-";"-";"-";"-";"-";"-";"-";"-";"-";"-";"-";"-";"-";"-";"-";"-";"-";"-";"-";"-";"-";"-"
"08 Maj 2024 11:37:36";"Zmodyfikowano Transakcję Sprzedaży";"O2-CV-90NH6S";"T2-CV-5EYLMC";"-";"Solana (USD)";"25 Jednost.";"146,450";"-";"145,800";"-";"-";"-";"-";"0,00";"-";"-";"-";"-";"-";"-";"-";"-";"-";"-";"-";"-";"-";"-";"-";"-";"-";"-";"-";"-";"-";"-";"-";"-";"-"
"08 Maj 2024 11:37:04";"Zmodyfikowano Transakcję Sprzedaży";"O2-CV-90NH2Y";"T2-CV-5EYLHV";"-";"Solana (USD)";"50 Jednost.";"146,895";"-";"145,800";"-";"-";"-";"-";"0,00";"-";"-";"-";"-";"-";"-";"-";"-";"-";"-";"-";"-";"-";"-";"-";"-";"-";"-";"-";"-";"-";"-";"-";"-";"-"
"08 Maj 2024 09:21:59";"Transakcja Sprzedaży";"O2-CV-90NH8D";"T2-CV-5EYLNM";"-";"Solana (USD)";"20 Jednost.";"146,440";"-";"-";"-";"-";"4,033591";"11 813,58";"0,00";"-";"-";"-";"-";"-";"-";"-";"-";"-";"-";"-";"-";"-";"-";"-";"-";"-";"-";"-";"-";"-";"-";"-";"-";"-"
"08 Maj 2024 09:21:13";"Transakcja Sprzedaży";"O2-CV-90NH6S";"T2-CV-5EYLMC";"-";"Solana (USD)";"25 Jednost.";"146,450";"-";"-";"-";"-";"4,033991";"14 769,44";"0,00";"-";"-";"-";"-";"-";"-";"-";"-";"-";"-";"-";"-";"-";"-";"-";"-";"-";"-";"-";"-";"-";"-";"-";"-";"-"
"08 Maj 2024 09:19:20";"Transakcja Sprzedaży";"O2-CV-90NH2Y";"T2-CV-5EYLHV";"-";"Solana (USD)";"50 Jednost.";"146,895";"-";"-";"-";"-";"4,034462";"29 632,11";"0,00";"-";"-";"-";"-";"-";"-";"-";"-";"-";"-";"-";"-";"-";"-";"-";"-";"-";"-";"-";"-";"-";"-";"-";"-";"-"
"07 Maj 2024 23:00:58";"Koszty Utrzymania Pozycji";"1334050928";"-";"-";"Rachunek";"-";"-";"-";"-";"-";"-";"-";"-";"-78,87";"40 391,03";"-";"-";"-";"-";"-";"-78,87";"-";"-";"-";"-";"-";"-";"-";"-";"-";"-";"-";"-";"-";"-";"-";"-";"-";"-"
"07 Maj 2024 23:00:58";"Koszty Utrzymania Pozycji";"O2-CV-909KF0";"-";"-";"Solana (USD)";"-";"-";"-";"-";"-";"-";"-";"-";"-";"-";"-";"-";"21 194,88";"-10,00000%";"23,16";"23,16";"-";"-";"-";"-";"-";"-";"-";"-";"-";"-";"-";"-";"-";"-";"-";"-";"-";"-"
"07 Maj 2024 23:00:58";"Koszty Utrzymania Pozycji";"O2-CR-8Z7P36";"-";"-";"Solana (USD)";"-";"-";"-";"-";"-";"-";"-";"-";"-";"-";"-";"-";"7 569,60";"-27,50000%";"-22,98";"-22,98";"-";"-";"-";"-";"-";"-";"-";"-";"-";"-";"-";"-";"-";"-";"-";"-";"-";"-"
"07 Maj 2024 23:00:58";"Koszty Utrzymania Pozycji";"O2-CV-90MEWZ";"-";"-";"Solana (USD)";"-";"-";"-";"-";"-";"-";"-";"-";"-";"-";"-";"-";"15 139,20";"-27,50000%";"-45,96";"-45,96";"-";"-";"-";"-";"-";"-";"-";"-";"-";"-";"-";"-";"-";"-";"-";"-";"-";"-"
"07 Maj 2024 23:00:58";"Koszty Utrzymania Pozycji";"O2-CV-90L0DG";"-";"-";"Solana (USD)";"-";"-";"-";"-";"-";"-";"-";"-";"-";"-";"-";"-";"13 625,28";"-27,50000%";"-41,36";"-41,36";"-";"-";"-";"-";"-";"-";"-";"-";"-";"-";"-";"-";"-";"-";"-";"-";"-";"-"
"07 Maj 2024 23:00:58";"Koszty Utrzymania Pozycji";"O2-CV-90MB7Y";"-";"-";"Solana (USD)";"-";"-";"-";"-";"-";"-";"-";"-";"-";"-";"-";"-";"7 569,60";"-10,00000%";"8,27";"8,27";"-";"-";"-";"-";"-";"-";"-";"-";"-";"-";"-";"-";"-";"-";"-";"-";"-";"-"
"07 Maj 2024 17:44:52";" Zmodyfikowano Transakcję Kupna";"O2-CV-90MEWZ";"T2-CV-5EXQTK";"-";"Solana (USD)";"100 Jednost.";"156,680";"-";"-";"158,200";"-";"-";"-";"0,00";"-";"-";"-";"-";"-";"-";"-";"-";"-";"-";"-";"-";"-";"-";"-";"-";"-";"-";"-";"-";"-";"-";"-";"-";"-"
"07 Maj 2024 17:02:14";" Transakcja Kupna";"O2-CV-90MEWZ";"T2-CV-5EXQTK";"-";"Solana (USD)";"100 Jednost.";"156,680";"-";"-";"-";"-";"4,014042";"62 892,01";"0,00";"-";"-";"-";"-";"-";"-";"-";"-";"-";"-";"-";"-";"-";"-";"-";"-";"-";"-";"-";"-";"-";"-";"-";"-";"-"
"07 Maj 2024 16:45:04";" Zamknięcie Transakcji";"O2-CV-90MCWM";"T2-CV-5EXNZC";"O2-CV-90M6Q7";"Solana (USD)";"50 Jednost.";"153,565";"-";"-";"-";"-";"3,97487";"30 826,73";"1,99";"40 469,90";"-";"-";"-";"-";"-";"-";"-";"-";"-";"-";"-";"-";"-";"-";"-";"-";"-";"-";"-";"-";"-";"-";"-";"-"
"07 Maj 2024 16:26:41";"Transakcja Sprzedaży";"O2-CV-90MB7Y";"T2-CV-5EXMH4";"-";"Solana (USD)";"50 Jednost.";"152,750";"-";"-";"-";"-";"4,015404";"30 667,64";"0,00";"-";"-";"-";"-";"-";"-";"-";"-";"-";"-";"-";"-";"-";"-";"-";"-";"-";"-";"-";"-";"-";"-";"-";"-";"-"
"07 Maj 2024 15:53:54";" Transakcja Kupna";"O2-CV-90M6Q7";"T2-CV-5EXJHB";"-";"Solana (USD)";"50 Jednost.";"153,555";"-";"-";"-";"-";"4,01801";"30 849,27";"0,00";"-";"-";"-";"-";"-";"-";"-";"-";"-";"-";"-";"-";"-";"-";"-";"-";"-";"-";"-";"-";"-";"-";"-";"-";"-"
"07 Maj 2024 15:53:12";" Zamknięcie Transakcji";"O2-CV-90M6LV";"T2-CV-5EXJEN";"O2-CV-90LMQ2";"Solana (USD)";"2,5 Jednost.";"153,380";"-";"-";"-";"-";"3,97858";"1 540,92";"47,65";"40 467,91";"-";"-";"-";"-";"-";"-";"-";"-";"-";"-";"-";"-";"-";"-";"-";"-";"-";"-";"-";"-";"-";"-";"-";"-"
"07 Maj 2024 15:53:05";" Zamknięcie Transakcji";"O2-CV-90M6LB";"T2-CV-5EXJE2";"O2-CV-90LKHV";"Solana (USD)";"25 Jednost.";"153,355";"-";"-";"-";"-";"3,97858";"15 406,69";"370,51";"40 420,26";"-";"-";"-";"-";"-";"-";"-";"-";"-";"-";"-";"-";"-";"-";"-";"-";"-";"-";"-";"-";"-";"-";"-";"-"
"07 Maj 2024 15:51:23";"Stop Loss";"O2-CV-90L04H";"T2-CV-5EXJ68";"-";"Solana (USD)";"20 Jednost.";"153,205";"-";"-";"-";"-";"3,97953";"12 316,25";"89,94";"40 049,75";"-";"-";"-";"-";"-";"-";"-";"-";"-";"-";"-";"-";"-";"-";"-";"-";"-";"-";"-";"-";"-";"-";"-";"-"
"07 Maj 2024 15:50:59";"Zmodyfikowano Stop Loss";"O2-CV-90L04H";"-";"O2-CV-90M64K";"Solana (USD)";"20 Jednost.";"154,335";"-";"153,200";"-";"-";"-";"-";"-";"-";"-";"-";"-";"-";"-";"-";"-";"-";"-";"-";"-";"-";"-";"-";"-";"-";"-";"-";"-";"-";"-";"-";"-";"-"
"07 Maj 2024 15:50:26";"Zmodyfikowano Stop Loss";"O2-CV-90L04H";"-";"O2-CV-90M64K";"Solana (USD)";"20 Jednost.";"154,335";"-";"153,600";"-";"-";"-";"-";"-";"-";"-";"-";"-";"-";"-";"-";"-";"-";"-";"-";"-";"-";"-";"-";"-";"-";"-";"-";"-";"-";"-";"-";"-";"-"
"07 Maj 2024 15:50:26";"Zmodyfikowano Transakcję Sprzedaży";"O2-CV-90L04H";"T2-CV-5EWJQM";"-";"Solana (USD)";"20 Jednost.";"154,335";"-";"153,600";"-";"-";"-";"-";"0,00";"-";"-";"-";"-";"-";"-";"-";"-";"-";"-";"-";"-";"-";"-";"-";"-";"-";"-";"-";"-";"-";"-";"-";"-";"-"
"07 Maj 2024 15:49:43";"Zmodyfikowano Transakcję Sprzedaży";"O2-CV-90L04H";"T2-CV-5EWJQM";"-";"Solana (USD)";"20 Jednost.";"154,335";"-";"154,000";"153,000";"-";"-";"-";"0,00";"-";"-";"-";"-";"-";"-";"-";"-";"-";"-";"-";"-";"-";"-";"-";"-";"-";"-";"-";"-";"-";"-";"-";"-";"-"
"07 Maj 2024 13:20:30";"Stop Loss";"O2-CV-90LTK1";"T2-CV-5EX6FV";"-";"Solana (USD)";"95 Jednost.";"156,850";"-";"-";"-";"-";"3,98814";"60 023,35";"126,92";"39 959,81";"-";"-";"-";"-";"-";"-";"-";"-";"-";"-";"-";"-";"-";"-";"-";"-";"-";"-";"-";"-";"-";"-";"-";"-"
"07 Maj 2024 13:20:07";"Zmodyfikowano Stop Loss";"O2-CV-90LTK1";"-";"O2-CV-90LTQ2";"Solana (USD)";"95 Jednost.";"156,515";"-";"156,850";"-";"-";"-";"-";"-";"-";"-";"-";"-";"-";"-";"-";"-";"-";"-";"-";"-";"-";"-";"-";"-";"-";"-";"-";"-";"-";"-";"-";"-";"-"
"07 Maj 2024 13:15:59";"Zmodyfikowano Stop Loss";"O2-CV-90LTK1";"-";"O2-CV-90LTQ2";"Solana (USD)";"95 Jednost.";"156,515";"-";"156,700";"-";"-";"-";"-";"-";"-";"-";"-";"-";"-";"-";"-";"-";"-";"-";"-";"-";"-";"-";"-";"-";"-";"-";"-";"-";"-";"-";"-";"-";"-"
"07 Maj 2024 13:15:34";" Zmodyfikowano Transakcję Kupna";"O2-CV-90LTK1";"T2-CV-5EX660";"-";"Solana (USD)";"95 Jednost.";"156,515";"-";"156,600";"-";"-";"-";"-";"0,00";"-";"-";"-";"-";"-";"-";"-";"-";"-";"-";"-";"-";"-";"-";"-";"-";"-";"-";"-";"-";"-";"-";"-";"-";"-"
"07 Maj 2024 13:11:03";" Transakcja Kupna";"O2-CV-90LTK1";"T2-CV-5EX660";"-";"Solana (USD)";"95 Jednost.";"156,515";"-";"-";"-";"-";"4,026707";"59 872,80";"0,00";"-";"-";"-";"-";"-";"-";"-";"-";"-";"-";"-";"-";"-";"-";"-";"-";"-";"-";"-";"-";"-";"-";"-";"-";"-"
"07 Maj 2024 12:54:57";"Stop Loss";"O2-CV-90LSK2";"T2-CV-5EX5LP";"-";"Solana (USD)";"95 Jednost.";"156,830";"-";"-";"-";"-";"3,98743";"60 005,10";"13,26";"39 832,89";"-";"-";"-";"-";"-";"-";"-";"-";"-";"-";"-";"-";"-";"-";"-";"-";"-";"-";"-";"-";"-";"-";"-";"-"
"07 Maj 2024 12:54:38";" Zmodyfikowano Transakcję Kupna";"O2-CV-90LSK2";"T2-CV-5EX5DB";"-";"Solana (USD)";"95 Jednost.";"156,795";"-";"156,830";"-";"-";"-";"-";"0,00";"-";"-";"-";"-";"-";"-";"-";"-";"-";"-";"-";"-";"-";"-";"-";"-";"-";"-";"-";"-";"-";"-";"-";"-";"-"
"07 Maj 2024 12:48:53";" Transakcja Kupna";"O2-CV-90LSK2";"T2-CV-5EX5DB";"-";"Solana (USD)";"95 Jednost.";"156,795";"-";"-";"-";"-";"4,027118";"59 986,03";"0,00";"-";"-";"-";"-";"-";"-";"-";"-";"-";"-";"-";"-";"-";"-";"-";"-";"-";"-";"-";"-";"-";"-";"-";"-";"-"
"07 Maj 2024 12:38:13";"Zmodyfikowano Transakcję Sprzedaży";"O2-CV-90L04H";"T2-CV-5EWJQM";"-";"Solana (USD)";"20 Jednost.";"154,335";"-";"-";"153,000";"-";"-";"-";"0,00";"-";"-";"-";"-";"-";"-";"-";"-";"-";"-";"-";"-";"-";"-";"-";"-";"-";"-";"-";"-";"-";"-";"-";"-";"-"
"07 Maj 2024 10:57:16";"Transakcja Sprzedaży";"O2-CV-90LMQ2";"T2-CV-5EX1FC";"-";"Solana (USD)";"2,5 Jednost.";"158,171";"-";"-";"-";"-";"4,025505";"1 591,79";"0,00";"-";"-";"-";"-";"-";"-";"-";"-";"-";"-";"-";"-";"-";"-";"-";"-";"-";"-";"-";"-";"-";"-";"-";"-";"-"
"07 Maj 2024 10:20:30";"Transakcja Sprzedaży";"O2-CV-90LKHV";"T2-CV-5EWZJS";"-";"Solana (USD)";"25 Jednost.";"157,080";"-";"-";"-";"-";"4,031116";"15 830,19";"0,00";"-";"-";"-";"-";"-";"-";"-";"-";"-";"-";"-";"-";"-";"-";"-";"-";"-";"-";"-";"-";"-";"-";"-";"-";"-"
"07 Maj 2024 10:20:22";"Odrzucono Zlecenie: brak wystarczających środków";"O2-CV-90LKHP";"-";"-";"Solana (USD)";"30 Jednost.";"-";"-";"-";"-";"-";"-";"-";"-";"-";"-";"-";"-";"-";"-";"-";"-";"-";"-";"-";"-";"-";"-";"-";"-";"-";"-";"-";"-";"-";"-";"-";"-";"-"
"07 Maj 2024 10:20:13";"Odrzucono Zlecenie: brak wystarczających środków";"O2-CV-90LKHF";"-";"-";"Solana (USD)";"50 Jednost.";"-";"-";"-";"-";"-";"-";"-";"-";"-";"-";"-";"-";"-";"-";"-";"-";"-";"-";"-";"-";"-";"-";"-";"-";"-";"-";"-";"-";"-";"-";"-";"-";"-"
"07 Maj 2024 10:18:34";" Zamknięcie Transakcji";"O2-CV-90LKFF";"T2-CV-5EWZHC";"O2-CV-90JR22";"Solana (USD)";"90 Jednost.";"156,730";"-";"-";"-";"-";"3,99147";"56 868,21";"3,23";"39 819,63";"-";"-";"-";"-";"-";"-";"-";"-";"-";"-";"-";"-";"-";"-";"-";"-";"-";"-";"-";"-";"-";"-";"-";"-"
"07 Maj 2024 08:43:29";" Zmodyfikowano Transakcję Kupna";"O2-CV-90JR22";"T2-CV-5EVHJ6";"-";"Solana (USD)";"90 Jednost.";"156,721";"-";"-";"157,000";"-";"-";"-";"0,00";"-";"-";"-";"-";"-";"-";"-";"-";"-";"-";"-";"-";"-";"-";"-";"-";"-";"-";"-";"-";"-";"-";"-";"-";"-"
"07 Maj 2024 01:31:47";" Zamknięcie Transakcji";"O2-CV-90L2KY";"T2-CV-5EWKSG";"O2-CV-90L04H";"Solana (USD)";"10 Jednost.";"153,500";"-";"-";"-";"-";"3,98012";"6 170,89";"33,23";"39 816,40";"-";"-";"-";"-";"-";"-";"-";"-";"-";"-";"-";"-";"-";"-";"-";"-";"-";"-";"-";"-";"-";"-";"-";"-"
"07 Maj 2024 01:28:29";"Zmodyfikowano Transakcję Sprzedaży";"O2-CV-90L04H";"T2-CV-5EWJQM";"-";"Solana (USD)";"30 Jednost.";"154,335";"-";"-";"-";"-";"-";"-";"0,00";"-";"-";"-";"-";"-";"-";"-";"-";"-";"-";"-";"-";"-";"-";"-";"-";"-";"-";"-";"-";"-";"-";"-";"-";"-"
"07 Maj 2024 01:25:12";" Zamknięcie Transakcji";"O2-CV-90L2J4";"T2-CV-5EWKR3";"O2-CV-90L04H";"Solana (USD)";"18 Jednost.";"153,655";"-";"-";"-";"-";"3,98062";"11 120,20";"48,72";"39 783,17";"-";"-";"-";"-";"-";"-";"-";"-";"-";"-";"-";"-";"-";"-";"-";"-";"-";"-";"-";"-";"-";"-";"-";"-"
"06 Maj 2024 23:49:50";"Odrzucono Zlecenie: brak wystarczających środków";"O2-CV-90L0HK";"-";"-";"Solana (USD)";"48 Jednost.";"-";"-";"-";"-";"-";"-";"-";"-";"-";"-";"-";"-";"-";"-";"-";"-";"-";"-";"-";"-";"-";"-";"-";"-";"-";"-";"-";"-";"-";"-";"-";"-";"-"
"06 Maj 2024 23:41:21";"Zmodyfikowano Take Profit";"O2-CV-90L04H";"-";"O2-CV-90L0CQ";"Solana (USD)";"48 Jednost.";"154,335";"-";"-";"151,600";"-";"-";"-";"-";"-";"-";"-";"-";"-";"-";"-";"-";"-";"-";"-";"-";"-";"-";"-";"-";"-";"-";"-";"-";"-";"-";"-";"-";"-"
"06 Maj 2024 23:19:15";" Transakcja Kupna";"O2-CV-90L0DG";"T2-CV-5EWJXP";"-";"Solana (USD)";"90 Jednost.";"155,525";"-";"-";"-";"-";"4,020976";"56 282,60";"0,00";"-";"-";"-";"-";"-";"-";"-";"-";"-";"-";"-";"-";"-";"-";"-";"-";"-";"-";"-";"-";"-";"-";"-";"-";"-"
"06 Maj 2024 23:15:16";"Zmodyfikowano Transakcję Sprzedaży";"O2-CV-90L04H";"T2-CV-5EWJQM";"-";"Solana (USD)";"48 Jednost.";"154,335";"-";"-";"152,000";"-";"-";"-";"0,00";"-";"-";"-";"-";"-";"-";"-";"-";"-";"-";"-";"-";"-";"-";"-";"-";"-";"-";"-";"-";"-";"-";"-";"-";"-"
"06 Maj 2024 23:00:54";"Koszty Utrzymania Pozycji";"1333650070";"-";"-";"Rachunek";"-";"-";"-";"-";"-";"-";"-";"-";"-33,84";"39 734,45";"-";"-";"-";"-";"-";"-33,84";"-";"-";"-";"-";"-";"-";"-";"-";"-";"-";"-";"-";"-";"-";"-";"-";"-";"-"
"06 Maj 2024 23:00:54";"Koszty Utrzymania Pozycji";"O2-CV-909KF0";"-";"-";"Solana (USD)";"-";"-";"-";"-";"-";"-";"-";"-";"-";"-";"-";"-";"21 627,20";"-10,00000%";"23,59";"23,59";"-";"-";"-";"-";"-";"-";"-";"-";"-";"-";"-";"-";"-";"-";"-";"-";"-";"-"
"06 Maj 2024 23:00:54";"Koszty Utrzymania Pozycji";"O2-CR-8Z7P36";"-";"-";"Solana (USD)";"-";"-";"-";"-";"-";"-";"-";"-";"-";"-";"-";"-";"7 724,00";"-27,50000%";"-23,40";"-23,40";"-";"-";"-";"-";"-";"-";"-";"-";"-";"-";"-";"-";"-";"-";"-";"-";"-";"-"
"06 Maj 2024 23:00:54";"Koszty Utrzymania Pozycji";"O2-CV-90L04H";"-";"-";"Solana (USD)";"-";"-";"-";"-";"-";"-";"-";"-";"-";"-";"-";"-";"7 415,04";"-10,00000%";"8,09";"8,09";"-";"-";"-";"-";"-";"-";"-";"-";"-";"-";"-";"-";"-";"-";"-";"-";"-";"-"
"06 Maj 2024 23:00:54";"Koszty Utrzymania Pozycji";"O2-CV-90JR22";"-";"-";"Solana (USD)";"-";"-";"-";"-";"-";"-";"-";"-";"-";"-";"-";"-";"13 903,20";"-27,50000%";"-42,12";"-42,12";"-";"-";"-";"-";"-";"-";"-";"-";"-";"-";"-";"-";"-";"-";"-";"-";"-";"-"
"06 Maj 2024 22:47:33";"Transakcja Sprzedaży";"O2-CV-90L04H";"T2-CV-5EWJQM";"-";"Solana (USD)";"48 Jednost.";"154,335";"-";"-";"-";"-";"4,019763";"29 778,72";"0,00";"-";"-";"-";"-";"-";"-";"-";"-";"-";"-";"-";"-";"-";"-";"-";"-";"-";"-";"-";"-";"-";"-";"-";"-";"-"
"06 Maj 2024 22:31:50";"Stop Loss";"O2-CV-90KGYQ";"T2-CV-5EWJLP";"-";"Solana (USD)";"48 Jednost.";"154,790";"-";"-";"-";"-";"3,98027";"29 870,38";"179,59";"39 768,29";"-";"-";"-";"-";"-";"-";"-";"-";"-";"-";"-";"-";"-";"-";"-";"-";"-";"-";"-";"-";"-";"-";"-";"-"
"06 Maj 2024 22:31:28";"Zmodyfikowano Stop Loss";"O2-CV-90KGYQ";"-";"O2-CV-90KZXT";"Solana (USD)";"48 Jednost.";"153,850";"-";"154,800";"-";"-";"-";"-";"-";"-";"-";"-";"-";"-";"-";"-";"-";"-";"-";"-";"-";"-";"-";"-";"-";"-";"-";"-";"-";"-";"-";"-";"-";"-"
"06 Maj 2024 22:30:28";"Zmodyfikowano Stop Loss";"O2-CV-90KGYQ";"-";"O2-CV-90KZXT";"Solana (USD)";"48 Jednost.";"153,850";"-";"154,600";"-";"-";"-";"-";"-";"-";"-";"-";"-";"-";"-";"-";"-";"-";"-";"-";"-";"-";"-";"-";"-";"-";"-";"-";"-";"-";"-";"-";"-";"-"
"06 Maj 2024 22:29:43";"Zmodyfikowano Stop Loss";"O2-CV-90KGYQ";"-";"O2-CV-90KZXT";"Solana (USD)";"48 Jednost.";"153,850";"-";"154,400";"-";"-";"-";"-";"-";"-";"-";"-";"-";"-";"-";"-";"-";"-";"-";"-";"-";"-";"-";"-";"-";"-";"-";"-";"-";"-";"-";"-";"-";"-"
"06 Maj 2024 22:27:50";" Zmodyfikowano Transakcję Kupna";"O2-CV-90KGYQ";"T2-CV-5EW3SE";"-";"Solana (USD)";"48 Jednost.";"153,850";"-";"154,100";"-";"-";"-";"-";"0,00";"-";"-";"-";"-";"-";"-";"-";"-";"-";"-";"-";"-";"-";"-";"-";"-";"-";"-";"-";"-";"-";"-";"-";"-";"-"
"06 Maj 2024 19:45:32";"Stop Loss";"O2-CV-90KQDY";"T2-CV-5EWBB3";"-";"Solana (USD)";"80 Jednost.";"151,250";"-";"-";"-";"-";"3,977";"48 605,43";"17,50";"39 588,70";"-";"-";"-";"-";"-";"-";"-";"-";"-";"-";"-";"-";"-";"-";"-";"-";"-";"-";"-";"-";"-";"-";"-";"-"
"06 Maj 2024 19:42:29";"Zmodyfikowano Transakcję Sprzedaży";"O2-CV-90KQDY";"T2-CV-5EW9VB";"-";"Solana (USD)";"80 Jednost.";"151,305";"-";"151,250";"-";"-";"-";"-";"0,00";"-";"-";"-";"-";"-";"-";"-";"-";"-";"-";"-";"-";"-";"-";"-";"-";"-";"-";"-";"-";"-";"-";"-";"-";"-"
"06 Maj 2024 19:35:09";"Transakcja Sprzedaży";"O2-CV-90KQDY";"T2-CV-5EW9VB";"-";"Solana (USD)";"80 Jednost.";"151,305";"-";"-";"-";"-";"4,01801";"48 635,60";"0,00";"-";"-";"-";"-";"-";"-";"-";"-";"-";"-";"-";"-";"-";"-";"-";"-";"-";"-";"-";"-";"-";"-";"-";"-";"-"
"06 Maj 2024 17:42:38";" Transakcja Kupna";"O2-CV-90KGYQ";"T2-CV-5EW3SE";"-";"Solana (USD)";"48 Jednost.";"153,850";"-";"-";"-";"-";"4,016837";"29 663,53";"0,00";"-";"-";"-";"-";"-";"-";"-";"-";"-";"-";"-";"-";"-";"-";"-";"-";"-";"-";"-";"-";"-";"-";"-";"-";"-"
"06 Maj 2024 17:20:31";"Stop Loss";"O2-CV-90KENC";"T2-CV-5EW2JD";"-";"Solana (USD)";"8 Jednost.";"153,000";"-";"-";"-";"-";"3,978";"4 917,99";"23,71";"39 571,20";"-";"-";"-";"-";"-";"-";"-";"-";"-";"-";"-";"-";"-";"-";"-";"-";"-";"-";"-";"-";"-";"-";"-";"-"
"06 Maj 2024 17:20:31";"Stop Loss";"O2-CV-90KE4G";"T2-CV-5EW2JC";"-";"Solana (USD)";"40 Jednost.";"153,000";"-";"-";"-";"-";"3,978";"24 589,97";"10,18";"39 547,49";"-";"-";"-";"-";"-";"-";"-";"-";"-";"-";"-";"-";"-";"-";"-";"-";"-";"-";"-";"-";"-";"-";"-";"-"
"06 Maj 2024 17:18:51";" Zmodyfikowano Transakcję Kupna";"O2-CV-90KENC";"T2-CV-5EW1YS";"-";"Solana (USD)";"8 Jednost.";"152,255";"-";"153,000";"-";"-";"-";"-";"0,00";"-";"-";"-";"-";"-";"-";"-";"-";"-";"-";"-";"-";"-";"-";"-";"-";"-";"-";"-";"-";"-";"-";"-";"-";"-"
"06 Maj 2024 17:18:36";" Zmodyfikowano Transakcję Kupna";"O2-CV-90KE4G";"T2-CV-5EW1H3";"-";"Solana (USD)";"40 Jednost.";"152,936";"-";"153,000";"-";"-";"-";"-";"0,00";"-";"-";"-";"-";"-";"-";"-";"-";"-";"-";"-";"-";"-";"-";"-";"-";"-";"-";"-";"-";"-";"-";"-";"-";"-"
"06 Maj 2024 17:10:21";" Transakcja Kupna";"O2-CV-90KENC";"T2-CV-5EW1YS";"-";"Solana (USD)";"8 Jednost.";"152,255";"-";"-";"-";"-";"4,016256";"4 891,96";"0,00";"-";"-";"-";"-";"-";"-";"-";"-";"-";"-";"-";"-";"-";"-";"-";"-";"-";"-";"-";"-";"-";"-";"-";"-";"-"
"06 Maj 2024 17:03:27";" Transakcja Kupna";"O2-CV-90KE4G";"T2-CV-5EW1H3";"-";"Solana (USD)";"40 Jednost.";"152,936";"-";"-";"-";"-";"4,016487";"24 570,61";"0,00";"-";"-";"-";"-";"-";"-";"-";"-";"-";"-";"-";"-";"-";"-";"-";"-";"-";"-";"-";"-";"-";"-";"-";"-";"-"
"06 Maj 2024 17:03:16";"Odrzucono Zlecenie: brak wystarczających środków";"O2-CV-90KE3W";"-";"-";"Solana (USD)";"50 Jednost.";"-";"-";"-";"-";"-";"-";"-";"-";"-";"-";"-";"-";"-";"-";"-";"-";"-";"-";"-";"-";"-";"-";"-";"-";"-";"-";"-";"-";"-";"-";"-";"-";"-"
"06 Maj 2024 16:58:45";"Stop Loss";"O2-CV-90KCFK";"T2-CV-5EW10V";"-";"Solana (USD)";"40 Jednost.";"152,906";"-";"-";"-";"-";"3,97495";"24 556,04";"167,58";"39 537,31";"-";"-";"-";"-";"-";"-";"-";"-";"-";"-";"-";"-";"-";"-";"-";"-";"-";"-";"-";"-";"-";"-";"-";"-"
"06 Maj 2024 16:58:44";"Zmodyfikowano Stop Loss";"O2-CV-90KCFK";"-";"O2-CV-90KDLK";"Solana (USD)";"40 Jednost.";"153,960";"-";"152,900";"-";"-";"-";"-";"-";"-";"-";"-";"-";"-";"-";"-";"-";"-";"-";"-";"-";"-";"-";"-";"-";"-";"-";"-";"-";"-";"-";"-";"-";"-"
"06 Maj 2024 16:58:09";"Zmodyfikowano Stop Loss";"O2-CV-90KCFK";"-";"O2-CV-90KDLK";"Solana (USD)";"40 Jednost.";"153,960";"-";"153,200";"-";"-";"-";"-";"-";"-";"-";"-";"-";"-";"-";"-";"-";"-";"-";"-";"-";"-";"-";"-";"-";"-";"-";"-";"-";"-";"-";"-";"-";"-"
"06 Maj 2024 16:57:36";"Zmodyfikowano Stop Loss";"O2-CV-90KCFK";"-";"O2-CV-90KDLK";"Solana (USD)";"40 Jednost.";"153,960";"-";"153,500";"-";"-";"-";"-";"-";"-";"-";"-";"-";"-";"-";"-";"-";"-";"-";"-";"-";"-";"-";"-";"-";"-";"-";"-";"-";"-";"-";"-";"-";"-"
"06 Maj 2024 16:57:14";"Zmodyfikowano Stop Loss";"O2-CV-90KCFK";"-";"O2-CV-90KDLK";"Solana (USD)";"40 Jednost.";"153,960";"-";"153,700";"-";"-";"-";"-";"-";"-";"-";"-";"-";"-";"-";"-";"-";"-";"-";"-";"-";"-";"-";"-";"-";"-";"-";"-";"-";"-";"-";"-";"-";"-"
"06 Maj 2024 16:56:28";"Zmodyfikowano Transakcję Sprzedaży";"O2-CV-90KCFK";"T2-CV-5EVZZ1";"-";"Solana (USD)";"40 Jednost.";"153,960";"-";"153,800";"-";"-";"-";"-";"0,00";"-";"-";"-";"-";"-";"-";"-";"-";"-";"-";"-";"-";"-";"-";"-";"-";"-";"-";"-";"-";"-";"-";"-";"-";"-"
"06 Maj 2024 16:44:09";"Transakcja Sprzedaży";"O2-CV-90KCFK";"T2-CV-5EVZZ1";"-";"Solana (USD)";"40 Jednost.";"153,960";"-";"-";"-";"-";"4,016657";"24 736,18";"0,00";"-";"-";"-";"-";"-";"-";"-";"-";"-";"-";"-";"-";"-";"-";"-";"-";"-";"-";"-";"-";"-";"-";"-";"-";"-"
"06 Maj 2024 15:41:08";"Stop Loss";"O2-CV-90K23L";"T2-CV-5EVTFD";"-";"Solana (USD)";"6 Jednost.";"153,494";"-";"-";"-";"-";"3,97714";"3 699,61";"54,14";"39 369,73";"-";"-";"-";"-";"-";"-";"-";"-";"-";"-";"-";"-";"-";"-";"-";"-";"-";"-";"-";"-";"-";"-";"-";"-"
"06 Maj 2024 15:41:08";"Stop Loss";"O2-CV-90K1P8";"T2-CV-5EVTFC";"-";"Solana (USD)";"40 Jednost.";"153,494";"-";"-";"-";"-";"3,97714";"24 664,07";"228,92";"39 315,59";"-";"-";"-";"-";"-";"-";"-";"-";"-";"-";"-";"-";"-";"-";"-";"-";"-";"-";"-";"-";"-";"-";"-";"-"
"06 Maj 2024 15:39:11";"Zmodyfikowano Stop Loss";"O2-CV-90K23L";"-";"O2-CV-90K43W";"Solana (USD)";"6 Jednost.";"151,225";"-";"153,500";"-";"-";"-";"-";"-";"-";"-";"-";"-";"-";"-";"-";"-";"-";"-";"-";"-";"-";"-";"-";"-";"-";"-";"-";"-";"-";"-";"-";"-";"-"
"06 Maj 2024 15:39:00";"Zmodyfikowano Stop Loss";"O2-CV-90K1P8";"-";"O2-CV-90K424";"Solana (USD)";"40 Jednost.";"152,055";"-";"153,500";"-";"-";"-";"-";"-";"-";"-";"-";"-";"-";"-";"-";"-";"-";"-";"-";"-";"-";"-";"-";"-";"-";"-";"-";"-";"-";"-";"-";"-";"-"
"06 Maj 2024 15:38:40";"Zmodyfikowano Stop Loss";"O2-CV-90K23L";"-";"O2-CV-90K43W";"Solana (USD)";"6 Jednost.";"151,225";"-";"153,200";"-";"-";"-";"-";"-";"-";"-";"-";"-";"-";"-";"-";"-";"-";"-";"-";"-";"-";"-";"-";"-";"-";"-";"-";"-";"-";"-";"-";"-";"-"
"06 Maj 2024 15:38:11";" Zmodyfikowano Transakcję Kupna";"O2-CV-90K23L";"T2-CV-5EVR92";"-";"Solana (USD)";"6 Jednost.";"151,225";"-";"152,700";"156,200";"-";"-";"-";"0,00";"-";"-";"-";"-";"-";"-";"-";"-";"-";"-";"-";"-";"-";"-";"-";"-";"-";"-";"-";"-";"-";"-";"-";"-";"-"
"06 Maj 2024 15:37:55";" Zmodyfikowano Transakcję Kupna";"O2-CV-90K1P8";"T2-CV-5EVQXH";"-";"Solana (USD)";"40 Jednost.";"152,055";"-";"152,700";"156,200";"-";"-";"-";"0,00";"-";"-";"-";"-";"-";"-";"-";"-";"-";"-";"-";"-";"-";"-";"-";"-";"-";"-";"-";"-";"-";"-";"-";"-";"-"
"06 Maj 2024 15:27:45";" Zmodyfikowano Transakcję Kupna";"O2-CV-90K23L";"T2-CV-5EVR92";"-";"Solana (USD)";"6 Jednost.";"151,225";"-";"-";"156,200";"-";"-";"-";"0,00";"-";"-";"-";"-";"-";"-";"-";"-";"-";"-";"-";"-";"-";"-";"-";"-";"-";"-";"-";"-";"-";"-";"-";"-";"-"
"06 Maj 2024 15:27:17";" Transakcja Kupna";"O2-CV-90K23L";"T2-CV-5EVR92";"-";"Solana (USD)";"6 Jednost.";"151,225";"-";"-";"-";"-";"4,017909";"3 645,64";"0,00";"-";"-";"-";"-";"-";"-";"-";"-";"-";"-";"-";"-";"-";"-";"-";"-";"-";"-";"-";"-";"-";"-";"-";"-";"-"
"06 Maj 2024 15:21:10";" Zmodyfikowano Transakcję Kupna";"O2-CV-90K1P8";"T2-CV-5EVQXH";"-";"Solana (USD)";"40 Jednost.";"152,055";"-";"-";"156,200";"-";"-";"-";"0,00";"-";"-";"-";"-";"-";"-";"-";"-";"-";"-";"-";"-";"-";"-";"-";"-";"-";"-";"-";"-";"-";"-";"-";"-";"-"
"06 Maj 2024 15:20:16";" Transakcja Kupna";"O2-CV-90K1P8";"T2-CV-5EVQXH";"-";"Solana (USD)";"40 Jednost.";"152,055";"-";"-";"-";"-";"4,017809";"24 437,11";"0,00";"-";"-";"-";"-";"-";"-";"-";"-";"-";"-";"-";"-";"-";"-";"-";"-";"-";"-";"-";"-";"-";"-";"-";"-";"-"
"06 Maj 2024 15:10:01";"Stop Loss";"O2-CV-90K0PS";"T2-CV-5EVQ57";"-";"Solana (USD)";"40 Jednost.";"151,685";"-";"-";"-";"-";"3,98171";"24 401,48";"24,53";"39 086,67";"-";"-";"-";"-";"-";"-";"-";"-";"-";"-";"-";"-";"-";"-";"-";"-";"-";"-";"-";"-";"-";"-";"-";"-"
"06 Maj 2024 15:09:56";" Zmodyfikowano Transakcję Kupna";"O2-CV-90K0PS";"T2-CV-5EVPZ8";"-";"Solana (USD)";"40 Jednost.";"151,531";"-";"151,700";"-";"-";"-";"-";"0,00";"-";"-";"-";"-";"-";"-";"-";"-";"-";"-";"-";"-";"-";"-";"-";"-";"-";"-";"-";"-";"-";"-";"-";"-";"-"
"06 Maj 2024 15:06:42";" Transakcja Kupna";"O2-CV-90K0PS";"T2-CV-5EVPZ8";"-";"Solana (USD)";"40 Jednost.";"151,531";"-";"-";"-";"-";"4,021136";"24 373,07";"0,00";"-";"-";"-";"-";"-";"-";"-";"-";"-";"-";"-";"-";"-";"-";"-";"-";"-";"-";"-";"-";"-";"-";"-";"-";"-"
"06 Maj 2024 15:04:13";"Stop Loss";"O2-CV-90K055";"T2-CV-5EVPT3";"-";"Solana (USD)";"40 Jednost.";"151,172";"-";"-";"-";"-";"3,98082";"24 313,44";"32,96";"39 062,14";"-";"-";"-";"-";"-";"-";"-";"-";"-";"-";"-";"-";"-";"-";"-";"-";"-";"-";"-";"-";"-";"-";"-";"-"
"06 Maj 2024 15:04:06";"Zmodyfikowano Stop Loss";"O2-CV-90K055";"-";"O2-CV-90K0HC";"Solana (USD)";"40 Jednost.";"150,965";"-";"151,200";"-";"-";"-";"-";"-";"-";"-";"-";"-";"-";"-";"-";"-";"-";"-";"-";"-";"-";"-";"-";"-";"-";"-";"-";"-";"-";"-";"-";"-";"-"
"06 Maj 2024 15:03:46";" Zmodyfikowano Transakcję Kupna";"O2-CV-90K055";"T2-CV-5EVPHG";"-";"Solana (USD)";"40 Jednost.";"150,965";"-";"150,150";"-";"-";"-";"-";"0,00";"-";"-";"-";"-";"-";"-";"-";"-";"-";"-";"-";"-";"-";"-";"-";"-";"-";"-";"-";"-";"-";"-";"-";"-";"-"
"06 Maj 2024 14:57:50";" Transakcja Kupna";"O2-CV-90K055";"T2-CV-5EVPHG";"-";"Solana (USD)";"40 Jednost.";"150,965";"-";"-";"-";"-";"4,020274";"24 276,82";"0,00";"-";"-";"-";"-";"-";"-";"-";"-";"-";"-";"-";"-";"-";"-";"-";"-";"-";"-";"-";"-";"-";"-";"-";"-";"-"
"06 Maj 2024 14:48:29";"Stop Loss";"O2-CV-90JZ9B";"T2-CV-5EVP36";"-";"Solana (USD)";"40 Jednost.";"151,510";"-";"-";"-";"-";"3,98046";"24 365,62";"39,01";"39 029,18";"-";"-";"-";"-";"-";"-";"-";"-";"-";"-";"-";"-";"-";"-";"-";"-";"-";"-";"-";"-";"-";"-";"-";"-"
"06 Maj 2024 14:48:03";"Zmodyfikowano Stop Loss";"O2-CV-90JZ9B";"-";"O2-CV-90JZEB";"Solana (USD)";"40 Jednost.";"151,755";"-";"151,500";"-";"-";"-";"-";"-";"-";"-";"-";"-";"-";"-";"-";"-";"-";"-";"-";"-";"-";"-";"-";"-";"-";"-";"-";"-";"-";"-";"-";"-";"-"
"06 Maj 2024 14:46:45";"Zmodyfikowano Transakcję Sprzedaży";"O2-CV-90JZ9B";"T2-CV-5EVNW9";"-";"Solana (USD)";"40 Jednost.";"151,755";"-";"151,700";"-";"-";"-";"-";"0,00";"-";"-";"-";"-";"-";"-";"-";"-";"-";"-";"-";"-";"-";"-";"-";"-";"-";"-";"-";"-";"-";"-";"-";"-";"-"
"06 Maj 2024 14:45:56";"Transakcja Sprzedaży";"O2-CV-90JZ9B";"T2-CV-5EVNW9";"-";"Solana (USD)";"40 Jednost.";"151,755";"-";"-";"-";"-";"4,018821";"24 395,04";"0,00";"-";"-";"-";"-";"-";"-";"-";"-";"-";"-";"-";"-";"-";"-";"-";"-";"-";"-";"-";"-";"-";"-";"-";"-";"-"
"06 Maj 2024 13:16:13";"Stop Loss";"O2-CV-90JT4F";"T2-CV-5EVKDQ";"-";"Solana (USD)";"40 Jednost.";"153,995";"-";"-";"-";"-";"3,99488";"24 854,94";"186,16";"38 990,17";"-";"-";"-";"-";"-";"-";"-";"-";"-";"-";"-";"-";"-";"-";"-";"-";"-";"-";"-";"-";"-";"-";"-";"-"
"06 Maj 2024 13:13:51";"Zmodyfikowano Stop Loss";"O2-CV-90JT4F";"-";"O2-CV-90JTCP";"Solana (USD)";"40 Jednost.";"152,830";"-";"154,000";"-";"-";"-";"-";"-";"-";"-";"-";"-";"-";"-";"-";"-";"-";"-";"-";"-";"-";"-";"-";"-";"-";"-";"-";"-";"-";"-";"-";"-";"-"
"06 Maj 2024 13:12:33";"Zmodyfikowano Stop Loss";"O2-CV-90JT4F";"-";"O2-CV-90JTCP";"Solana (USD)";"40 Jednost.";"152,830";"-";"153,500";"-";"-";"-";"-";"-";"-";"-";"-";"-";"-";"-";"-";"-";"-";"-";"-";"-";"-";"-";"-";"-";"-";"-";"-";"-";"-";"-";"-";"-";"-"
"06 Maj 2024 13:06:47";" Zmodyfikowano Transakcję Kupna";"O2-CV-90JT4F";"T2-CV-5EVK20";"-";"Solana (USD)";"40 Jednost.";"152,830";"-";"153,200";"-";"-";"-";"-";"0,00";"-";"-";"-";"-";"-";"-";"-";"-";"-";"-";"-";"-";"-";"-";"-";"-";"-";"-";"-";"-";"-";"-";"-";"-";"-"
"06 Maj 2024 12:59:00";" Transakcja Kupna";"O2-CV-90JT4F";"T2-CV-5EVK20";"-";"Solana (USD)";"40 Jednost.";"152,830";"-";"-";"-";"-";"4,032689";"24 652,63";"0,00";"-";"-";"-";"-";"-";"-";"-";"-";"-";"-";"-";"-";"-";"-";"-";"-";"-";"-";"-";"-";"-";"-";"-";"-";"-"
"06 Maj 2024 12:11:38";" Transakcja Kupna";"O2-CV-90JR22";"T2-CV-5EVHJ6";"-";"Solana (USD)";"90 Jednost.";"156,721";"-";"-";"-";"-";"4,034372";"56 904,37";"0,00";"-";"-";"-";"-";"-";"-";"-";"-";"-";"-";"-";"-";"-";"-";"-";"-";"-";"-";"-";"-";"-";"-";"-";"-";"-"
"06 Maj 2024 11:57:04";" Zamknięcie Transakcji";"O2-CV-90JQ6L";"T2-CV-5EVGVW";"O2-CV-90JEGS";"Solana (USD)";"90 Jednost.";"155,930";"-";"-";"-";"-";"3,99453";"56 621,39";"2 417,69";"38 804,01";"-";"-";"-";"-";"-";"-";"-";"-";"-";"-";"-";"-";"-";"-";"-";"-";"-";"-";"-";"-";"-";"-";"-";"-"
"06 Maj 2024 10:44:24";" Zamknięcie Transakcji";"O2-CV-90JLTD";"T2-CV-5EVEQK";"O2-CV-90JKR7";"Solana (USD)";"40 Jednost.";"154,470";"-";"-";"-";"-";"4,00008";"24 964,10";"52,00";"36 386,32";"-";"-";"-";"-";"-";"-";"-";"-";"-";"-";"-";"-";"-";"-";"-";"-";"-";"-";"-";"-";"-";"-";"-";"-"
"06 Maj 2024 10:27:11";" Transakcja Kupna";"O2-CV-90JKR7";"T2-CV-5EVDZE";"-";"Solana (USD)";"40 Jednost.";"154,145";"-";"-";"-";"-";"4,039262";"24 905,28";"0,00";"-";"-";"-";"-";"-";"-";"-";"-";"-";"-";"-";"-";"-";"-";"-";"-";"-";"-";"-";"-";"-";"-";"-";"-";"-"
"06 Maj 2024 08:43:38";" Transakcja Kupna";"O2-CV-90JEGS";"T2-CV-5EV9XH";"-";"Solana (USD)";"90 Jednost.";"149,205";"-";"-";"-";"-";"4,035895";"54 195,81";"0,00";"-";"-";"-";"-";"-";"-";"-";"-";"-";"-";"-";"-";"-";"-";"-";"-";"-";"-";"-";"-";"-";"-";"-";"-";"-"
"06 Maj 2024 00:01:59";" Zamknięcie Transakcji";"O2-CV-90J205";"T2-CV-5EV170";"O2-CV-90HXHT";"Solana (USD)";"90 Jednost.";"145,465";"-";"-";"-";"-";"3,99552";"52 834,45";"1 443,78";"36 334,32";"-";"-";"-";"-";"-";"-";"-";"-";"-";"-";"-";"-";"-";"-";"-";"-";"-";"-";"-";"-";"-";"-";"-";"-"
"03 Maj 2024 23:00:50";"Koszty Utrzymania Pozycji";"1333231843";"-";"-";"Rachunek";"-";"-";"-";"-";"-";"-";"-";"-";"-116,91";"34 890,54";"-";"-";"-";"-";"-";"-116,91";"-";"-";"-";"-";"-";"-";"-";"-";"-";"-";"-";"-";"-";"-";"-";"-";"-";"-"
"03 Maj 2024 23:00:50";"Koszty Utrzymania Pozycji";"O2-CV-90HXHT";"-";"-";"Solana (USD)";"-";"-";"-";"-";"-";"-";"-";"-";"-";"-";"-";"-";"12 852,45";"-27,50000%";"-117,44";"-117,44";"-";"-";"-";"-";"-";"-";"-";"-";"-";"-";"-";"-";"-";"-";"-";"-";"-";"-"
"03 Maj 2024 23:00:50";"Koszty Utrzymania Pozycji";"O2-CV-909KF0";"-";"-";"Solana (USD)";"-";"-";"-";"-";"-";"-";"-";"-";"-";"-";"-";"-";"19 992,70";"-10,00000%";"65,77";"65,77";"-";"-";"-";"-";"-";"-";"-";"-";"-";"-";"-";"-";"-";"-";"-";"-";"-";"-"
"03 Maj 2024 23:00:50";"Koszty Utrzymania Pozycji";"O2-CR-8Z7P36";"-";"-";"Solana (USD)";"-";"-";"-";"-";"-";"-";"-";"-";"-";"-";"-";"-";"7 140,25";"-27,50000%";"-65,24";"-65,24";"-";"-";"-";"-";"-";"-";"-";"-";"-";"-";"-";"-";"-";"-";"-";"-";"-";"-"
"03 Maj 2024 21:18:40";" Transakcja Kupna";"O2-CV-90HXHT";"T2-CV-5ETXTL";"-";"Solana (USD)";"90 Jednost.";"141,450";"-";"-";"-";"-";"4,039272";"51 421,95";"0,00";"-";"-";"-";"-";"-";"-";"-";"-";"-";"-";"-";"-";"-";"-";"-";"-";"-";"-";"-";"-";"-";"-";"-";"-";"-"
"03 Maj 2024 20:16:40";" Zamknięcie Transakcji";"O2-CV-90HV1S";"T2-CV-5ETV7R";"O2-CV-90FEDK";"Solana (USD)";"90 Jednost.";"142,040";"-";"-";"-";"-";"4,00028";"51 652,05";"1 301,49";"35 007,45";"-";"-";"-";"-";"-";"-";"-";"-";"-";"-";"-";"-";"-";"-";"-";"-";"-";"-";"-";"-";"-";"-";"-";"-"
"02 Maj 2024 23:52:08";" Transakcja Kupna";"O2-CV-90FEDK";"T2-CV-5ERSK9";"-";"Solana (USD)";"90 Jednost.";"138,425";"-";"-";"-";"-";"4,059573";"50 575,17";"0,00";"-";"-";"-";"-";"-";"-";"-";"-";"-";"-";"-";"-";"-";"-";"-";"-";"-";"-";"-";"-";"-";"-";"-";"-";"-"
"02 Maj 2024 23:00:56";"Koszty Utrzymania Pozycji";"1332795084";"-";"-";"Rachunek";"-";"-";"-";"-";"-";"-";"-";"-";"0,17";"33 705,96";"-";"-";"-";"-";"-";"0,17";"-";"-";"-";"-";"-";"-";"-";"-";"-";"-";"-";"-";"-";"-";"-";"-";"-";"-"
"02 Maj 2024 23:00:56";"Koszty Utrzymania Pozycji";"O2-CV-909KF0";"-";"-";"Solana (USD)";"-";"-";"-";"-";"-";"-";"-";"-";"-";"-";"-";"-";"19 120,64";"-10,00000%";"21,06";"21,06";"-";"-";"-";"-";"-";"-";"-";"-";"-";"-";"-";"-";"-";"-";"-";"-";"-";"-"
"02 Maj 2024 23:00:56";"Koszty Utrzymania Pozycji";"O2-CR-8Z7P36";"-";"-";"Solana (USD)";"-";"-";"-";"-";"-";"-";"-";"-";"-";"-";"-";"-";"6 828,80";"-27,50000%";"-20,89";"-20,89";"-";"-";"-";"-";"-";"-";"-";"-";"-";"-";"-";"-";"-";"-";"-";"-";"-";"-"
"02 Maj 2024 22:07:36";"Stop Loss";"O2-CV-90F5YJ";"T2-CV-5ERPZ0";"-";"Solana (USD)";"150 Jednost.";"138,200";"-";"-";"-";"-";"4,01903";"84 151,61";"45,21";"33 705,79";"-";"-";"-";"-";"-";"-";"-";"-";"-";"-";"-";"-";"-";"-";"-";"-";"-";"-";"-";"-";"-";"-";"-";"-"
"02 Maj 2024 22:06:18";" Zmodyfikowano Transakcję Kupna";"O2-CV-90F5YJ";"T2-CV-5ERKF6";"-";"Solana (USD)";"150 Jednost.";"138,125";"-";"138,200";"139,400";"-";"-";"-";"0,00";"-";"-";"-";"-";"-";"-";"-";"-";"-";"-";"-";"-";"-";"-";"-";"-";"-";"-";"-";"-";"-";"-";"-";"-";"-"
"02 Maj 2024 21:01:07";" Zmodyfikowano Transakcję Kupna";"O2-CV-90F5YJ";"T2-CV-5ERKF6";"-";"Solana (USD)";"150 Jednost.";"138,125";"-";"-";"139,400";"-";"-";"-";"0,00";"-";"-";"-";"-";"-";"-";"-";"-";"-";"-";"-";"-";"-";"-";"-";"-";"-";"-";"-";"-";"-";"-";"-";"-";"-"
"02 Maj 2024 20:56:48";" Transakcja Kupna";"O2-CV-90F5YJ";"T2-CV-5ERKF6";"-";"Solana (USD)";"150 Jednost.";"138,125";"-";"-";"-";"-";"4,05843";"84 085,59";"0,00";"-";"-";"-";"-";"-";"-";"-";"-";"-";"-";"-";"-";"-";"-";"-";"-";"-";"-";"-";"-";"-";"-";"-";"-";"-"
"02 Maj 2024 20:38:02";"Stop Loss";"O2-CV-90F3ME";"T2-CV-5ERJ8B";"-";"Solana (USD)";"150 Jednost.";"138,800";"-";"-";"-";"-";"4,01982";"84 534,07";"220,09";"33 660,58";"-";"-";"-";"-";"-";"-";"-";"-";"-";"-";"-";"-";"-";"-";"-";"-";"-";"-";"-";"-";"-";"-";"-";"-"
"02 Maj 2024 20:37:52";"Zmodyfikowano Stop Loss";"O2-CV-90F3ME";"-";"O2-CV-90F4C8";"Solana (USD)";"150 Jednost.";"138,435";"-";"138,800";"-";"-";"-";"-";"-";"-";"-";"-";"-";"-";"-";"-";"-";"-";"-";"-";"-";"-";"-";"-";"-";"-";"-";"-";"-";"-";"-";"-";"-";"-"
"02 Maj 2024 20:35:24";" Zmodyfikowano Transakcję Kupna";"O2-CV-90F3ME";"T2-CV-5ERHHF";"-";"Solana (USD)";"150 Jednost.";"138,435";"-";"138,500";"-";"-";"-";"-";"0,00";"-";"-";"-";"-";"-";"-";"-";"-";"-";"-";"-";"-";"-";"-";"-";"-";"-";"-";"-";"-";"-";"-";"-";"-";"-"
"02 Maj 2024 20:23:53";" Transakcja Kupna";"O2-CV-90F3ME";"T2-CV-5ERHHF";"-";"Solana (USD)";"150 Jednost.";"138,435";"-";"-";"-";"-";"4,061025";"84 328,19";"0,00";"-";"-";"-";"-";"-";"-";"-";"-";"-";"-";"-";"-";"-";"-";"-";"-";"-";"-";"-";"-";"-";"-";"-";"-";"-"
"02 Maj 2024 19:31:52";" Zamknięcie Transakcji";"O2-CV-90EZR0";"T2-CV-5EREWD";"O2-CV-90EZ4D";"Solana (USD)";"140 Jednost.";"139,485";"-";"-";"-";"-";"4,02224";"79 335,39";"53,50";"33 440,49";"-";"-";"-";"-";"-";"-";"-";"-";"-";"-";"-";"-";"-";"-";"-";"-";"-";"-";"-";"-";"-";"-";"-";"-"
"02 Maj 2024 19:20:47";" Transakcja Kupna";"O2-CV-90EZ4D";"T2-CV-5EREB9";"-";"Solana (USD)";"140 Jednost.";"139,390";"-";"-";"-";"-";"4,06319";"79 291,52";"0,00";"-";"-";"-";"-";"-";"-";"-";"-";"-";"-";"-";"-";"-";"-";"-";"-";"-";"-";"-";"-";"-";"-";"-";"-";"-"
"02 Maj 2024 18:09:54";" Zamknięcie Transakcji";"O2-CV-90ET92";"T2-CV-5ER920";"O2-CV-90ENEF";"Solana (USD)";"150 Jednost.";"138,005";"-";"-";"-";"-";"4,06809";"84 212,51";"-1 235,07";"33 386,99";"-";"-";"-";"-";"-";"-";"-";"-";"-";"-";"-";"-";"-";"-";"-";"-";"-";"-";"-";"-";"-";"-";"-";"-"
"02 Maj 2024 17:57:25";" Zmodyfikowano Transakcję Kupna";"O2-CV-90ENEF";"T2-CV-5ER4ST";"-";"Solana (USD)";"150 Jednost.";"140,029";"-";"-";"140,200";"-";"-";"-";"0,00";"-";"-";"-";"-";"-";"-";"-";"-";"-";"-";"-";"-";"-";"-";"-";"-";"-";"-";"-";"-";"-";"-";"-";"-";"-"
"02 Maj 2024 17:29:08";" Zmodyfikowano Transakcję Kupna";"O2-CV-90ENEF";"T2-CV-5ER4ST";"-";"Solana (USD)";"150 Jednost.";"140,029";"-";"-";"-";"-";"-";"-";"0,00";"-";"-";"-";"-";"-";"-";"-";"-";"-";"-";"-";"-";"-";"-";"-";"-";"-";"-";"-";"-";"-";"-";"-";"-";"-"
"02 Maj 2024 17:19:44";" Zmodyfikowano Transakcję Kupna";"O2-CV-90ENEF";"T2-CV-5ER4ST";"-";"Solana (USD)";"150 Jednost.";"140,029";"-";"-";"140,200";"-";"-";"-";"0,00";"-";"-";"-";"-";"-";"-";"-";"-";"-";"-";"-";"-";"-";"-";"-";"-";"-";"-";"-";"-";"-";"-";"-";"-";"-"
"02 Maj 2024 17:14:37";" Transakcja Kupna";"O2-CV-90ENEF";"T2-CV-5ER4ST";"-";"Solana (USD)";"150 Jednost.";"140,029";"-";"-";"-";"-";"4,071055";"85 509,86";"0,00";"-";"-";"-";"-";"-";"-";"-";"-";"-";"-";"-";"-";"-";"-";"-";"-";"-";"-";"-";"-";"-";"-";"-";"-";"-"
"02 Maj 2024 17:11:58";" Zamknięcie Transakcji";"O2-CV-90EN4R";"T2-CV-5ER4JR";"O2-CV-90EM4K";"Solana (USD)";"150 Jednost.";"139,808";"-";"-";"-";"-";"4,03042";"85 372,18";"331,30";"34 622,06";"-";"-";"-";"-";"-";"-";"-";"-";"-";"-";"-";"-";"-";"-";"-";"-";"-";"-";"-";"-";"-";"-";"-";"-"
"02 Maj 2024 17:02:54";" Transakcja Kupna";"O2-CV-90EM4K";"T2-CV-5ER3L1";"-";"Solana (USD)";"150 Jednost.";"139,260";"-";"-";"-";"-";"4,074492";"85 112,06";"0,00";"-";"-";"-";"-";"-";"-";"-";"-";"-";"-";"-";"-";"-";"-";"-";"-";"-";"-";"-";"-";"-";"-";"-";"-";"-"
"02 Maj 2024 16:44:31";"Stop Loss";"O2-CV-90EJ4V";"T2-CV-5ER1GT";"-";"Solana (USD)";"150 Jednost.";"138,374";"-";"-";"-";"-";"4,03502";"84 593,24";"81,71";"34 290,76";"-";"-";"-";"-";"-";"-";"-";"-";"-";"-";"-";"-";"-";"-";"-";"-";"-";"-";"-";"-";"-";"-";"-";"-"
"02 Maj 2024 16:44:11";" Zmodyfikowano Transakcję Kupna";"O2-CV-90EJ4V";"T2-CV-5ER0SJ";"-";"Solana (USD)";"150 Jednost.";"138,239";"-";"138,400";"-";"-";"-";"-";"0,00";"-";"-";"-";"-";"-";"-";"-";"-";"-";"-";"-";"-";"-";"-";"-";"-";"-";"-";"-";"-";"-";"-";"-";"-";"-"
"02 Maj 2024 16:40:07";" Transakcja Kupna";"O2-CV-90EJ4V";"T2-CV-5ER0SJ";"-";"Solana (USD)";"150 Jednost.";"138,239";"-";"-";"-";"-";"4,073671";"84 471,03";"0,00";"-";"-";"-";"-";"-";"-";"-";"-";"-";"-";"-";"-";"-";"-";"-";"-";"-";"-";"-";"-";"-";"-";"-";"-";"-"
"02 Maj 2024 16:34:53";"Stop Loss";"O2-CV-90EH9K";"T2-CV-5ER085";"-";"Solana (USD)";"150 Jednost.";"137,145";"-";"-";"-";"-";"4,0315";"83 768,72";"30,24";"34 209,05";"-";"-";"-";"-";"-";"-";"-";"-";"-";"-";"-";"-";"-";"-";"-";"-";"-";"-";"-";"-";"-";"-";"-";"-"
"02 Maj 2024 16:34:47";" Zmodyfikowano Transakcję Kupna";"O2-CV-90EH9K";"T2-CV-5ER025";"-";"Solana (USD)";"150 Jednost.";"137,095";"-";"137,150";"-";"-";"-";"-";"0,00";"-";"-";"-";"-";"-";"-";"-";"-";"-";"-";"-";"-";"-";"-";"-";"-";"-";"-";"-";"-";"-";"-";"-";"-";"-"
"02 Maj 2024 16:33:02";" Transakcja Kupna";"O2-CV-90EH9K";"T2-CV-5ER025";"-";"Solana (USD)";"150 Jednost.";"137,095";"-";"-";"-";"-";"4,072488";"83 747,66";"0,00";"-";"-";"-";"-";"-";"-";"-";"-";"-";"-";"-";"-";"-";"-";"-";"-";"-";"-";"-";"-";"-";"-";"-";"-";"-"
"02 Maj 2024 15:33:38";" Zamknięcie Transakcji";"O2-CV-90E588";"T2-CV-5EQNQS";"O2-CV-90E4ZT";"Solana (USD)";"150 Jednost.";"137,092";"-";"-";"-";"-";"4,03033";"83 711,83";"61,66";"34 178,81";"-";"-";"-";"-";"-";"-";"-";"-";"-";"-";"-";"-";"-";"-";"-";"-";"-";"-";"-";"-";"-";"-";"-";"-"
"02 Maj 2024 15:32:19";" Transakcja Kupna";"O2-CV-90E4ZT";"T2-CV-5EQNGY";"-";"Solana (USD)";"150 Jednost.";"136,990";"-";"-";"-";"-";"4,070825";"83 649,34";"0,00";"-";"-";"-";"-";"-";"-";"-";"-";"-";"-";"-";"-";"-";"-";"-";"-";"-";"-";"-";"-";"-";"-";"-";"-";"-"
"02 Maj 2024 15:30:03";" Zamknięcie Transakcji";"O2-CV-90E4GX";"T2-CV-5EQN0K";"O2-CV-90E2SB";"Solana (USD)";"150 Jednost.";"137,405";"-";"-";"-";"-";"4,03006";"83 897,37";"15,11";"34 117,15";"-";"-";"-";"-";"-";"-";"-";"-";"-";"-";"-";"-";"-";"-";"-";"-";"-";"-";"-";"-";"-";"-";"-";"-"
"02 Maj 2024 15:08:04";" Transakcja Kupna";"O2-CV-90E2SB";"T2-CV-5EQLFS";"-";"Solana (USD)";"150 Jednost.";"137,380";"-";"-";"-";"-";"4,06851";"83 839,78";"0,00";"-";"-";"-";"-";"-";"-";"-";"-";"-";"-";"-";"-";"-";"-";"-";"-";"-";"-";"-";"-";"-";"-";"-";"-";"-"
"02 Maj 2024 14:39:10";"Take Profit";"O2-CV-90DYM5";"T2-CV-5EQJ18";"-";"Solana (USD)";"150 Jednost.";"137,600";"-";"-";"-";"-";"4,02353";"83 880,15";"42,25";"34 102,04";"-";"-";"-";"-";"-";"-";"-";"-";"-";"-";"-";"-";"-";"-";"-";"-";"-";"-";"-";"-";"-";"-";"-";"-"
"02 Maj 2024 14:38:12";" Zmodyfikowano Transakcję Kupna";"O2-CV-90DYM5";"T2-CV-5EQGTR";"-";"Solana (USD)";"150 Jednost.";"137,530";"-";"-";"137,600";"-";"-";"-";"0,00";"-";"-";"-";"-";"-";"-";"-";"-";"-";"-";"-";"-";"-";"-";"-";"-";"-";"-";"-";"-";"-";"-";"-";"-";"-"
"02 Maj 2024 14:24:45";" Transakcja Kupna";"O2-CV-90DYM5";"T2-CV-5EQGTR";"-";"Solana (USD)";"150 Jednost.";"137,530";"-";"-";"-";"-";"4,065394";"83 867,04";"0,00";"-";"-";"-";"-";"-";"-";"-";"-";"-";"-";"-";"-";"-";"-";"-";"-";"-";"-";"-";"-";"-";"-";"-";"-";"-"
"02 Maj 2024 14:00:59";" Zamknięcie Transakcji";"O2-CV-90DX87";"T2-CV-5EQFVH";"O2-CV-90DVZH";"Solana (USD)";"150 Jednost.";"138,346";"-";"-";"-";"-";"4,02271";"84 317,87";"398,85";"34 059,79";"-";"-";"-";"-";"-";"-";"-";"-";"-";"-";"-";"-";"-";"-";"-";"-";"-";"-";"-";"-";"-";"-";"-";"-"
"02 Maj 2024 13:41:41";" Transakcja Kupna";"O2-CV-90DVZH";"T2-CV-5EQF3B";"-";"Solana (USD)";"150 Jednost.";"137,685";"-";"-";"-";"-";"4,065274";"83 959,08";"0,00";"-";"-";"-";"-";"-";"-";"-";"-";"-";"-";"-";"-";"-";"-";"-";"-";"-";"-";"-";"-";"-";"-";"-";"-";"-"
"02 Maj 2024 13:31:17";"Stop Loss";"O2-CV-90DTRL";"T2-CV-5EQEN4";"-";"Solana (USD)";"150 Jednost.";"137,293";"-";"-";"-";"-";"4,02635";"83 751,82";"212,59";"33 660,94";"-";"-";"-";"-";"-";"-";"-";"-";"-";"-";"-";"-";"-";"-";"-";"-";"-";"-";"-";"-";"-";"-";"-";"-"
"02 Maj 2024 13:28:44";" Zmodyfikowano Transakcję Kupna";"O2-CV-90DTRL";"T2-CV-5EQE29";"-";"Solana (USD)";"150 Jednost.";"136,941";"-";"137,300";"-";"-";"-";"-";"0,00";"-";"-";"-";"-";"-";"-";"-";"-";"-";"-";"-";"-";"-";"-";"-";"-";"-";"-";"-";"-";"-";"-";"-";"-";"-"
"02 Maj 2024 13:20:26";" Transakcja Kupna";"O2-CV-90DTRL";"T2-CV-5EQE29";"-";"Solana (USD)";"150 Jednost.";"136,941";"-";"-";"-";"-";"4,066977";"83 540,38";"0,00";"-";"-";"-";"-";"-";"-";"-";"-";"-";"-";"-";"-";"-";"-";"-";"-";"-";"-";"-";"-";"-";"-";"-";"-";"-"
"02 Maj 2024 13:13:38";" Zamknięcie Transakcji";"O2-CV-90DTCN";"T2-CV-5EQDRN";"O2-CV-90DT7K";"Solana (USD)";"150 Jednost.";"135,901";"-";"-";"-";"-";"4,02443";"82 862,84";"21,73";"33 448,35";"-";"-";"-";"-";"-";"-";"-";"-";"-";"-";"-";"-";"-";"-";"-";"-";"-";"-";"-";"-";"-";"-";"-";"-"
"02 Maj 2024 13:11:19";" Transakcja Kupna";"O2-CV-90DT7K";"T2-CV-5EQDN8";"-";"Solana (USD)";"150 Jednost.";"135,865";"-";"-";"-";"-";"4,064322";"82 829,86";"0,00";"-";"-";"-";"-";"-";"-";"-";"-";"-";"-";"-";"-";"-";"-";"-";"-";"-";"-";"-";"-";"-";"-";"-";"-";"-"
"02 Maj 2024 12:13:36";"Stop Loss";"O2-CV-90DQ9E";"T2-CV-5EQBFN";"-";"Solana (USD)";"80 Jednost.";"133,400";"-";"-";"-";"-";"4,03175";"43 459,24";"67,73";"33 426,62";"-";"-";"-";"-";"-";"-";"-";"-";"-";"-";"-";"-";"-";"-";"-";"-";"-";"-";"-";"-";"-";"-";"-";"-"
"02 Maj 2024 12:13:20";" Zmodyfikowano Transakcję Kupna";"O2-CV-90DQ9E";"T2-CV-5EQB9S";"-";"Solana (USD)";"80 Jednost.";"133,190";"-";"133,400";"-";"-";"-";"-";"0,00";"-";"-";"-";"-";"-";"-";"-";"-";"-";"-";"-";"-";"-";"-";"-";"-";"-";"-";"-";"-";"-";"-";"-";"-";"-"
"02 Maj 2024 12:10:20";" Transakcja Kupna";"O2-CV-90DQ9E";"T2-CV-5EQB9S";"-";"Solana (USD)";"80 Jednost.";"133,190";"-";"-";"-";"-";"4,070053";"43 367,22";"0,00";"-";"-";"-";"-";"-";"-";"-";"-";"-";"-";"-";"-";"-";"-";"-";"-";"-";"-";"-";"-";"-";"-";"-";"-";"-"
"01 Maj 2024 23:00:54";"Koszty Utrzymania Pozycji";"1332310467";"-";"-";"Rachunek";"-";"-";"-";"-";"-";"-";"-";"-";"0,16";"33 358,89";"-";"-";"-";"-";"-";"0,16";"-";"-";"-";"-";"-";"-";"-";"-";"-";"-";"-";"-";"-";"-";"-";"-";"-";"-"
"01 Maj 2024 23:00:54";"Koszty Utrzymania Pozycji";"O2-CV-909KF0";"-";"-";"Solana (USD)";"-";"-";"-";"-";"-";"-";"-";"-";"-";"-";"-";"-";"18 428,90";"-10,00000%";"20,27";"20,27";"-";"-";"-";"-";"-";"-";"-";"-";"-";"-";"-";"-";"-";"-";"-";"-";"-";"-"
"01 Maj 2024 23:00:54";"Koszty Utrzymania Pozycji";"O2-CR-8Z7P36";"-";"-";"Solana (USD)";"-";"-";"-";"-";"-";"-";"-";"-";"-";"-";"-";"-";"6 581,75";"-27,50000%";"-20,11";"-20,11";"-";"-";"-";"-";"-";"-";"-";"-";"-";"-";"-";"-";"-";"-";"-";"-";"-";"-"
"01 Maj 2024 17:07:29";"Zmodyfikowano Transakcję Sprzedaży";"O2-CV-909KF0";"T2-CV-5EMY9V";"-";"Solana (USD)";"140 Jednost.";"119,145";"-";"-";"118,400";"-";"-";"-";"0,00";"-";"-";"-";"-";"-";"-";"-";"-";"-";"-";"-";"-";"-";"-";"-";"-";"-";"-";"-";"-";"-";"-";"-";"-";"-"
"01 Maj 2024 10:56:16";"Zmodyfikowano Transakcję Sprzedaży";"O2-CV-909KF0";"T2-CV-5EMY9V";"-";"Solana (USD)";"140 Jednost.";"119,145";"-";"-";"-";"-";"-";"-";"0,00";"-";"-";"-";"-";"-";"-";"-";"-";"-";"-";"-";"-";"-";"-";"-";"-";"-";"-";"-";"-";"-";"-";"-";"-";"-"
"01 Maj 2024 10:26:53";"Zmodyfikowano Transakcję Sprzedaży";"O2-CV-909KF0";"T2-CV-5EMY9V";"-";"Solana (USD)";"140 Jednost.";"119,145";"-";"-";"119,080";"-";"-";"-";"0,00";"-";"-";"-";"-";"-";"-";"-";"-";"-";"-";"-";"-";"-";"-";"-";"-";"-";"-";"-";"-";"-";"-";"-";"-";"-"
"01 Maj 2024 10:24:01";"Zmodyfikowano Transakcję Sprzedaży";"O2-CV-909KF0";"T2-CV-5EMY9V";"-";"Solana (USD)";"140 Jednost.";"119,145";"-";"-";"-";"-";"-";"-";"0,00";"-";"-";"-";"-";"-";"-";"-";"-";"-";"-";"-";"-";"-";"-";"-";"-";"-";"-";"-";"-";"-";"-";"-";"-";"-"
"01 Maj 2024 10:23:30";"Zmodyfikowano Transakcję Sprzedaży";"O2-CV-909KF0";"T2-CV-5EMY9V";"-";"Solana (USD)";"140 Jednost.";"119,145";"-";"-";"118,900";"-";"-";"-";"0,00";"-";"-";"-";"-";"-";"-";"-";"-";"-";"-";"-";"-";"-";"-";"-";"-";"-";"-";"-";"-";"-";"-";"-";"-";"-"
"01 Maj 2024 10:21:41";"Transakcja Sprzedaży";"O2-CV-909KF0";"T2-CV-5EMY9V";"-";"Solana (USD)";"140 Jednost.";"119,145";"-";"-";"-";"-";"4,090925";"68 237,85";"0,00";"-";"-";"-";"-";"-";"-";"-";"-";"-";"-";"-";"-";"-";"-";"-";"-";"-";"-";"-";"-";"-";"-";"-";"-";"-"
"01 Maj 2024 10:20:22";"Stop Loss";"O2-CV-908ZBJ";"T2-CV-5EMY7W";"-";"Solana (USD)";"130 Jednost.";"120,012";"-";"-";"-";"-";"4,05033";"63 826,52";"925,66";"33 358,73";"-";"-";"-";"-";"-";"-";"-";"-";"-";"-";"-";"-";"-";"-";"-";"-";"-";"-";"-";"-";"-";"-";"-";"-"
"01 Maj 2024 10:20:21";"Zmodyfikowano Stop Loss";"O2-CV-908ZBJ";"-";"O2-CV-909JYL";"Solana (USD)";"130 Jednost.";"121,770";"-";"120,000";"-";"-";"-";"-";"-";"-";"-";"-";"-";"-";"-";"-";"-";"-";"-";"-";"-";"-";"-";"-";"-";"-";"-";"-";"-";"-";"-";"-";"-";"-"
"01 Maj 2024 10:07:47";"Zmodyfikowano Take Profit";"O2-CV-908ZBJ";"-";"O2-CV-9093CH";"Solana (USD)";"130 Jednost.";"121,770";"-";"-";"110,000";"-";"-";"-";"-";"-";"-";"-";"-";"-";"-";"-";"-";"-";"-";"-";"-";"-";"-";"-";"-";"-";"-";"-";"-";"-";"-";"-";"-";"-"
"01 Maj 2024 10:07:47";"Zmodyfikowano Transakcję Sprzedaży";"O2-CV-908ZBJ";"T2-CV-5EMHD9";"-";"Solana (USD)";"130 Jednost.";"121,770";"-";"121,000";"110,000";"-";"-";"-";"0,00";"-";"-";"-";"-";"-";"-";"-";"-";"-";"-";"-";"-";"-";"-";"-";"-";"-";"-";"-";"-";"-";"-";"-";"-";"-"
"30 Kw 2024 23:00:59";"Koszty Utrzymania Pozycji";"1331894509";"-";"-";"Rachunek";"-";"-";"-";"-";"-";"-";"-";"-";"-1,23";"32 433,07";"-";"-";"-";"-";"-";"-1,23";"-";"-";"-";"-";"-";"-";"-";"-";"-";"-";"-";"-";"-";"-";"-";"-";"-";"-"
"30 Kw 2024 23:00:59";"Koszty Utrzymania Pozycji";"O2-CR-8Z7P36";"-";"-";"Solana (USD)";"-";"-";"-";"-";"-";"-";"-";"-";"-";"-";"-";"-";"6 240,00";"-27,50000%";"-19,19";"-19,19";"-";"-";"-";"-";"-";"-";"-";"-";"-";"-";"-";"-";"-";"-";"-";"-";"-";"-"
"30 Kw 2024 23:00:59";"Koszty Utrzymania Pozycji";"O2-CV-908ZBJ";"-";"-";"Solana (USD)";"-";"-";"-";"-";"-";"-";"-";"-";"-";"-";"-";"-";"16 224,00";"-10,00000%";"17,96";"17,96";"-";"-";"-";"-";"-";"-";"-";"-";"-";"-";"-";"-";"-";"-";"-";"-";"-";"-"
"30 Kw 2024 22:47:21";"Zmodyfikowano Transakcję Sprzedaży";"O2-CV-908ZBJ";"T2-CV-5EMHD9";"-";"Solana (USD)";"130 Jednost.";"121,770";"-";"-";"115,500";"-";"-";"-";"0,00";"-";"-";"-";"-";"-";"-";"-";"-";"-";"-";"-";"-";"-";"-";"-";"-";"-";"-";"-";"-";"-";"-";"-";"-";"-"
"30 Kw 2024 21:53:15";"Transakcja Sprzedaży";"O2-CV-908ZBJ";"T2-CV-5EMHD9";"-";"Solana (USD)";"130 Jednost.";"121,770";"-";"-";"-";"-";"4,074793";"64 504,38";"0,00";"-";"-";"-";"-";"-";"-";"-";"-";"-";"-";"-";"-";"-";"-";"-";"-";"-";"-";"-";"-";"-";"-";"-";"-";"-"
"30 Kw 2024 20:51:22";" Zamknięcie Transakcji";"O2-CV-908VL0";"T2-CV-5EMDXL";"O2-CV-908KLM";"Solana (USD)";"130 Jednost.";"123,615";"-";"-";"-";"-";"4,03102";"65 429,21";"37,73";"32 434,30";"-";"-";"-";"-";"-";"-";"-";"-";"-";"-";"-";"-";"-";"-";"-";"-";"-";"-";"-";"-";"-";"-";"-";"-"
"30 Kw 2024 18:33:44";"Zmodyfikowano Transakcję Sprzedaży";"O2-CV-908KLM";"T2-CV-5EM56Z";"-";"Solana (USD)";"130 Jednost.";"123,687";"-";"-";"120,500";"-";"-";"-";"0,00";"-";"-";"-";"-";"-";"-";"-";"-";"-";"-";"-";"-";"-";"-";"-";"-";"-";"-";"-";"-";"-";"-";"-";"-";"-"
"30 Kw 2024 18:23:13";"Transakcja Sprzedaży";"O2-CV-908KLM";"T2-CV-5EM56Z";"-";"Solana (USD)";"130 Jednost.";"123,687";"-";"-";"-";"-";"4,071456";"65 466,20";"0,00";"-";"-";"-";"-";"-";"-";"-";"-";"-";"-";"-";"-";"-";"-";"-";"-";"-";"-";"-";"-";"-";"-";"-";"-";"-"
"30 Kw 2024 18:18:14";"Take Profit";"O2-CV-908JK2";"T2-CV-5EM50F";"-";"Solana (USD)";"130 Jednost.";"124,200";"-";"-";"-";"-";"4,03046";"65 729,96";"1 199,87";"32 396,57";"-";"-";"-";"-";"-";"-";"-";"-";"-";"-";"-";"-";"-";"-";"-";"-";"-";"-";"-";"-";"-";"-";"-";"-"
"30 Kw 2024 18:17:43";"Zmodyfikowano Stop Loss";"O2-CV-908JK2";"-";"O2-CV-908K72";"Solana (USD)";"130 Jednost.";"126,490";"-";"125,300";"-";"-";"-";"-";"-";"-";"-";"-";"-";"-";"-";"-";"-";"-";"-";"-";"-";"-";"-";"-";"-";"-";"-";"-";"-";"-";"-";"-";"-";"-"
"30 Kw 2024 18:17:02";"Zmodyfikowano Take Profit";"O2-CV-908JK2";"-";"O2-CV-908JNX";"Solana (USD)";"130 Jednost.";"126,490";"-";"-";"124,200";"-";"-";"-";"-";"-";"-";"-";"-";"-";"-";"-";"-";"-";"-";"-";"-";"-";"-";"-";"-";"-";"-";"-";"-";"-";"-";"-";"-";"-"
"30 Kw 2024 18:16:22";"Zmodyfikowano Transakcję Sprzedaży";"O2-CV-908JK2";"T2-CV-5EM4DH";"-";"Solana (USD)";"130 Jednost.";"126,490";"-";"126,300";"124,800";"-";"-";"-";"0,00";"-";"-";"-";"-";"-";"-";"-";"-";"-";"-";"-";"-";"-";"-";"-";"-";"-";"-";"-";"-";"-";"-";"-";"-";"-"
"30 Kw 2024 18:07:42";"Zmodyfikowano Transakcję Sprzedaży";"O2-CV-908JK2";"T2-CV-5EM4DH";"-";"Solana (USD)";"130 Jednost.";"126,490";"-";"-";"124,800";"-";"-";"-";"0,00";"-";"-";"-";"-";"-";"-";"-";"-";"-";"-";"-";"-";"-";"-";"-";"-";"-";"-";"-";"-";"-";"-";"-";"-";"-"
"30 Kw 2024 18:06:23";"Transakcja Sprzedaży";"O2-CV-908JK2";"T2-CV-5EM4DH";"-";"Solana (USD)";"130 Jednost.";"126,490";"-";"-";"-";"-";"4,070364";"66 931,84";"0,00";"-";"-";"-";"-";"-";"-";"-";"-";"-";"-";"-";"-";"-";"-";"-";"-";"-";"-";"-";"-";"-";"-";"-";"-";"-"
"30 Kw 2024 18:05:18";"Odrzucono Zlecenie: brak wystarczających środków";"O2-CV-908JG1";"-";"-";"Solana (USD)";"135 Jednost.";"-";"-";"-";"-";"-";"-";"-";"-";"-";"-";"-";"-";"-";"-";"-";"-";"-";"-";"-";"-";"-";"-";"-";"-";"-";"-";"-";"-";"-";"-";"-";"-";"-"
"30 Kw 2024 10:31:41";"Take Profit";"O2-CV-905XF2";"T2-CV-5EL05R";"-";"Solana (USD)";"135 Jednost.";"133,750";"-";"-";"-";"-";"4,01539";"73 231,72";"10,84";"31 196,70";"-";"-";"-";"-";"-";"-";"-";"-";"-";"-";"-";"-";"-";"-";"-";"-";"-";"-";"-";"-";"-";"-";"-";"-"
"29 Kw 2024 23:00:48";"Koszty Utrzymania Pozycji";"1331380681";"-";"-";"Rachunek";"-";"-";"-";"-";"-";"-";"-";"-";"-0,57";"31 185,86";"-";"-";"-";"-";"-";"-0,57";"-";"-";"-";"-";"-";"-";"-";"-";"-";"-";"-";"-";"-";"-";"-";"-";"-";"-"
"29 Kw 2024 23:00:48";"Koszty Utrzymania Pozycji";"O2-CV-905XF2";"-";"-";"Solana (USD)";"-";"-";"-";"-";"-";"-";"-";"-";"-";"-";"-";"-";"18 215,55";"-10,00000%";"19,99";"19,99";"-";"-";"-";"-";"-";"-";"-";"-";"-";"-";"-";"-";"-";"-";"-";"-";"-";"-"
"29 Kw 2024 23:00:48";"Koszty Utrzymania Pozycji";"O2-CR-8Z7P36";"-";"-";"Solana (USD)";"-";"-";"-";"-";"-";"-";"-";"-";"-";"-";"-";"-";"6 746,50";"-27,50000%";"-20,56";"-20,56";"-";"-";"-";"-";"-";"-";"-";"-";"-";"-";"-";"-";"-";"-";"-";"-";"-";"-"
"29 Kw 2024 21:48:04";"Zmodyfikowano Transakcję Sprzedaży";"O2-CV-905XF2";"T2-CV-5EKH6W";"-";"Solana (USD)";"135 Jednost.";"133,770";"-";"-";"133,750";"-";"-";"-";"0,00";"-";"-";"-";"-";"-";"-";"-";"-";"-";"-";"-";"-";"-";"-";"-";"-";"-";"-";"-";"-";"-";"-";"-";"-";"-"
"29 Kw 2024 21:26:16";"Transakcja Sprzedaży";"O2-CV-905XF2";"T2-CV-5EKH6W";"-";"Solana (USD)";"135 Jednost.";"133,770";"-";"-";"-";"-";"4,046557";"73 076,57";"0,00";"-";"-";"-";"-";"-";"-";"-";"-";"-";"-";"-";"-";"-";"-";"-";"-";"-";"-";"-";"-";"-";"-";"-";"-";"-"
"29 Kw 2024 17:38:11";"Stop Loss";"O2-CV-905FCZ";"T2-CV-5EK498";"-";"Solana (USD)";"130 Jednost.";"135,905";"-";"-";"-";"-";"4,00875";"71 537,05";"99,02";"31 186,43";"-";"-";"-";"-";"-";"-";"-";"-";"-";"-";"-";"-";"-";"-";"-";"-";"-";"-";"-";"-";"-";"-";"-";"-"
"29 Kw 2024 17:37:51";"Zmodyfikowano Transakcję Sprzedaży";"O2-CV-905FCZ";"T2-CV-5EK3ZY";"-";"Solana (USD)";"130 Jednost.";"136,095";"-";"135,900";"134,800";"-";"-";"-";"0,00";"-";"-";"-";"-";"-";"-";"-";"-";"-";"-";"-";"-";"-";"-";"-";"-";"-";"-";"-";"-";"-";"-";"-";"-";"-"
"29 Kw 2024 17:36:27";"Zmodyfikowano Transakcję Sprzedaży";"O2-CV-905FCZ";"T2-CV-5EK3ZY";"-";"Solana (USD)";"130 Jednost.";"136,095";"-";"-";"134,800";"-";"-";"-";"0,00";"-";"-";"-";"-";"-";"-";"-";"-";"-";"-";"-";"-";"-";"-";"-";"-";"-";"-";"-";"-";"-";"-";"-";"-";"-"
"29 Kw 2024 17:35:18";"Transakcja Sprzedaży";"O2-CV-905FCZ";"T2-CV-5EK3ZY";"-";"Solana (USD)";"130 Jednost.";"136,095";"-";"-";"-";"-";"4,048731";"71 631,56";"0,00";"-";"-";"-";"-";"-";"-";"-";"-";"-";"-";"-";"-";"-";"-";"-";"-";"-";"-";"-";"-";"-";"-";"-";"-";"-"
"29 Kw 2024 16:44:12";"Stop Loss";"O2-CV-9054G3";"T2-CV-5EJW8R";"-";"Solana (USD)";"125 Jednost.";"136,653";"-";"-";"-";"-";"4,01758";"69 316,36";"46,20";"31 087,41";"-";"-";"-";"-";"-";"-";"-";"-";"-";"-";"-";"-";"-";"-";"-";"-";"-";"-";"-";"-";"-";"-";"-";"-"
"29 Kw 2024 16:44:02";"Zmodyfikowano Transakcję Sprzedaży";"O2-CV-9054G3";"T2-CV-5EJTLG";"-";"Solana (USD)";"125 Jednost.";"136,745";"-";"136,650";"135,000";"-";"-";"-";"0,00";"-";"-";"-";"-";"-";"-";"-";"-";"-";"-";"-";"-";"-";"-";"-";"-";"-";"-";"-";"-";"-";"-";"-";"-";"-"
"29 Kw 2024 16:39:09";"Zmodyfikowano Transakcję Sprzedaży";"O2-CV-9054G3";"T2-CV-5EJTLG";"-";"Solana (USD)";"125 Jednost.";"136,745";"-";"-";"135,000";"-";"-";"-";"0,00";"-";"-";"-";"-";"-";"-";"-";"-";"-";"-";"-";"-";"-";"-";"-";"-";"-";"-";"-";"-";"-";"-";"-";"-";"-"
"29 Kw 2024 16:38:19";"Transakcja Sprzedaży";"O2-CV-9054G3";"T2-CV-5EJTLG";"-";"Solana (USD)";"125 Jednost.";"136,745";"-";"-";"-";"-";"4,060755";"69 410,99";"0,00";"-";"-";"-";"-";"-";"-";"-";"-";"-";"-";"-";"-";"-";"-";"-";"-";"-";"-";"-";"-";"-";"-";"-";"-";"-"
"29 Kw 2024 15:36:39";"Take Profit";"O2-CV-904PVN";"T2-CV-5EJJ1D";"-";"Solana (USD)";"130 Jednost.";"135,100";"-";"-";"-";"-";"4,02401";"71 383,79";"272,02";"31 041,21";"-";"-";"-";"-";"-";"-";"-";"-";"-";"-";"-";"-";"-";"-";"-";"-";"-";"-";"-";"-";"-";"-";"-";"-"
"29 Kw 2024 15:01:50";"Zmodyfikowano Transakcję Sprzedaży";"O2-CV-904PVN";"T2-CV-5EJF6J";"-";"Solana (USD)";"130 Jednost.";"135,620";"-";"-";"135,100";"-";"-";"-";"0,00";"-";"-";"-";"-";"-";"-";"-";"-";"-";"-";"-";"-";"-";"-";"-";"-";"-";"-";"-";"-";"-";"-";"-";"-";"-"
"29 Kw 2024 15:00:58";"Transakcja Sprzedaży";"O2-CV-904PVN";"T2-CV-5EJF6J";"-";"Solana (USD)";"130 Jednost.";"135,620";"-";"-";"-";"-";"4,066346";"71 692,11";"0,00";"-";"-";"-";"-";"-";"-";"-";"-";"-";"-";"-";"-";"-";"-";"-";"-";"-";"-";"-";"-";"-";"-";"-";"-";"-"
"29 Kw 2024 13:47:35";"Take Profit";"O2-CV-904GY6";"T2-CV-5EJBZX";"-";"Solana (USD)";"130 Jednost.";"134,500";"-";"-";"-";"-";"4,01834";"70 966,91";"880,22";"30 769,19";"-";"-";"-";"-";"-";"-";"-";"-";"-";"-";"-";"-";"-";"-";"-";"-";"-";"-";"-";"-";"-";"-";"-";"-"
"29 Kw 2024 12:29:31";"Zmodyfikowano Transakcję Sprzedaży";"O2-CV-904GY6";"T2-CV-5EJ8P3";"-";"Solana (USD)";"130 Jednost.";"136,185";"-";"-";"134,500";"-";"-";"-";"0,00";"-";"-";"-";"-";"-";"-";"-";"-";"-";"-";"-";"-";"-";"-";"-";"-";"-";"-";"-";"-";"-";"-";"-";"-";"-"
"29 Kw 2024 12:27:25";"Transakcja Sprzedaży";"O2-CV-904GY6";"T2-CV-5EJ8P3";"-";"Solana (USD)";"130 Jednost.";"136,185";"-";"-";"-";"-";"4,055695";"71 802,22";"0,00";"-";"-";"-";"-";"-";"-";"-";"-";"-";"-";"-";"-";"-";"-";"-";"-";"-";"-";"-";"-";"-";"-";"-";"-";"-"
"29 Kw 2024 04:40:20";"Take Profit";"O2-CV-903G5Y";"T2-CV-5EHLSF";"-";"Solana (USD)";"123 Jednost.";"136,300";"-";"-";"-";"-";"4,0093";"67 891,02";"2 105,72";"29 888,97";"-";"-";"-";"-";"-";"-";"-";"-";"-";"-";"-";"-";"-";"-";"-";"-";"-";"-";"-";"-";"-";"-";"-";"-"
"29 Kw 2024 00:13:02";"Zmodyfikowano Transakcję Sprzedaży";"O2-CV-903G5Y";"T2-CV-5EHE07";"-";"Solana (USD)";"123 Jednost.";"140,570";"-";"-";"136,300";"-";"-";"-";"0,00";"-";"-";"-";"-";"-";"-";"-";"-";"-";"-";"-";"-";"-";"-";"-";"-";"-";"-";"-";"-";"-";"-";"-";"-";"-"
"29 Kw 2024 00:12:00";"Transakcja Sprzedaży";"O2-CV-903G5Y";"T2-CV-5EHE07";"-";"Solana (USD)";"123 Jednost.";"140,570";"-";"-";"-";"-";"4,054392";"70 100,88";"0,00";"-";"-";"-";"-";"-";"-";"-";"-";"-";"-";"-";"-";"-";"-";"-";"-";"-";"-";"-";"-";"-";"-";"-";"-";"-"
"29 Kw 2024 00:07:30";" Zamknięcie Transakcji";"O2-CV-903G2K";"T2-CV-5EHDY0";"O2-CV-903G00";"Solana (USD)";"122 Jednost.";"140,835";"-";"-";"-";"-";"4,01446";"69 668,92";"191,01";"27 783,25";"-";"-";"-";"-";"-";"-";"-";"-";"-";"-";"-";"-";"-";"-";"-";"-";"-";"-";"-";"-";"-";"-";"-";"-"
"29 Kw 2024 00:05:07";"Zmodyfikowano Transakcję Sprzedaży";"O2-CV-903G00";"T2-CV-5EHDVV";"-";"Solana (USD)";"122 Jednost.";"141,225";"-";"-";"136,500";"-";"-";"-";"0,00";"-";"-";"-";"-";"-";"-";"-";"-";"-";"-";"-";"-";"-";"-";"-";"-";"-";"-";"-";"-";"-";"-";"-";"-";"-"
"29 Kw 2024 00:04:17";"Transakcja Sprzedaży";"O2-CV-903G00";"T2-CV-5EHDVV";"-";"Solana (USD)";"122 Jednost.";"141,225";"-";"-";"-";"-";"4,054943";"69 864,43";"0,00";"-";"-";"-";"-";"-";"-";"-";"-";"-";"-";"-";"-";"-";"-";"-";"-";"-";"-";"-";"-";"-";"-";"-";"-";"-"
"26 Kw 2024 23:01:03";"Koszty Utrzymania Pozycji";"1330940838";"-";"-";"Rachunek";"-";"-";"-";"-";"-";"-";"-";"-";"-65,45";"27 592,24";"-";"-";"-";"-";"-";"-65,45";"-";"-";"-";"-";"-";"-";"-";"-";"-";"-";"-";"-";"-";"-";"-";"-";"-";"-"
"26 Kw 2024 23:01:03";"Koszty Utrzymania Pozycji";"O2-CR-8Z7P36";"-";"-";"Solana (USD)";"-";"-";"-";"-";"-";"-";"-";"-";"-";"-";"-";"-";"7 135,95";"-27,50000%";"-65,45";"-65,45";"-";"-";"-";"-";"-";"-";"-";"-";"-";"-";"-";"-";"-";"-";"-";"-";"-";"-"
"26 Kw 2024 02:33:09";"Take Profit";"O2-CT-8ZZM3B";"T2-CT-5EFEJ1";"-";"Solana (USD)";"122 Jednost.";"142,800";"-";"-";"-";"-";"4,00238";"70 428,71";"35,16";"27 657,69";"-";"-";"-";"-";"-";"-";"-";"-";"-";"-";"-";"-";"-";"-";"-";"-";"-";"-";"-";"-";"-";"-";"-";"-"
"26 Kw 2024 00:21:54";"Zmodyfikowano Take Profit";"O2-CT-8ZZM3B";"-";"O2-CT-9003KH";"Solana (USD)";"122 Jednost.";"142,872";"-";"-";"142,800";"-";"-";"-";"-";"-";"-";"-";"-";"-";"-";"-";"-";"-";"-";"-";"-";"-";"-";"-";"-";"-";"-";"-";"-";"-";"-";"-";"-";"-"
"25 Kw 2024 23:01:00";"Koszty Utrzymania Pozycji";"1330482724";"-";"-";"Rachunek";"-";"-";"-";"-";"-";"-";"-";"-";"-2,72";"27 622,53";"-";"-";"-";"-";"-";"-2,72";"-";"-";"-";"-";"-";"-";"-";"-";"-";"-";"-";"-";"-";"-";"-";"-";"-";"-"
"25 Kw 2024 23:01:00";"Koszty Utrzymania Pozycji";"O2-CR-8Z7P36";"-";"-";"Solana (USD)";"-";"-";"-";"-";"-";"-";"-";"-";"-";"-";"-";"-";"7 370,25";"-27,50000%";"-22,44";"-22,44";"-";"-";"-";"-";"-";"-";"-";"-";"-";"-";"-";"-";"-";"-";"-";"-";"-";"-"
"25 Kw 2024 23:01:00";"Koszty Utrzymania Pozycji";"O2-CT-8ZZM3B";"-";"-";"Solana (USD)";"-";"-";"-";"-";"-";"-";"-";"-";"-";"-";"-";"-";"17 983,41";"-10,00000%";"19,72";"19,72";"-";"-";"-";"-";"-";"-";"-";"-";"-";"-";"-";"-";"-";"-";"-";"-";"-";"-"
"25 Kw 2024 16:44:43";"Zmodyfikowano Transakcję Sprzedaży";"O2-CT-8ZZM3B";"T2-CT-5EE2YR";"-";"Solana (USD)";"122 Jednost.";"142,872";"-";"-";"142,000";"-";"-";"-";"0,00";"-";"-";"-";"-";"-";"-";"-";"-";"-";"-";"-";"-";"-";"-";"-";"-";"-";"-";"-";"-";"-";"-";"-";"-";"-"
"25 Kw 2024 15:23:23";"Transakcja Sprzedaży";"O2-CT-8ZZM3B";"T2-CT-5EE2YR";"-";"Solana (USD)";"122 Jednost.";"142,872";"-";"-";"-";"-";"4,068581";"70 916,92";"0,00";"-";"-";"-";"-";"-";"-";"-";"-";"-";"-";"-";"-";"-";"-";"-";"-";"-";"-";"-";"-";"-";"-";"-";"-";"-"
"25 Kw 2024 15:17:36";"Stop Loss";"O2-CT-8ZZJ95";"T2-CT-5EE27G";"-";"Solana (USD)";"120 Jednost.";"142,620";"-";"-";"-";"-";"4,03408";"69 734,55";"239,62";"27 625,25";"-";"-";"-";"-";"-";"-";"-";"-";"-";"-";"-";"-";"-";"-";"-";"-";"-";"-";"-";"-";"-";"-";"-";"-"
"25 Kw 2024 15:17:18";"Zmodyfikowano Transakcję Sprzedaży";"O2-CT-8ZZJ95";"T2-CT-5EE0B9";"-";"Solana (USD)";"120 Jednost.";"143,115";"-";"142,600";"-";"-";"-";"-";"0,00";"-";"-";"-";"-";"-";"-";"-";"-";"-";"-";"-";"-";"-";"-";"-";"-";"-";"-";"-";"-";"-";"-";"-";"-";"-"
"25 Kw 2024 15:07:16";"Transakcja Sprzedaży";"O2-CT-8ZZJ95";"T2-CT-5EE0B9";"-";"Solana (USD)";"120 Jednost.";"143,115";"-";"-";"-";"-";"4,070274";"69 902,07";"0,00";"-";"-";"-";"-";"-";"-";"-";"-";"-";"-";"-";"-";"-";"-";"-";"-";"-";"-";"-";"-";"-";"-";"-";"-";"-"
"25 Kw 2024 14:49:11";"Stop Loss";"O2-CT-8ZZ6HT";"T2-CT-5EDXWB";"-";"Solana (USD)";"122 Jednost.";"143,730";"-";"-";"-";"-";"4,02486";"71 285,70";"4,91";"27 385,63";"-";"-";"-";"-";"-";"-";"-";"-";"-";"-";"-";"-";"-";"-";"-";"-";"-";"-";"-";"-";"-";"-";"-";"-"
"25 Kw 2024 14:48:28";"Zmodyfikowano Transakcję Sprzedaży";"O2-CT-8ZZ6HT";"T2-CT-5EDP9H";"-";"Solana (USD)";"122 Jednost.";"143,740";"-";"143,700";"142,000";"-";"-";"-";"0,00";"-";"-";"-";"-";"-";"-";"-";"-";"-";"-";"-";"-";"-";"-";"-";"-";"-";"-";"-";"-";"-";"-";"-";"-";"-"
"25 Kw 2024 14:37:11";"Zmodyfikowano Take Profit";"O2-CT-8ZZ6HT";"-";"O2-CT-8ZZ6MD";"Solana (USD)";"122 Jednost.";"143,740";"-";"-";"142,000";"-";"-";"-";"-";"-";"-";"-";"-";"-";"-";"-";"-";"-";"-";"-";"-";"-";"-";"-";"-";"-";"-";"-";"-";"-";"-";"-";"-";"-"
"25 Kw 2024 13:10:59";"Zmodyfikowano Transakcję Sprzedaży";"O2-CT-8ZZ6HT";"T2-CT-5EDP9H";"-";"Solana (USD)";"122 Jednost.";"143,740";"-";"-";"142,800";"-";"-";"-";"0,00";"-";"-";"-";"-";"-";"-";"-";"-";"-";"-";"-";"-";"-";"-";"-";"-";"-";"-";"-";"-";"-";"-";"-";"-";"-"
"25 Kw 2024 13:08:22";"Transakcja Sprzedaży";"O2-CT-8ZZ6HT";"T2-CT-5EDP9H";"-";"Solana (USD)";"122 Jednost.";"143,740";"-";"-";"-";"-";"4,044142";"70 919,20";"0,00";"-";"-";"-";"-";"-";"-";"-";"-";"-";"-";"-";"-";"-";"-";"-";"-";"-";"-";"-";"-";"-";"-";"-";"-";"-"
"25 Kw 2024 13:04:35";"Odrzucono Zlecenie: brak wystarczających środków";"O2-CT-8ZZ6C5";"-";"-";"Solana (USD)";"125 Jednost.";"-";"-";"-";"-";"-";"-";"-";"-";"-";"-";"-";"-";"-";"-";"-";"-";"-";"-";"-";"-";"-";"-";"-";"-";"-";"-";"-";"-";"-";"-";"-";"-";"-"
"25 Kw 2024 12:59:33";"Stop Loss";"O2-CT-8ZZ4JX";"T2-CT-5EDNTX";"-";"Solana (USD)";"120 Jednost.";"143,900";"-";"-";"-";"-";"4,00406";"69 836,83";"38,44";"27 380,72";"-";"-";"-";"-";"-";"-";"-";"-";"-";"-";"-";"-";"-";"-";"-";"-";"-";"-";"-";"-";"-";"-";"-";"-"
"25 Kw 2024 12:59:29";"Zmodyfikowano Transakcję Sprzedaży";"O2-CT-8ZZ4JX";"T2-CT-5EDMJJ";"-";"Solana (USD)";"120 Jednost.";"143,980";"-";"143,900";"141,500";"-";"-";"-";"0,00";"-";"-";"-";"-";"-";"-";"-";"-";"-";"-";"-";"-";"-";"-";"-";"-";"-";"-";"-";"-";"-";"-";"-";"-";"-"
"25 Kw 2024 12:59:29";"Zmodyfikowano Take Profit";"O2-CT-8ZZ4JX";"-";"O2-CT-8ZZ4LC";"Solana (USD)";"120 Jednost.";"143,980";"-";"-";"141,500";"-";"-";"-";"-";"-";"-";"-";"-";"-";"-";"-";"-";"-";"-";"-";"-";"-";"-";"-";"-";"-";"-";"-";"-";"-";"-";"-";"-";"-"
"25 Kw 2024 12:25:05";"Zmodyfikowano Transakcję Sprzedaży";"O2-CT-8ZZ4JX";"T2-CT-5EDMJJ";"-";"Solana (USD)";"120 Jednost.";"143,980";"-";"-";"142,600";"-";"-";"-";"0,00";"-";"-";"-";"-";"-";"-";"-";"-";"-";"-";"-";"-";"-";"-";"-";"-";"-";"-";"-";"-";"-";"-";"-";"-";"-"
"25 Kw 2024 12:23:58";"Transakcja Sprzedaży";"O2-CT-8ZZ4JX";"T2-CT-5EDMJJ";"-";"Solana (USD)";"120 Jednost.";"143,980";"-";"-";"-";"-";"4,04322";"69 857,13";"0,00";"-";"-";"-";"-";"-";"-";"-";"-";"-";"-";"-";"-";"-";"-";"-";"-";"-";"-";"-";"-";"-";"-";"-";"-";"-"
"25 Kw 2024 12:21:03";"Stop Loss";"O2-CT-8ZZ43X";"T2-CT-5EDMFJ";"-";"Solana (USD)";"120 Jednost.";"144,050";"-";"-";"-";"-";"4,00338";"69 897,85";"420,84";"27 342,28";"-";"-";"-";"-";"-";"-";"-";"-";"-";"-";"-";"-";"-";"-";"-";"-";"-";"-";"-";"-";"-";"-";"-";"-"
"25 Kw 2024 12:20:48";"Zmodyfikowano Stop Loss";"O2-CT-8ZZ43X";"-";"O2-CT-8ZZ4D6";"Solana (USD)";"120 Jednost.";"144,926";"-";"144,000";"-";"-";"-";"-";"-";"-";"-";"-";"-";"-";"-";"-";"-";"-";"-";"-";"-";"-";"-";"-";"-";"-";"-";"-";"-";"-";"-";"-";"-";"-"
"25 Kw 2024 12:20:09";"Zmodyfikowano Transakcję Sprzedaży";"O2-CT-8ZZ43X";"T2-CT-5EDM69";"-";"Solana (USD)";"120 Jednost.";"144,926";"-";"144,200";"143,400";"-";"-";"-";"0,00";"-";"-";"-";"-";"-";"-";"-";"-";"-";"-";"-";"-";"-";"-";"-";"-";"-";"-";"-";"-";"-";"-";"-";"-";"-"
"25 Kw 2024 12:14:59";"Zmodyfikowano Transakcję Sprzedaży";"O2-CT-8ZZ43X";"T2-CT-5EDM69";"-";"Solana (USD)";"120 Jednost.";"144,926";"-";"-";"143,400";"-";"-";"-";"0,00";"-";"-";"-";"-";"-";"-";"-";"-";"-";"-";"-";"-";"-";"-";"-";"-";"-";"-";"-";"-";"-";"-";"-";"-";"-"
"25 Kw 2024 12:14:05";"Transakcja Sprzedaży";"O2-CT-8ZZ43X";"T2-CT-5EDM69";"-";"Solana (USD)";"120 Jednost.";"144,926";"-";"-";"-";"-";"4,046747";"70 377,46";"0,00";"-";"-";"-";"-";"-";"-";"-";"-";"-";"-";"-";"-";"-";"-";"-";"-";"-";"-";"-";"-";"-";"-";"-";"-";"-"
"25 Kw 2024 12:10:50";"Take Profit";"O2-CT-8ZZ0DJ";"T2-CT-5EDM2X";"-";"Solana (USD)";"120 Jednost.";"144,600";"-";"-";"-";"-";"4,00552";"70 202,46";"406,16";"26 921,44";"-";"-";"-";"-";"-";"-";"-";"-";"-";"-";"-";"-";"-";"-";"-";"-";"-";"-";"-";"-";"-";"-";"-";"-"
"25 Kw 2024 12:10:45";"Zmodyfikowano Transakcję Sprzedaży";"O2-CT-8ZZ0DJ";"T2-CT-5EDJ6N";"-";"Solana (USD)";"120 Jednost.";"145,445";"-";"145,200";"144,600";"-";"-";"-";"0,00";"-";"-";"-";"-";"-";"-";"-";"-";"-";"-";"-";"-";"-";"-";"-";"-";"-";"-";"-";"-";"-";"-";"-";"-";"-"
"25 Kw 2024 10:39:41";"Zmodyfikowano Transakcję Sprzedaży";"O2-CT-8ZZ0DJ";"T2-CT-5EDJ6N";"-";"Solana (USD)";"120 Jednost.";"145,445";"-";"-";"144,600";"-";"-";"-";"0,00";"-";"-";"-";"-";"-";"-";"-";"-";"-";"-";"-";"-";"-";"-";"-";"-";"-";"-";"-";"-";"-";"-";"-";"-";"-"
"25 Kw 2024 10:38:03";"Transakcja Sprzedaży";"O2-CT-8ZZ0DJ";"T2-CT-5EDJ6N";"-";"Solana (USD)";"120 Jednost.";"145,445";"-";"-";"-";"-";"4,046446";"70 624,24";"0,00";"-";"-";"-";"-";"-";"-";"-";"-";"-";"-";"-";"-";"-";"-";"-";"-";"-";"-";"-";"-";"-";"-";"-";"-";"-"
"25 Kw 2024 10:35:13";" Zamknięcie Transakcji";"O2-CT-8ZZ05V";"T2-CT-5EDJ2M";"O2-CT-8ZYWW6";"Solana (USD)";"120 Jednost.";"146,115";"-";"-";"-";"-";"4,00619";"70 949,75";"45,67";"26 515,28";"-";"-";"-";"-";"-";"-";"-";"-";"-";"-";"-";"-";"-";"-";"-";"-";"-";"-";"-";"-";"-";"-";"-";"-"
"25 Kw 2024 09:49:30";"Zmodyfikowano Transakcję Sprzedaży";"O2-CT-8ZYWW6";"T2-CT-5EDFEH";"-";"Solana (USD)";"120 Jednost.";"146,210";"-";"-";"145,200";"-";"-";"-";"0,00";"-";"-";"-";"-";"-";"-";"-";"-";"-";"-";"-";"-";"-";"-";"-";"-";"-";"-";"-";"-";"-";"-";"-";"-";"-"
"25 Kw 2024 09:48:38";"Transakcja Sprzedaży";"O2-CT-8ZYWW6";"T2-CT-5EDFEH";"-";"Solana (USD)";"120 Jednost.";"146,210";"-";"-";"-";"-";"4,055254";"71 150,24";"0,00";"-";"-";"-";"-";"-";"-";"-";"-";"-";"-";"-";"-";"-";"-";"-";"-";"-";"-";"-";"-";"-";"-";"-";"-";"-"
"25 Kw 2024 09:44:06";"Stop Loss";"O2-CT-8ZYR5F";"T2-CT-5EDF6L";"-";"Solana (USD)";"120 Jednost.";"146,200";"-";"-";"-";"-";"4,01431";"71 134,65";"400,79";"26 469,61";"-";"-";"-";"-";"-";"-";"-";"-";"-";"-";"-";"-";"-";"-";"-";"-";"-";"-";"-";"-";"-";"-";"-";"-"
"25 Kw 2024 09:43:32";"Zmodyfikowano Stop Loss";"O2-CT-8ZYR5F";"-";"O2-CT-8ZYWHT";"Solana (USD)";"120 Jednost.";"147,032";"-";"146,200";"-";"-";"-";"-";"-";"-";"-";"-";"-";"-";"-";"-";"-";"-";"-";"-";"-";"-";"-";"-";"-";"-";"-";"-";"-";"-";"-";"-";"-";"-"
"25 Kw 2024 09:42:55";"Zmodyfikowano Take Profit";"O2-CT-8ZYR5F";"-";"O2-CT-8ZYRB3";"Solana (USD)";"120 Jednost.";"147,032";"-";"-";"145,000";"-";"-";"-";"-";"-";"-";"-";"-";"-";"-";"-";"-";"-";"-";"-";"-";"-";"-";"-";"-";"-";"-";"-";"-";"-";"-";"-";"-";"-"
"25 Kw 2024 09:41:57";"Zmodyfikowano Stop Loss";"O2-CT-8ZYR5F";"-";"O2-CT-8ZYWHT";"Solana (USD)";"120 Jednost.";"147,032";"-";"146,500";"-";"-";"-";"-";"-";"-";"-";"-";"-";"-";"-";"-";"-";"-";"-";"-";"-";"-";"-";"-";"-";"-";"-";"-";"-";"-";"-";"-";"-";"-"
"25 Kw 2024 09:39:15";"Zmodyfikowano Transakcję Sprzedaży";"O2-CT-8ZYR5F";"T2-CT-5EDBG7";"-";"Solana (USD)";"120 Jednost.";"147,032";"-";"146,800";"145,600";"-";"-";"-";"0,00";"-";"-";"-";"-";"-";"-";"-";"-";"-";"-";"-";"-";"-";"-";"-";"-";"-";"-";"-";"-";"-";"-";"-";"-";"-"
"25 Kw 2024 08:52:37";"Zmodyfikowano Transakcję Sprzedaży";"O2-CT-8ZYR5F";"T2-CT-5EDBG7";"-";"Solana (USD)";"120 Jednost.";"147,032";"-";"-";"145,600";"-";"-";"-";"0,00";"-";"-";"-";"-";"-";"-";"-";"-";"-";"-";"-";"-";"-";"-";"-";"-";"-";"-";"-";"-";"-";"-";"-";"-";"-"
"25 Kw 2024 08:49:27";"Transakcja Sprzedaży";"O2-CT-8ZYR5F";"T2-CT-5EDBG7";"-";"Solana (USD)";"120 Jednost.";"147,032";"-";"-";"-";"-";"4,054843";"71 543,00";"0,00";"-";"-";"-";"-";"-";"-";"-";"-";"-";"-";"-";"-";"-";"-";"-";"-";"-";"-";"-";"-";"-";"-";"-";"-";"-"
"25 Kw 2024 00:27:00";"Stop Loss";"O2-CT-8ZYERH";"T2-CT-5ED33P";"-";"Solana (USD)";"118 Jednost.";"148,205";"-";"-";"-";"-";"4,03271";"71 233,42";"173,69";"26 068,82";"-";"-";"-";"-";"-";"-";"-";"-";"-";"-";"-";"-";"-";"-";"-";"-";"-";"-";"-";"-";"-";"-";"-";"-"
"25 Kw 2024 00:23:06";"Zmodyfikowano Transakcję Sprzedaży";"O2-CT-8ZYERH";"T2-CT-5ED2HM";"-";"Solana (USD)";"118 Jednost.";"148,570";"-";"148,150";"146,500";"-";"-";"-";"0,00";"-";"-";"-";"-";"-";"-";"-";"-";"-";"-";"-";"-";"-";"-";"-";"-";"-";"-";"-";"-";"-";"-";"-";"-";"-"
"24 Kw 2024 23:55:11";"Zmodyfikowano Take Profit";"O2-CT-8ZYERH";"-";"O2-CT-8ZYET4";"Solana (USD)";"118 Jednost.";"148,570";"-";"-";"146,500";"-";"-";"-";"-";"-";"-";"-";"-";"-";"-";"-";"-";"-";"-";"-";"-";"-";"-";"-";"-";"-";"-";"-";"-";"-";"-";"-";"-";"-"
"24 Kw 2024 23:27:30";"Zmodyfikowano Transakcję Sprzedaży";"O2-CT-8ZYERH";"T2-CT-5ED2HM";"-";"Solana (USD)";"118 Jednost.";"148,570";"-";"-";"147,600";"-";"-";"-";"0,00";"-";"-";"-";"-";"-";"-";"-";"-";"-";"-";"-";"-";"-";"-";"-";"-";"-";"-";"-";"-";"-";"-";"-";"-";"-"
"24 Kw 2024 23:16:18";"Transakcja Sprzedaży";"O2-CT-8ZYERH";"T2-CT-5ED2HM";"-";"Solana (USD)";"118 Jednost.";"148,570";"-";"-";"-";"-";"4,071376";"71 376,35";"0,00";"-";"-";"-";"-";"-";"-";"-";"-";"-";"-";"-";"-";"-";"-";"-";"-";"-";"-";"-";"-";"-";"-";"-";"-";"-"
"24 Kw 2024 23:12:27";"Stop Loss";"O2-CT-8ZYEN4";"T2-CT-5ED2H4";"-";"Solana (USD)";"118 Jednost.";"148,304";"-";"-";"-";"-";"4,03201";"71 268,89";"209,82";"25 895,13";"-";"-";"-";"-";"-";"-";"-";"-";"-";"-";"-";"-";"-";"-";"-";"-";"-";"-";"-";"-";"-";"-";"-";"-"
"24 Kw 2024 23:12:26";"Zmodyfikowano Transakcję Sprzedaży";"O2-CT-8ZYEN4";"T2-CT-5ED2FF";"-";"Solana (USD)";"118 Jednost.";"148,745";"-";"148,300";"147,800";"-";"-";"-";"0,00";"-";"-";"-";"-";"-";"-";"-";"-";"-";"-";"-";"-";"-";"-";"-";"-";"-";"-";"-";"-";"-";"-";"-";"-";"-"
"24 Kw 2024 23:06:49";"Zmodyfikowano Transakcję Sprzedaży";"O2-CT-8ZYEN4";"T2-CT-5ED2FF";"-";"Solana (USD)";"118 Jednost.";"148,745";"-";"-";"147,800";"-";"-";"-";"0,00";"-";"-";"-";"-";"-";"-";"-";"-";"-";"-";"-";"-";"-";"-";"-";"-";"-";"-";"-";"-";"-";"-";"-";"-";"-"
"24 Kw 2024 23:04:28";"Transakcja Sprzedaży";"O2-CT-8ZYEN4";"T2-CT-5ED2FF";"-";"Solana (USD)";"118 Jednost.";"148,745";"-";"-";"-";"-";"4,072067";"71 472,55";"0,00";"-";"-";"-";"-";"-";"-";"-";"-";"-";"-";"-";"-";"-";"-";"-";"-";"-";"-";"-";"-";"-";"-";"-";"-";"-"
"24 Kw 2024 23:03:57";"Odrzucono Zlecenie: brak wystarczających środków";"O2-CT-8ZYEMF";"-";"-";"Solana (USD)";"120 Jednost.";"-";"-";"-";"-";"-";"-";"-";"-";"-";"-";"-";"-";"-";"-";"-";"-";"-";"-";"-";"-";"-";"-";"-";"-";"-";"-";"-";"-";"-";"-";"-";"-";"-"
"24 Kw 2024 23:01:03";"Koszty Utrzymania Pozycji";"1330003179";"-";"-";"Rachunek";"-";"-";"-";"-";"-";"-";"-";"-";"-22,84";"25 685,31";"-";"-";"-";"-";"-";"-22,84";"-";"-";"-";"-";"-";"-";"-";"-";"-";"-";"-";"-";"-";"-";"-";"-";"-";"-"
"24 Kw 2024 23:01:03";"Koszty Utrzymania Pozycji";"O2-CR-8Z7P36";"-";"-";"Solana (USD)";"-";"-";"-";"-";"-";"-";"-";"-";"-";"-";"-";"-";"7 445,15";"-27,50000%";"-22,84";"-22,84";"-";"-";"-";"-";"-";"-";"-";"-";"-";"-";"-";"-";"-";"-";"-";"-";"-";"-"
"24 Kw 2024 22:23:21";"Stop Loss";"O2-CT-8ZYCXB";"T2-CT-5ED164";"-";"Solana (USD)";"118 Jednost.";"149,135";"-";"-";"-";"-";"4,03208";"71 669,31";"133,22";"25 708,15";"-";"-";"-";"-";"-";"-";"-";"-";"-";"-";"-";"-";"-";"-";"-";"-";"-";"-";"-";"-";"-";"-";"-";"-"
"24 Kw 2024 22:23:06";"Zmodyfikowano Stop Loss";"O2-CT-8ZYCXB";"-";"O2-CT-8ZYD2G";"Solana (USD)";"118 Jednost.";"149,415";"-";"149,100";"-";"-";"-";"-";"-";"-";"-";"-";"-";"-";"-";"-";"-";"-";"-";"-";"-";"-";"-";"-";"-";"-";"-";"-";"-";"-";"-";"-";"-";"-"
"24 Kw 2024 22:22:45";"Zmodyfikowano Transakcję Sprzedaży";"O2-CT-8ZYCXB";"T2-CT-5ED0YD";"-";"Solana (USD)";"118 Jednost.";"149,415";"-";"149,300";"147,921";"-";"-";"-";"0,00";"-";"-";"-";"-";"-";"-";"-";"-";"-";"-";"-";"-";"-";"-";"-";"-";"-";"-";"-";"-";"-";"-";"-";"-";"-"
"24 Kw 2024 22:20:50";"Transakcja Sprzedaży";"O2-CT-8ZYCXB";"T2-CT-5ED0YD";"-";"Solana (USD)";"118 Jednost.";"149,415";"-";"-";"-";"-";"4,071887";"71 791,31";"0,00";"-";"-";"-";"-";"-";"-";"-";"-";"-";"-";"-";"-";"-";"-";"-";"-";"-";"-";"-";"-";"-";"-";"-";"-";"-"
"24 Kw 2024 22:15:38";"Stop Loss";"O2-CT-8ZYCHL";"T2-CT-5ED0P0";"-";"Solana (USD)";"117 Jednost.";"149,660";"-";"-";"-";"-";"4,03113";"71 295,25";"235,82";"25 574,93";"-";"-";"-";"-";"-";"-";"-";"-";"-";"-";"-";"-";"-";"-";"-";"-";"-";"-";"-";"-";"-";"-";"-";"-"
"24 Kw 2024 22:15:19";"Zmodyfikowano Stop Loss";"O2-CT-8ZYCHL";"-";"O2-CT-8ZYCL9";"Solana (USD)";"117 Jednost.";"150,160";"-";"149,650";"-";"-";"-";"-";"-";"-";"-";"-";"-";"-";"-";"-";"-";"-";"-";"-";"-";"-";"-";"-";"-";"-";"-";"-";"-";"-";"-";"-";"-";"-"
"24 Kw 2024 22:14:22";"Zmodyfikowano Transakcję Sprzedaży";"O2-CT-8ZYCHL";"T2-CT-5ED0KJ";"-";"Solana (USD)";"117 Jednost.";"150,160";"-";"149,850";"148,400";"-";"-";"-";"0,00";"-";"-";"-";"-";"-";"-";"-";"-";"-";"-";"-";"-";"-";"-";"-";"-";"-";"-";"-";"-";"-";"-";"-";"-";"-"
"24 Kw 2024 22:13:23";"Zmodyfikowano Transakcję Sprzedaży";"O2-CT-8ZYCHL";"T2-CT-5ED0KJ";"-";"Solana (USD)";"117 Jednost.";"150,160";"-";"-";"148,400";"-";"-";"-";"0,00";"-";"-";"-";"-";"-";"-";"-";"-";"-";"-";"-";"-";"-";"-";"-";"-";"-";"-";"-";"-";"-";"-";"-";"-";"-"
"24 Kw 2024 22:12:36";"Transakcja Sprzedaży";"O2-CT-8ZYCHL";"T2-CT-5ED0KJ";"-";"Solana (USD)";"117 Jednost.";"150,160";"-";"-";"-";"-";"4,071536";"71 531,67";"0,00";"-";"-";"-";"-";"-";"-";"-";"-";"-";"-";"-";"-";"-";"-";"-";"-";"-";"-";"-";"-";"-";"-";"-";"-";"-"
"24 Kw 2024 22:11:26";" Zamknięcie Transakcji";"O2-CT-8ZYCFD";"T2-CT-5ED0J5";"O2-CT-8ZYBGQ";"Solana (USD)";"117 Jednost.";"149,750";"-";"-";"-";"-";"4,03122";"71 339,71";"96,69";"25 339,11";"-";"-";"-";"-";"-";"-";"-";"-";"-";"-";"-";"-";"-";"-";"-";"-";"-";"-";"-";"-";"-";"-";"-";"-"
"24 Kw 2024 22:09:38";"Zmodyfikowano Transakcję Sprzedaży";"O2-CT-8ZYBGQ";"T2-CT-5ECZHQ";"-";"Solana (USD)";"117 Jednost.";"149,955";"-";"149,800";"148,800";"-";"-";"-";"0,00";"-";"-";"-";"-";"-";"-";"-";"-";"-";"-";"-";"-";"-";"-";"-";"-";"-";"-";"-";"-";"-";"-";"-";"-";"-"
"24 Kw 2024 22:02:14";"Zmodyfikowano Transakcję Sprzedaży";"O2-CT-8ZYBGQ";"T2-CT-5ECZHQ";"-";"Solana (USD)";"117 Jednost.";"149,955";"-";"-";"148,800";"-";"-";"-";"0,00";"-";"-";"-";"-";"-";"-";"-";"-";"-";"-";"-";"-";"-";"-";"-";"-";"-";"-";"-";"-";"-";"-";"-";"-";"-"
"24 Kw 2024 22:00:38";"Transakcja Sprzedaży";"O2-CT-8ZYBGQ";"T2-CT-5ECZHQ";"-";"Solana (USD)";"117 Jednost.";"149,955";"-";"-";"-";"-";"4,071146";"71 427,17";"0,00";"-";"-";"-";"-";"-";"-";"-";"-";"-";"-";"-";"-";"-";"-";"-";"-";"-";"-";"-";"-";"-";"-";"-";"-";"-"
"24 Kw 2024 21:56:14";"Stop Loss";"O2-CT-8ZY9ZJ";"T2-CT-5ECZ88";"-";"Solana (USD)";"116 Jednost.";"149,900";"-";"-";"-";"-";"4,02847";"70 752,54";"114,49";"25 242,42";"-";"-";"-";"-";"-";"-";"-";"-";"-";"-";"-";"-";"-";"-";"-";"-";"-";"-";"-";"-";"-";"-";"-";"-"
"24 Kw 2024 21:56:04";"Zmodyfikowano Transakcję Sprzedaży";"O2-CT-8ZY9ZJ";"T2-CT-5ECZ2H";"-";"Solana (USD)";"116 Jednost.";"150,145";"-";"149,900";"147,800";"-";"-";"-";"0,00";"-";"-";"-";"-";"-";"-";"-";"-";"-";"-";"-";"-";"-";"-";"-";"-";"-";"-";"-";"-";"-";"-";"-";"-";"-"
"24 Kw 2024 21:52:45";"Zmodyfikowano Transakcję Sprzedaży";"O2-CT-8ZY9ZJ";"T2-CT-5ECZ2H";"-";"Solana (USD)";"116 Jednost.";"150,145";"-";"-";"147,800";"-";"-";"-";"0,00";"-";"-";"-";"-";"-";"-";"-";"-";"-";"-";"-";"-";"-";"-";"-";"-";"-";"-";"-";"-";"-";"-";"-";"-";"-"
"24 Kw 2024 21:51:52";"Transakcja Sprzedaży";"O2-CT-8ZY9ZJ";"T2-CT-5ECZ2H";"-";"Solana (USD)";"116 Jednost.";"150,145";"-";"-";"-";"-";"4,069212";"70 872,73";"0,00";"-";"-";"-";"-";"-";"-";"-";"-";"-";"-";"-";"-";"-";"-";"-";"-";"-";"-";"-";"-";"-";"-";"-";"-";"-"
"24 Kw 2024 21:44:54";"Stop Loss";"O2-CT-8ZY9G8";"T2-CT-5ECYM3";"-";"Solana (USD)";"115 Jednost.";"149,610";"-";"-";"-";"-";"4,02798";"69 998,29";"275,61";"25 127,93";"-";"-";"-";"-";"-";"-";"-";"-";"-";"-";"-";"-";"-";"-";"-";"-";"-";"-";"-";"-";"-";"-";"-";"-"
"24 Kw 2024 21:44:46";"Zmodyfikowano Stop Loss";"O2-CT-8ZY9G8";"-";"O2-CT-8ZY9K4";"Solana (USD)";"115 Jednost.";"150,205";"-";"149,600";"-";"-";"-";"-";"-";"-";"-";"-";"-";"-";"-";"-";"-";"-";"-";"-";"-";"-";"-";"-";"-";"-";"-";"-";"-";"-";"-";"-";"-";"-"
"24 Kw 2024 21:44:27";"Zmodyfikowano Transakcję Sprzedaży";"O2-CT-8ZY9G8";"T2-CT-5ECYJ1";"-";"Solana (USD)";"115 Jednost.";"150,205";"-";"149,700";"147,800";"-";"-";"-";"0,00";"-";"-";"-";"-";"-";"-";"-";"-";"-";"-";"-";"-";"-";"-";"-";"-";"-";"-";"-";"-";"-";"-";"-";"-";"-"
"24 Kw 2024 21:43:05";"Zmodyfikowano Transakcję Sprzedaży";"O2-CT-8ZY9G8";"T2-CT-5ECYJ1";"-";"Solana (USD)";"115 Jednost.";"150,205";"-";"-";"147,800";"-";"-";"-";"0,00";"-";"-";"-";"-";"-";"-";"-";"-";"-";"-";"-";"-";"-";"-";"-";"-";"-";"-";"-";"-";"-";"-";"-";"-";"-"
"24 Kw 2024 21:42:29";"Transakcja Sprzedaży";"O2-CT-8ZY9G8";"T2-CT-5ECYJ1";"-";"Solana (USD)";"115 Jednost.";"150,205";"-";"-";"-";"-";"4,0682";"70 272,35";"0,00";"-";"-";"-";"-";"-";"-";"-";"-";"-";"-";"-";"-";"-";"-";"-";"-";"-";"-";"-";"-";"-";"-";"-";"-";"-"
"24 Kw 2024 20:12:00";"Stop Loss";"O2-CT-8ZXTRJ";"T2-CT-5ECSE7";"-";"Solana (USD)";"115 Jednost.";"151,313";"-";"-";"-";"-";"4,03102";"70 848,60";"258,21";"24 852,32";"-";"-";"-";"-";"-";"-";"-";"-";"-";"-";"-";"-";"-";"-";"-";"-";"-";"-";"-";"-";"-";"-";"-";"-"
"24 Kw 2024 20:11:51";"Zmodyfikowano Transakcję Sprzedaży";"O2-CT-8ZXTRJ";"T2-CT-5ECK20";"-";"Solana (USD)";"115 Jednost.";"151,870";"-";"151,300";"148,500";"-";"-";"-";"0,00";"-";"-";"-";"-";"-";"-";"-";"-";"-";"-";"-";"-";"-";"-";"-";"-";"-";"-";"-";"-";"-";"-";"-";"-";"-"
"24 Kw 2024 18:03:52";"Zmodyfikowano Transakcję Sprzedaży";"O2-CT-8ZXTRJ";"T2-CT-5ECK20";"-";"Solana (USD)";"115 Jednost.";"151,870";"-";"-";"148,500";"-";"-";"-";"0,00";"-";"-";"-";"-";"-";"-";"-";"-";"-";"-";"-";"-";"-";"-";"-";"-";"-";"-";"-";"-";"-";"-";"-";"-";"-"
"24 Kw 2024 18:03:21";"Transakcja Sprzedaży";"O2-CT-8ZXTRJ";"T2-CT-5ECK20";"-";"Solana (USD)";"115 Jednost.";"151,870";"-";"-";"-";"-";"4,073761";"71 148,43";"0,00";"-";"-";"-";"-";"-";"-";"-";"-";"-";"-";"-";"-";"-";"-";"-";"-";"-";"-";"-";"-";"-";"-";"-";"-";"-"
"24 Kw 2024 18:02:31";"Odrzucono Zlecenie: brak wystarczających środków";"O2-CT-8ZXTQB";"-";"-";"Solana (USD)";"120 Jednost.";"-";"-";"-";"-";"-";"-";"-";"-";"-";"-";"-";"-";"-";"-";"-";"-";"-";"-";"-";"-";"-";"-";"-";"-";"-";"-";"-";"-";"-";"-";"-";"-";"-"
"24 Kw 2024 17:59:40";"Stop Loss";"O2-CT-8ZXSPD";"T2-CT-5ECJSR";"-";"Solana (USD)";"113 Jednost.";"151,810";"-";"-";"-";"-";"4,03378";"69 892,90";"107,12";"24 594,11";"-";"-";"-";"-";"-";"-";"-";"-";"-";"-";"-";"-";"-";"-";"-";"-";"-";"-";"-";"-";"-";"-";"-";"-"
"24 Kw 2024 17:58:22";"Zmodyfikowano Transakcję Sprzedaży";"O2-CT-8ZXSPD";"T2-CT-5ECJ3D";"-";"Solana (USD)";"113 Jednost.";"152,045";"-";"151,800";"146,500";"-";"-";"-";"0,00";"-";"-";"-";"-";"-";"-";"-";"-";"-";"-";"-";"-";"-";"-";"-";"-";"-";"-";"-";"-";"-";"-";"-";"-";"-"
"24 Kw 2024 17:48:33";"Zmodyfikowano Transakcję Sprzedaży";"O2-CT-8ZXSPD";"T2-CT-5ECJ3D";"-";"Solana (USD)";"113 Jednost.";"152,045";"-";"-";"146,500";"-";"-";"-";"0,00";"-";"-";"-";"-";"-";"-";"-";"-";"-";"-";"-";"-";"-";"-";"-";"-";"-";"-";"-";"-";"-";"-";"-";"-";"-"
"24 Kw 2024 17:47:58";"Transakcja Sprzedaży";"O2-CT-8ZXSPD";"T2-CT-5ECJ3D";"-";"Solana (USD)";"113 Jednost.";"152,045";"-";"-";"-";"-";"4,075615";"70 023,48";"0,00";"-";"-";"-";"-";"-";"-";"-";"-";"-";"-";"-";"-";"-";"-";"-";"-";"-";"-";"-";"-";"-";"-";"-";"-";"-"
"24 Kw 2024 17:45:50";"Stop Loss";"O2-CT-8ZXQ05";"T2-CT-5ECHVN";"-";"Solana (USD)";"60 Jednost.";"152,000";"-";"-";"-";"-";"4,03468";"37 166,04";"239,18";"24 286,26";"-";"-";"-";"-";"-";"-";"-";"-";"-";"-";"-";"-";"-";"-";"-";"-";"-";"-";"-";"-";"-";"-";"-";"-"
"24 Kw 2024 17:45:50";"Stop Loss";"O2-CT-8ZXPPX";"T2-CT-5ECHVP";"-";"Solana (USD)";"50 Jednost.";"152,000";"-";"-";"-";"-";"4,03468";"30 971,70";"200,73";"24 486,99";"-";"-";"-";"-";"-";"-";"-";"-";"-";"-";"-";"-";"-";"-";"-";"-";"-";"-";"-";"-";"-";"-";"-";"-"
"24 Kw 2024 17:45:42";"Zmodyfikowano Stop Loss";"O2-CT-8ZXPPX";"-";"O2-CT-8ZXS3K";"Solana (USD)";"50 Jednost.";"152,995";"-";"152,000";"-";"-";"-";"-";"-";"-";"-";"-";"-";"-";"-";"-";"-";"-";"-";"-";"-";"-";"-";"-";"-";"-";"-";"-";"-";"-";"-";"-";"-";"-"
"24 Kw 2024 17:45:29";"Zmodyfikowano Stop Loss";"O2-CT-8ZXQ05";"-";"O2-CT-8ZXS1Z";"Solana (USD)";"60 Jednost.";"152,988";"-";"152,000";"-";"-";"-";"-";"-";"-";"-";"-";"-";"-";"-";"-";"-";"-";"-";"-";"-";"-";"-";"-";"-";"-";"-";"-";"-";"-";"-";"-";"-";"-"
"24 Kw 2024 17:43:56";"Zmodyfikowano Transakcję Sprzedaży";"O2-CT-8ZXPPX";"T2-CT-5ECFJ4";"-";"Solana (USD)";"50 Jednost.";"152,995";"-";"152,700";"146,500";"-";"-";"-";"0,00";"-";"-";"-";"-";"-";"-";"-";"-";"-";"-";"-";"-";"-";"-";"-";"-";"-";"-";"-";"-";"-";"-";"-";"-";"-"
"24 Kw 2024 17:43:33";"Zmodyfikowano Transakcję Sprzedaży";"O2-CT-8ZXQ05";"T2-CT-5ECFRN";"-";"Solana (USD)";"60 Jednost.";"152,988";"-";"152,700";"146,500";"-";"-";"-";"0,00";"-";"-";"-";"-";"-";"-";"-";"-";"-";"-";"-";"-";"-";"-";"-";"-";"-";"-";"-";"-";"-";"-";"-";"-";"-"
"24 Kw 2024 17:35:17";"Zmodyfikowano Take Profit";"O2-CT-8ZXPPX";"-";"O2-CT-8ZXQDR";"Solana (USD)";"50 Jednost.";"152,995";"-";"-";"146,500";"-";"-";"-";"-";"-";"-";"-";"-";"-";"-";"-";"-";"-";"-";"-";"-";"-";"-";"-";"-";"-";"-";"-";"-";"-";"-";"-";"-";"-"
"24 Kw 2024 17:34:56";"Zmodyfikowano Take Profit";"O2-CT-8ZXPPX";"-";"O2-CT-8ZXQDR";"Solana (USD)";"50 Jednost.";"152,995";"-";"-";"152,200";"-";"-";"-";"-";"-";"-";"-";"-";"-";"-";"-";"-";"-";"-";"-";"-";"-";"-";"-";"-";"-";"-";"-";"-";"-";"-";"-";"-";"-"
"24 Kw 2024 17:25:21";"Zmodyfikowano Transakcję Sprzedaży";"O2-CT-8ZXPPX";"T2-CT-5ECFJ4";"-";"Solana (USD)";"50 Jednost.";"152,995";"-";"-";"146,500";"-";"-";"-";"0,00";"-";"-";"-";"-";"-";"-";"-";"-";"-";"-";"-";"-";"-";"-";"-";"-";"-";"-";"-";"-";"-";"-";"-";"-";"-"
"24 Kw 2024 17:24:53";"Zmodyfikowano Transakcję Sprzedaży";"O2-CT-8ZXQ05";"T2-CT-5ECFRN";"-";"Solana (USD)";"60 Jednost.";"152,988";"-";"-";"146,500";"-";"-";"-";"0,00";"-";"-";"-";"-";"-";"-";"-";"-";"-";"-";"-";"-";"-";"-";"-";"-";"-";"-";"-";"-";"-";"-";"-";"-";"-"
"24 Kw 2024 17:21:16";"Transakcja Sprzedaży";"O2-CT-8ZXQ05";"T2-CT-5ECFRN";"-";"Solana (USD)";"60 Jednost.";"152,988";"-";"-";"-";"-";"4,071276";"37 371,38";"0,00";"-";"-";"-";"-";"-";"-";"-";"-";"-";"-";"-";"-";"-";"-";"-";"-";"-";"-";"-";"-";"-";"-";"-";"-";"-"
"24 Kw 2024 17:19:14";"Transakcja Sprzedaży";"O2-CT-8ZXPPX";"T2-CT-5ECFJ4";"-";"Solana (USD)";"50 Jednost.";"152,995";"-";"-";"-";"-";"4,070765";"31 140,33";"0,00";"-";"-";"-";"-";"-";"-";"-";"-";"-";"-";"-";"-";"-";"-";"-";"-";"-";"-";"-";"-";"-";"-";"-";"-";"-"
"24 Kw 2024 16:45:25";"Take Profit";"O2-CT-8ZTQD4";"T2-CT-5ECBGR";"-";"Solana (USD)";"11 Jednost.";"153,000";"-";"-";"-";"-";"4,032";"6 854,06";"89,81";"24 047,08";"-";"-";"-";"-";"-";"-";"-";"-";"-";"-";"-";"-";"-";"-";"-";"-";"-";"-";"-";"-";"-";"-";"-";"-"
"24 Kw 2024 16:45:25";"Take Profit";"O2-CT-8ZSSK9";"T2-CT-5ECBGQ";"-";"Solana (USD)";"40 Jednost.";"153,000";"-";"-";"-";"-";"4,032";"24 923,87";"173,38";"23 957,27";"-";"-";"-";"-";"-";"-";"-";"-";"-";"-";"-";"-";"-";"-";"-";"-";"-";"-";"-";"-";"-";"-";"-";"-"
"24 Kw 2024 16:45:25";"Take Profit";"O2-CT-8ZSFNF";"T2-CT-5ECBGP";"-";"Solana (USD)";"60 Jednost.";"153,000";"-";"-";"-";"-";"4,032";"37 385,80";"139,10";"23 783,89";"-";"-";"-";"-";"-";"-";"-";"-";"-";"-";"-";"-";"-";"-";"-";"-";"-";"-";"-";"-";"-";"-";"-";"-"
"24 Kw 2024 00:31:48";"Zmodyfikowano Take Profit";"O2-CT-8ZTQD4";"-";"O2-CT-8ZTSQR";"Solana (USD)";"11 Jednost.";"155,025";"-";"-";"153,000";"-";"-";"-";"-";"-";"-";"-";"-";"-";"-";"-";"-";"-";"-";"-";"-";"-";"-";"-";"-";"-";"-";"-";"-";"-";"-";"-";"-";"-"
"24 Kw 2024 00:31:36";"Zmodyfikowano Take Profit";"O2-CT-8ZSSK9";"-";"O2-CT-8ZSSM6";"Solana (USD)";"40 Jednost.";"154,075";"-";"-";"153,000";"-";"-";"-";"-";"-";"-";"-";"-";"-";"-";"-";"-";"-";"-";"-";"-";"-";"-";"-";"-";"-";"-";"-";"-";"-";"-";"-";"-";"-"
"24 Kw 2024 00:31:24";"Zmodyfikowano Take Profit";"O2-CT-8ZSFNF";"-";"O2-CT-8ZSFS4";"Solana (USD)";"60 Jednost.";"153,575";"-";"-";"153,000";"-";"-";"-";"-";"-";"-";"-";"-";"-";"-";"-";"-";"-";"-";"-";"-";"-";"-";"-";"-";"-";"-";"-";"-";"-";"-";"-";"-";"-"
"24 Kw 2024 00:30:37";"Zmodyfikowano Take Profit";"O2-CT-8ZSFNF";"-";"O2-CT-8ZSFS4";"Solana (USD)";"60 Jednost.";"153,575";"-";"-";"153,800";"-";"-";"-";"-";"-";"-";"-";"-";"-";"-";"-";"-";"-";"-";"-";"-";"-";"-";"-";"-";"-";"-";"-";"-";"-";"-";"-";"-";"-"
"23 Kw 2024 23:01:04";"Koszty Utrzymania Pozycji";"1329574587";"-";"-";"Rachunek";"-";"-";"-";"-";"-";"-";"-";"-";"-4,79";"23 644,79";"-";"-";"-";"-";"-";"-4,79";"-";"-";"-";"-";"-";"-";"-";"-";"-";"-";"-";"-";"-";"-";"-";"-";"-";"-"
"23 Kw 2024 23:01:04";"Koszty Utrzymania Pozycji";"O2-CR-8Z7P36";"-";"-";"Solana (USD)";"-";"-";"-";"-";"-";"-";"-";"-";"-";"-";"-";"-";"7 824,50";"-27,50000%";"-23,86";"-23,86";"-";"-";"-";"-";"-";"-";"-";"-";"-";"-";"-";"-";"-";"-";"-";"-";"-";"-"
"23 Kw 2024 23:01:04";"Koszty Utrzymania Pozycji";"O2-CT-8ZTQD4";"-";"-";"Solana (USD)";"-";"-";"-";"-";"-";"-";"-";"-";"-";"-";"-";"-";"1 721,39";"-10,00000%";"1,89";"1,89";"-";"-";"-";"-";"-";"-";"-";"-";"-";"-";"-";"-";"-";"-";"-";"-";"-";"-"
"23 Kw 2024 23:01:04";"Koszty Utrzymania Pozycji";"O2-CT-8ZSFNF";"-";"-";"Solana (USD)";"-";"-";"-";"-";"-";"-";"-";"-";"-";"-";"-";"-";"9 389,40";"-10,00000%";"10,31";"10,31";"-";"-";"-";"-";"-";"-";"-";"-";"-";"-";"-";"-";"-";"-";"-";"-";"-";"-"
"23 Kw 2024 23:01:04";"Koszty Utrzymania Pozycji";"O2-CT-8ZSSK9";"-";"-";"Solana (USD)";"-";"-";"-";"-";"-";"-";"-";"-";"-";"-";"-";"-";"6 259,60";"-10,00000%";"6,87";"6,87";"-";"-";"-";"-";"-";"-";"-";"-";"-";"-";"-";"-";"-";"-";"-";"-";"-";"-"
"23 Kw 2024 14:55:53";"Zmodyfikowano Take Profit";"O2-CT-8ZTQD4";"-";"O2-CT-8ZTSQR";"Solana (USD)";"11 Jednost.";"155,025";"-";"-";"153,800";"-";"-";"-";"-";"-";"-";"-";"-";"-";"-";"-";"-";"-";"-";"-";"-";"-";"-";"-";"-";"-";"-";"-";"-";"-";"-";"-";"-";"-"
"23 Kw 2024 14:55:37";"Zmodyfikowano Take Profit";"O2-CT-8ZSSK9";"-";"O2-CT-8ZSSM6";"Solana (USD)";"40 Jednost.";"154,075";"-";"-";"153,800";"-";"-";"-";"-";"-";"-";"-";"-";"-";"-";"-";"-";"-";"-";"-";"-";"-";"-";"-";"-";"-";"-";"-";"-";"-";"-";"-";"-";"-"
"23 Kw 2024 13:44:08";"Zmodyfikowano Take Profit";"O2-CT-8ZSFNF";"-";"O2-CT-8ZSFS4";"Solana (USD)";"60 Jednost.";"153,575";"-";"-";"146,500";"-";"-";"-";"-";"-";"-";"-";"-";"-";"-";"-";"-";"-";"-";"-";"-";"-";"-";"-";"-";"-";"-";"-";"-";"-";"-";"-";"-";"-"
"23 Kw 2024 13:43:54";"Zmodyfikowano Take Profit";"O2-CT-8ZSSK9";"-";"O2-CT-8ZSSM6";"Solana (USD)";"40 Jednost.";"154,075";"-";"-";"146,500";"-";"-";"-";"-";"-";"-";"-";"-";"-";"-";"-";"-";"-";"-";"-";"-";"-";"-";"-";"-";"-";"-";"-";"-";"-";"-";"-";"-";"-"
"23 Kw 2024 13:43:40";"Zmodyfikowano Take Profit";"O2-CT-8ZTQD4";"-";"O2-CT-8ZTSQR";"Solana (USD)";"11 Jednost.";"155,025";"-";"-";"146,500";"-";"-";"-";"-";"-";"-";"-";"-";"-";"-";"-";"-";"-";"-";"-";"-";"-";"-";"-";"-";"-";"-";"-";"-";"-";"-";"-";"-";"-"
"23 Kw 2024 13:26:35";"Zmodyfikowano Transakcję Sprzedaży";"O2-CT-8ZTQD4";"T2-CT-5E908H";"-";"Solana (USD)";"11 Jednost.";"155,025";"-";"-";"150,500";"-";"-";"-";"0,00";"-";"-";"-";"-";"-";"-";"-";"-";"-";"-";"-";"-";"-";"-";"-";"-";"-";"-";"-";"-";"-";"-";"-";"-";"-"
"23 Kw 2024 12:49:54";"Transakcja Sprzedaży";"O2-CT-8ZTQD4";"T2-CT-5E908H";"-";"Solana (USD)";"11 Jednost.";"155,025";"-";"-";"-";"-";"4,075524";"6 949,88";"0,00";"-";"-";"-";"-";"-";"-";"-";"-";"-";"-";"-";"-";"-";"-";"-";"-";"-";"-";"-";"-";"-";"-";"-";"-";"-"
"23 Kw 2024 00:15:30";"Zmodyfikowano Take Profit";"O2-CT-8ZSFNF";"-";"O2-CT-8ZSFS4";"Solana (USD)";"60 Jednost.";"153,575";"-";"-";"150,500";"-";"-";"-";"-";"-";"-";"-";"-";"-";"-";"-";"-";"-";"-";"-";"-";"-";"-";"-";"-";"-";"-";"-";"-";"-";"-";"-";"-";"-"
"23 Kw 2024 00:15:13";"Zmodyfikowano Take Profit";"O2-CT-8ZSSK9";"-";"O2-CT-8ZSSM6";"Solana (USD)";"40 Jednost.";"154,075";"-";"-";"150,500";"-";"-";"-";"-";"-";"-";"-";"-";"-";"-";"-";"-";"-";"-";"-";"-";"-";"-";"-";"-";"-";"-";"-";"-";"-";"-";"-";"-";"-"
"22 Kw 2024 23:01:02";"Koszty Utrzymania Pozycji";"1329142145";"-";"-";"Rachunek";"-";"-";"-";"-";"-";"-";"-";"-";"-6,64";"23 649,58";"-";"-";"-";"-";"-";"-6,64";"-";"-";"-";"-";"-";"-";"-";"-";"-";"-";"-";"-";"-";"-";"-";"-";"-";"-"
"22 Kw 2024 23:01:02";"Koszty Utrzymania Pozycji";"O2-CR-8Z7P36";"-";"-";"Solana (USD)";"-";"-";"-";"-";"-";"-";"-";"-";"-";"-";"-";"-";"7 740,95";"-27,50000%";"-23,74";"-23,74";"-";"-";"-";"-";"-";"-";"-";"-";"-";"-";"-";"-";"-";"-";"-";"-";"-";"-"
"22 Kw 2024 23:01:02";"Koszty Utrzymania Pozycji";"O2-CT-8ZSFNF";"-";"-";"Solana (USD)";"-";"-";"-";"-";"-";"-";"-";"-";"-";"-";"-";"-";"9 289,14";"-10,00000%";"10,26";"10,26";"-";"-";"-";"-";"-";"-";"-";"-";"-";"-";"-";"-";"-";"-";"-";"-";"-";"-"
"22 Kw 2024 23:01:02";"Koszty Utrzymania Pozycji";"O2-CT-8ZSSK9";"-";"-";"Solana (USD)";"-";"-";"-";"-";"-";"-";"-";"-";"-";"-";"-";"-";"6 192,76";"-10,00000%";"6,84";"6,84";"-";"-";"-";"-";"-";"-";"-";"-";"-";"-";"-";"-";"-";"-";"-";"-";"-";"-"
"22 Kw 2024 21:52:08";"Zmodyfikowano Transakcję Sprzedaży";"O2-CT-8ZSSK9";"T2-CT-5E88W3";"-";"Solana (USD)";"40 Jednost.";"154,075";"-";"-";"151,000";"-";"-";"-";"0,00";"-";"-";"-";"-";"-";"-";"-";"-";"-";"-";"-";"-";"-";"-";"-";"-";"-";"-";"-";"-";"-";"-";"-";"-";"-"
"22 Kw 2024 21:51:00";"Transakcja Sprzedaży";"O2-CT-8ZSSK9";"T2-CT-5E88W3";"-";"Solana (USD)";"40 Jednost.";"154,075";"-";"-";"-";"-";"4,072979";"25 101,76";"0,00";"-";"-";"-";"-";"-";"-";"-";"-";"-";"-";"-";"-";"-";"-";"-";"-";"-";"-";"-";"-";"-";"-";"-";"-";"-"
"22 Kw 2024 21:39:10";"Stop Loss";"O2-CT-8ZSNCQ";"T2-CT-5E884Y";"-";"Solana (USD)";"20 Jednost.";"153,865";"-";"-";"-";"-";"4,03255";"12 534,05";"34,84";"23 617,51";"-";"-";"-";"-";"-";"-";"-";"-";"-";"-";"-";"-";"-";"-";"-";"-";"-";"-";"-";"-";"-";"-";"-";"-"
"22 Kw 2024 21:39:10";"Stop Loss";"O2-CT-8ZSG0V";"T2-CT-5E884Z";"-";"Solana (USD)";"30 Jednost.";"153,865";"-";"-";"-";"-";"4,03255";"18 801,08";"38,71";"23 656,22";"-";"-";"-";"-";"-";"-";"-";"-";"-";"-";"-";"-";"-";"-";"-";"-";"-";"-";"-";"-";"-";"-";"-";"-"
"22 Kw 2024 21:36:34";"Zmodyfikowano Stop Loss";"O2-CT-8ZSG0V";"-";"O2-CT-8ZSRF8";"Solana (USD)";"30 Jednost.";"154,185";"-";"153,850";"-";"-";"-";"-";"-";"-";"-";"-";"-";"-";"-";"-";"-";"-";"-";"-";"-";"-";"-";"-";"-";"-";"-";"-";"-";"-";"-";"-";"-";"-"
"22 Kw 2024 21:36:26";"Zmodyfikowano Stop Loss";"O2-CT-8ZSNCQ";"-";"O2-CT-8ZSRDH";"Solana (USD)";"20 Jednost.";"154,297";"-";"153,850";"-";"-";"-";"-";"-";"-";"-";"-";"-";"-";"-";"-";"-";"-";"-";"-";"-";"-";"-";"-";"-";"-";"-";"-";"-";"-";"-";"-";"-";"-"
"22 Kw 2024 21:35:35";"Zmodyfikowano Transakcję Sprzedaży";"O2-CT-8ZSG0V";"T2-CT-5E7Z11";"-";"Solana (USD)";"30 Jednost.";"154,185";"-";"153,950";"151,000";"-";"-";"-";"0,00";"-";"-";"-";"-";"-";"-";"-";"-";"-";"-";"-";"-";"-";"-";"-";"-";"-";"-";"-";"-";"-";"-";"-";"-";"-"
"22 Kw 2024 21:35:15";"Zmodyfikowano Transakcję Sprzedaży";"O2-CT-8ZSNCQ";"T2-CT-5E8580";"-";"Solana (USD)";"20 Jednost.";"154,297";"-";"153,950";"151,000";"-";"-";"-";"0,00";"-";"-";"-";"-";"-";"-";"-";"-";"-";"-";"-";"-";"-";"-";"-";"-";"-";"-";"-";"-";"-";"-";"-";"-";"-"
"22 Kw 2024 20:43:52";"Zmodyfikowano Transakcję Sprzedaży";"O2-CT-8ZSNCQ";"T2-CT-5E8580";"-";"Solana (USD)";"20 Jednost.";"154,297";"-";"-";"151,000";"-";"-";"-";"0,00";"-";"-";"-";"-";"-";"-";"-";"-";"-";"-";"-";"-";"-";"-";"-";"-";"-";"-";"-";"-";"-";"-";"-";"-";"-"
"22 Kw 2024 20:43:25";"Transakcja Sprzedaży";"O2-CT-8ZSNCQ";"T2-CT-5E8580";"-";"Solana (USD)";"20 Jednost.";"154,297";"-";"-";"-";"-";"4,070084";"12 560,03";"0,00";"-";"-";"-";"-";"-";"-";"-";"-";"-";"-";"-";"-";"-";"-";"-";"-";"-";"-";"-";"-";"-";"-";"-";"-";"-"
"22 Kw 2024 20:30:20";"Stop Loss";"O2-CT-8ZSLB6";"T2-CT-5E8474";"-";"Solana (USD)";"20 Jednost.";"154,720";"-";"-";"-";"-";"4,02953";"12 594,27";"16,12";"23 582,67";"-";"-";"-";"-";"-";"-";"-";"-";"-";"-";"-";"-";"-";"-";"-";"-";"-";"-";"-";"-";"-";"-";"-";"-"
"22 Kw 2024 20:29:47";"Zmodyfikowano Transakcję Sprzedaży";"O2-CT-8ZSLB6";"T2-CT-5E8386";"-";"Solana (USD)";"20 Jednost.";"154,920";"-";"154,700";"151,000";"-";"-";"-";"0,00";"-";"-";"-";"-";"-";"-";"-";"-";"-";"-";"-";"-";"-";"-";"-";"-";"-";"-";"-";"-";"-";"-";"-";"-";"-"
"22 Kw 2024 20:13:26";"Zmodyfikowano Transakcję Sprzedaży";"O2-CT-8ZSLB6";"T2-CT-5E8386";"-";"Solana (USD)";"20 Jednost.";"154,920";"-";"-";"151,000";"-";"-";"-";"0,00";"-";"-";"-";"-";"-";"-";"-";"-";"-";"-";"-";"-";"-";"-";"-";"-";"-";"-";"-";"-";"-";"-";"-";"-";"-"
"22 Kw 2024 20:13:03";"Transakcja Sprzedaży";"O2-CT-8ZSLB6";"T2-CT-5E8386";"-";"Solana (USD)";"20 Jednost.";"154,920";"-";"-";"-";"-";"4,071075";"12 613,81";"0,00";"-";"-";"-";"-";"-";"-";"-";"-";"-";"-";"-";"-";"-";"-";"-";"-";"-";"-";"-";"-";"-";"-";"-";"-";"-"
"22 Kw 2024 20:07:38";" Zamknięcie Transakcji";"O2-CT-8ZSKXB";"T2-CT-5E82Y6";"O2-CT-8ZSHBH";"Solana (USD)";"20 Jednost.";"155,110";"-";"-";"-";"-";"4,03092";"12 630,37";"8,46";"23 566,55";"-";"-";"-";"-";"-";"-";"-";"-";"-";"-";"-";"-";"-";"-";"-";"-";"-";"-";"-";"-";"-";"-";"-";"-"
"22 Kw 2024 19:56:03";"Zmodyfikowano Take Profit";"O2-CT-8ZSFNF";"-";"O2-CT-8ZSFS4";"Solana (USD)";"60 Jednost.";"153,575";"-";"-";"151,000";"-";"-";"-";"-";"-";"-";"-";"-";"-";"-";"-";"-";"-";"-";"-";"-";"-";"-";"-";"-";"-";"-";"-";"-";"-";"-";"-";"-";"-"
"22 Kw 2024 19:55:48";"Zmodyfikowano Take Profit";"O2-CT-8ZSG0V";"-";"O2-CT-8ZSG1Q";"Solana (USD)";"30 Jednost.";"154,185";"-";"-";"151,000";"-";"-";"-";"-";"-";"-";"-";"-";"-";"-";"-";"-";"-";"-";"-";"-";"-";"-";"-";"-";"-";"-";"-";"-";"-";"-";"-";"-";"-"
"22 Kw 2024 19:55:31";"Zmodyfikowano Take Profit";"O2-CT-8ZSHBH";"-";"O2-CT-8ZSHC7";"Solana (USD)";"20 Jednost.";"155,215";"-";"-";"151,000";"-";"-";"-";"-";"-";"-";"-";"-";"-";"-";"-";"-";"-";"-";"-";"-";"-";"-";"-";"-";"-";"-";"-";"-";"-";"-";"-";"-";"-"
"22 Kw 2024 19:44:12";"Zmodyfikowano Transakcję Sprzedaży";"O2-CT-8ZSHBH";"T2-CT-5E8079";"-";"Solana (USD)";"20 Jednost.";"155,215";"-";"-";"152,900";"-";"-";"-";"0,00";"-";"-";"-";"-";"-";"-";"-";"-";"-";"-";"-";"-";"-";"-";"-";"-";"-";"-";"-";"-";"-";"-";"-";"-";"-"
"22 Kw 2024 19:43:40";"Transakcja Sprzedaży";"O2-CT-8ZSHBH";"T2-CT-5E8079";"-";"Solana (USD)";"20 Jednost.";"155,215";"-";"-";"-";"-";"4,07329";"12 644,71";"0,00";"-";"-";"-";"-";"-";"-";"-";"-";"-";"-";"-";"-";"-";"-";"-";"-";"-";"-";"-";"-";"-";"-";"-";"-";"-"
"22 Kw 2024 19:28:42";"Zmodyfikowano Transakcję Sprzedaży";"O2-CT-8ZSG0V";"T2-CT-5E7Z11";"-";"Solana (USD)";"30 Jednost.";"154,185";"-";"-";"152,900";"-";"-";"-";"0,00";"-";"-";"-";"-";"-";"-";"-";"-";"-";"-";"-";"-";"-";"-";"-";"-";"-";"-";"-";"-";"-";"-";"-";"-";"-"
"22 Kw 2024 19:28:25";"Transakcja Sprzedaży";"O2-CT-8ZSG0V";"T2-CT-5E7Z11";"-";"Solana (USD)";"30 Jednost.";"154,185";"-";"-";"-";"-";"4,073049";"18 840,09";"0,00";"-";"-";"-";"-";"-";"-";"-";"-";"-";"-";"-";"-";"-";"-";"-";"-";"-";"-";"-";"-";"-";"-";"-";"-";"-"
"22 Kw 2024 19:25:41";"Zmodyfikowano Transakcję Sprzedaży";"O2-CT-8ZSFNF";"T2-CT-5E7YJL";"-";"Solana (USD)";"60 Jednost.";"153,575";"-";"-";"152,900";"-";"-";"-";"0,00";"-";"-";"-";"-";"-";"-";"-";"-";"-";"-";"-";"-";"-";"-";"-";"-";"-";"-";"-";"-";"-";"-";"-";"-";"-"
"22 Kw 2024 19:24:09";"Transakcja Sprzedaży";"O2-CT-8ZSFNF";"T2-CT-5E7YJL";"-";"Solana (USD)";"60 Jednost.";"153,575";"-";"-";"-";"-";"4,07355";"37 535,72";"0,00";"-";"-";"-";"-";"-";"-";"-";"-";"-";"-";"-";"-";"-";"-";"-";"-";"-";"-";"-";"-";"-";"-";"-";"-";"-"
"22 Kw 2024 11:21:39";" Zamknięcie Transakcji";"O2-CT-8ZRC01";"T2-CT-5E6YPX";"O2-CT-8ZRB6C";"Solana (USD)";"10 Jednost.";"153,600";"-";"-";"-";"-";"4,03136";"6 254,38";"15,92";"23 558,09";"-";"-";"-";"-";"-";"-";"-";"-";"-";"-";"-";"-";"-";"-";"-";"-";"-";"-";"-";"-";"-";"-";"-";"-"
"22 Kw 2024 11:07:08";" Transakcja Kupna";"O2-CT-8ZRB6C";"T2-CT-5E6Y2H";"-";"Solana (USD)";"10 Jednost.";"153,205";"-";"-";"-";"-";"4,072458";"6 239,20";"0,00";"-";"-";"-";"-";"-";"-";"-";"-";"-";"-";"-";"-";"-";"-";"-";"-";"-";"-";"-";"-";"-";"-";"-";"-";"-"
"19 Kw 2024 23:01:14";"Koszty Utrzymania Pozycji";"1328746909";"-";"-";"Rachunek";"-";"-";"-";"-";"-";"-";"-";"-";"-66,85";"23 542,17";"-";"-";"-";"-";"-";"-66,85";"-";"-";"-";"-";"-";"-";"-";"-";"-";"-";"-";"-";"-";"-";"-";"-";"-";"-"
"19 Kw 2024 23:01:14";"Koszty Utrzymania Pozycji";"O2-CR-8Z7P36";"-";"-";"Solana (USD)";"-";"-";"-";"-";"-";"-";"-";"-";"-";"-";"-";"-";"7 277,25";"-27,50000%";"-66,85";"-66,85";"-";"-";"-";"-";"-";"-";"-";"-";"-";"-";"-";"-";"-";"-";"-";"-";"-";"-"
"19 Kw 2024 21:59:02";" Zamknięcie Transakcji";"O2-CS-8ZQG5N";"T2-CS-5E68VZ";"O2-CS-8ZQ797";"Solana (USD)";"11 Jednost.";"145,330";"-";"-";"-";"-";"4,066867";"6 501,41";"-23,40";"23 609,02";"-";"-";"-";"-";"-";"-";"-";"-";"-";"-";"-";"-";"-";"-";"-";"-";"-";"-";"-";"-";"-";"-";"-";"-"
"19 Kw 2024 21:00:18";" Zmodyfikowano Transakcję Kupna";"O2-CS-8ZQ797";"T2-CS-5E61KK";"-";"Solana (USD)";"11 Jednost.";"145,853";"-";"-";"147,300";"-";"-";"-";"0,00";"-";"-";"-";"-";"-";"-";"-";"-";"-";"-";"-";"-";"-";"-";"-";"-";"-";"-";"-";"-";"-";"-";"-";"-";"-"
"19 Kw 2024 20:11:00";" Transakcja Kupna";"O2-CS-8ZQ797";"T2-CS-5E61KK";"-";"Solana (USD)";"11 Jednost.";"145,853";"-";"-";"-";"-";"4,067548";"6 525,90";"0,00";"-";"-";"-";"-";"-";"-";"-";"-";"-";"-";"-";"-";"-";"-";"-";"-";"-";"-";"-";"-";"-";"-";"-";"-";"-"
"19 Kw 2024 20:04:17";"Stop Loss";"O2-CS-8ZQ68R";"T2-CS-5E610Z";"-";"Solana (USD)";"10 Jednost.";"145,855";"-";"-";"-";"-";"4,02743";"5 933,24";"8,05";"23 632,42";"-";"-";"-";"-";"-";"-";"-";"-";"-";"-";"-";"-";"-";"-";"-";"-";"-";"-";"-";"-";"-";"-";"-";"-"
"19 Kw 2024 20:04:15";"Zmodyfikowano Stop Loss";"O2-CS-8ZQ68R";"-";"O2-CS-8ZQ6MQ";"Solana (USD)";"10 Jednost.";"146,055";"-";"145,850";"-";"-";"-";"-";"-";"-";"-";"-";"-";"-";"-";"-";"-";"-";"-";"-";"-";"-";"-";"-";"-";"-";"-";"-";"-";"-";"-";"-";"-";"-"
"19 Kw 2024 20:03:51";"Zmodyfikowano Transakcję Sprzedaży";"O2-CS-8ZQ68R";"T2-CS-5E60PZ";"-";"Solana (USD)";"10 Jednost.";"146,055";"-";"145,950";"-";"-";"-";"-";"0,00";"-";"-";"-";"-";"-";"-";"-";"-";"-";"-";"-";"-";"-";"-";"-";"-";"-";"-";"-";"-";"-";"-";"-";"-";"-"
"19 Kw 2024 20:00:49";"Transakcja Sprzedaży";"O2-CS-8ZQ68R";"T2-CS-5E60PZ";"-";"Solana (USD)";"10 Jednost.";"146,055";"-";"-";"-";"-";"4,066917";"5 939,93";"0,00";"-";"-";"-";"-";"-";"-";"-";"-";"-";"-";"-";"-";"-";"-";"-";"-";"-";"-";"-";"-";"-";"-";"-";"-";"-"
"19 Kw 2024 19:54:43";" Zamknięcie Transakcji";"O2-CS-8ZQ5PX";"T2-CS-5E6064";"O2-CS-8ZPWZC";"Solana (USD)";"10,5 Jednost.";"146,745";"-";"-";"-";"-";"4,02502";"6 264,17";"7,18";"23 624,37";"-";"-";"-";"-";"-";"-";"-";"-";"-";"-";"-";"-";"-";"-";"-";"-";"-";"-";"-";"-";"-";"-";"-";"-"
"19 Kw 2024 19:26:13";" Zmodyfikowano Transakcję Kupna";"O2-CS-8ZPWZC";"T2-CS-5E5QQC";"-";"Solana (USD)";"10,5 Jednost.";"146,575";"-";"-";"147,350";"-";"-";"-";"0,00";"-";"-";"-";"-";"-";"-";"-";"-";"-";"-";"-";"-";"-";"-";"-";"-";"-";"-";"-";"-";"-";"-";"-";"-";"-"
"19 Kw 2024 18:07:52";" Transakcja Kupna";"O2-CS-8ZPWZC";"T2-CS-5E5QQC";"-";"Solana (USD)";"10,5 Jednost.";"146,575";"-";"-";"-";"-";"4,068951";"6 262,26";"0,00";"-";"-";"-";"-";"-";"-";"-";"-";"-";"-";"-";"-";"-";"-";"-";"-";"-";"-";"-";"-";"-";"-";"-";"-";"-"
"19 Kw 2024 18:03:51";"Take Profit";"O2-CS-8ZNY04";"T2-CS-5E5QE7";"-";"Solana (USD)";"10,1 Jednost.";"147,200";"-";"-";"-";"-";"4,02825";"6 049,06";"72,42";"23 617,19";"-";"-";"-";"-";"-";"-";"-";"-";"-";"-";"-";"-";"-";"-";"-";"-";"-";"-";"-";"-";"-";"-";"-";"-"
"19 Kw 2024 18:01:51";" Zmodyfikowano Transakcję Kupna";"O2-CS-8ZNY04";"T2-CS-5E4W06";"-";"Solana (USD)";"10,1 Jednost.";"145,420";"-";"-";"147,200";"-";"-";"-";"0,00";"-";"-";"-";"-";"-";"-";"-";"-";"-";"-";"-";"-";"-";"-";"-";"-";"-";"-";"-";"-";"-";"-";"-";"-";"-"
"19 Kw 2024 13:16:31";" Transakcja Kupna";"O2-CS-8ZNY04";"T2-CS-5E4W06";"-";"Solana (USD)";"10,1 Jednost.";"145,420";"-";"-";"-";"-";"4,085454";"6 000,47";"0,00";"-";"-";"-";"-";"-";"-";"-";"-";"-";"-";"-";"-";"-";"-";"-";"-";"-";"-";"-";"-";"-";"-";"-";"-";"-"
"19 Kw 2024 12:52:03";" Zamknięcie Transakcji";"O2-CS-8ZNWJQ";"T2-CS-5E4TRD";"O2-CS-8ZNNM9";"Solana (USD)";"4 Jednost.";"144,720";"-";"-";"-";"-";"4,04664";"2 366,06";"3,56";"23 544,77";"-";"-";"-";"-";"-";"-";"-";"-";"-";"-";"-";"-";"-";"-";"-";"-";"-";"-";"-";"-";"-";"-";"-";"-"
"19 Kw 2024 11:23:38";"Take Profit";"O2-CS-8ZN0WZ";"T2-CS-5E4PKT";"-";"Solana (USD)";"5,76 Jednost.";"143,906";"-";"-";"-";"-";"4,04679";"3 388,08";"202,93";"23 541,21";"-";"-";"-";"-";"-";"-";"-";"-";"-";"-";"-";"-";"-";"-";"-";"-";"-";"-";"-";"-";"-";"-";"-";"-"
"19 Kw 2024 11:22:01";" Zmodyfikowano Transakcję Kupna";"O2-CS-8ZN0WZ";"T2-CS-5E43JZ";"-";"Solana (USD)";"5,76 Jednost.";"135,200";"-";"-";"143,906";"-";"-";"-";"0,00";"-";"-";"-";"-";"-";"-";"-";"-";"-";"-";"-";"-";"-";"-";"-";"-";"-";"-";"-";"-";"-";"-";"-";"-";"-"
"19 Kw 2024 10:51:17";" Transakcja Kupna";"O2-CS-8ZNNM9";"T2-CS-5E4N3D";"-";"Solana (USD)";"4 Jednost.";"144,500";"-";"-";"-";"-";"4,092188";"2 365,28";"0,00";"-";"-";"-";"-";"-";"-";"-";"-";"-";"-";"-";"-";"-";"-";"-";"-";"-";"-";"-";"-";"-";"-";"-";"-";"-"
"19 Kw 2024 05:32:32";" Transakcja Kupna";"O2-CS-8ZN0WZ";"T2-CS-5E43JZ";"-";"Solana (USD)";"5,76 Jednost.";"135,200";"-";"-";"-";"-";"4,111907";"3 202,15";"0,00";"-";"-";"-";"-";"-";"-";"-";"-";"-";"-";"-";"-";"-";"-";"-";"-";"-";"-";"-";"-";"-";"-";"-";"-";"-"
"19 Kw 2024 05:31:26";" Zamknięcie Transakcji";"O2-CS-8ZN0T3";"T2-CS-5E43FY";"O2-CS-8ZL3PH";"Solana (USD)";"50 Jednost.";"135,896";"-";"-";"-";"-";"4,111827";"27 939,04";"-632,40";"23 338,28";"-";"-";"-";"-";"-";"-";"-";"-";"-";"-";"-";"-";"-";"-";"-";"-";"-";"-";"-";"-";"-";"-";"-";"-"
"19 Kw 2024 05:31:19";" Zamknięcie Transakcji";"O2-CS-8ZN0SQ";"T2-CS-5E43EQ";"O2-CS-8ZLH0V";"Solana (USD)";"50 Jednost.";"135,760";"-";"-";"-";"-";"4,112057";"27 912,64";"-667,18";"23 970,68";"-";"-";"-";"-";"-";"-";"-";"-";"-";"-";"-";"-";"-";"-";"-";"-";"-";"-";"-";"-";"-";"-";"-";"-"
"19 Kw 2024 05:24:30";" Zamknięcie Transakcji";"O2-CS-8ZN06S";"T2-CS-5E42R2";"O2-CS-8ZKWEW";"Solana (USD)";"50 Jednost.";"135,051";"-";"-";"-";"-";"4,126015";"27 861,12";"-923,40";"24 637,86";"-";"-";"-";"-";"-";"-";"-";"-";"-";"-";"-";"-";"-";"-";"-";"-";"-";"-";"-";"-";"-";"-";"-";"-"
"19 Kw 2024 05:24:00";" Zamknięcie Transakcji";"O2-CS-8ZN06C";"T2-CS-5E42QG";"O2-CS-8ZKSHX";"Solana (USD)";"50 Jednost.";"134,915";"-";"-";"-";"-";"4,125745";"27 831,24";"-1 067,54";"25 561,26";"-";"-";"-";"-";"-";"-";"-";"-";"-";"-";"-";"-";"-";"-";"-";"-";"-";"-";"-";"-";"-";"-";"-";"-"
"18 Kw 2024 23:51:10";" Zamknięcie Transakcji";"O2-CS-8ZMEYW";"T2-CS-5E3J1T";"O2-CS-8ZMEYH";"Solana (USD)";"50 Jednost.";"141,045";"-";"-";"-";"-";"4,05321";"28 871,49";"86,94";"26 628,80";"-";"-";"-";"-";"-";"-";"-";"-";"-";"-";"-";"-";"-";"-";"-";"-";"-";"-";"-";"-";"-";"-";"-";"-"
"18 Kw 2024 23:43:44";" Transakcja Kupna";"O2-CS-8ZMEYH";"T2-CS-5E3J1L";"-";"Solana (USD)";"50 Jednost.";"140,616";"-";"-";"-";"-";"4,093941";"28 783,68";"0,00";"-";"-";"-";"-";"-";"-";"-";"-";"-";"-";"-";"-";"-";"-";"-";"-";"-";"-";"-";"-";"-";"-";"-";"-";"-"
"18 Kw 2024 23:01:18";"Koszty Utrzymania Pozycji";"1328224852";"-";"-";"Rachunek";"-";"-";"-";"-";"-";"-";"-";"-";"-19,93";"26 541,86";"-";"-";"-";"-";"-";"-19,93";"-";"-";"-";"-";"-";"-";"-";"-";"-";"-";"-";"-";"-";"-";"-";"-";"-";"-"
"18 Kw 2024 23:01:18";"Koszty Utrzymania Pozycji";"O2-CS-8ZLH0V";"-";"-";"Solana (USD)";"-";"-";"-";"-";"-";"-";"-";"-";"-";"-";"-";"-";"7 016,00";"-27,50000%";"-21,65";"-21,65";"-";"-";"-";"-";"-";"-";"-";"-";"-";"-";"-";"-";"-";"-";"-";"-";"-";"-"
"18 Kw 2024 23:01:18";"Koszty Utrzymania Pozycji";"O2-CR-8Z7P36";"-";"-";"Solana (USD)";"-";"-";"-";"-";"-";"-";"-";"-";"-";"-";"-";"-";"7 016,00";"-27,50000%";"-21,65";"-21,65";"-";"-";"-";"-";"-";"-";"-";"-";"-";"-";"-";"-";"-";"-";"-";"-";"-";"-"
"18 Kw 2024 23:01:18";"Koszty Utrzymania Pozycji";"O2-CS-8ZL3PH";"-";"-";"Solana (USD)";"-";"-";"-";"-";"-";"-";"-";"-";"-";"-";"-";"-";"7 016,00";"-10,00000%";"7,79";"7,79";"-";"-";"-";"-";"-";"-";"-";"-";"-";"-";"-";"-";"-";"-";"-";"-";"-";"-"
"18 Kw 2024 23:01:18";"Koszty Utrzymania Pozycji";"O2-CS-8ZKSHX";"-";"-";"Solana (USD)";"-";"-";"-";"-";"-";"-";"-";"-";"-";"-";"-";"-";"7 016,00";"-10,00000%";"7,79";"7,79";"-";"-";"-";"-";"-";"-";"-";"-";"-";"-";"-";"-";"-";"-";"-";"-";"-";"-"
"18 Kw 2024 23:01:18";"Koszty Utrzymania Pozycji";"O2-CS-8ZKWEW";"-";"-";"Solana (USD)";"-";"-";"-";"-";"-";"-";"-";"-";"-";"-";"-";"-";"7 016,00";"-10,00000%";"7,79";"7,79";"-";"-";"-";"-";"-";"-";"-";"-";"-";"-";"-";"-";"-";"-";"-";"-";"-";"-"
"18 Kw 2024 16:19:51";" Zamknięcie Transakcji";"O2-CS-8ZLH1B";"T2-CS-5E2MRR";"O2-CS-8ZKZVK";"Solana (USD)";"50 Jednost.";"138,995";"-";"-";"-";"-";"4,04077";"28 364,54";"414,18";"26 561,79";"-";"-";"-";"-";"-";"-";"-";"-";"-";"-";"-";"-";"-";"-";"-";"-";"-";"-";"-";"-";"-";"-";"-";"-"
"18 Kw 2024 16:19:38";" Transakcja Kupna";"O2-CS-8ZLH0V";"T2-CS-5E2MRC";"-";"Solana (USD)";"50 Jednost.";"139,005";"-";"-";"-";"-";"4,080875";"28 363,10";"0,00";"-";"-";"-";"-";"-";"-";"-";"-";"-";"-";"-";"-";"-";"-";"-";"-";"-";"-";"-";"-";"-";"-";"-";"-";"-"
"18 Kw 2024 14:36:57";"Transakcja Sprzedaży";"O2-CS-8ZL3PH";"T2-CS-5E294J";"-";"Solana (USD)";"50 Jednost.";"132,820";"-";"-";"-";"-";"4,079071";"27 089,11";"0,00";"-";"-";"-";"-";"-";"-";"-";"-";"-";"-";"-";"-";"-";"-";"-";"-";"-";"-";"-";"-";"-";"-";"-";"-";"-"
"18 Kw 2024 14:34:53";"Stop Loss";"O2-CS-8ZL1VB";"T2-CS-5E28Z3";"-";"Solana (USD)";"50 Jednost.";"132,605";"-";"-";"-";"-";"4,0401";"27 056,09";"442,59";"26 147,61";"-";"-";"-";"-";"-";"-";"-";"-";"-";"-";"-";"-";"-";"-";"-";"-";"-";"-";"-";"-";"-";"-";"-";"-"
"18 Kw 2024 14:33:51";"Zmodyfikowano Stop Loss";"O2-CS-8ZL1VB";"-";"O2-CS-8ZL2PS";"Solana (USD)";"50 Jednost.";"134,796";"-";"132,600";"-";"-";"-";"-";"-";"-";"-";"-";"-";"-";"-";"-";"-";"-";"-";"-";"-";"-";"-";"-";"-";"-";"-";"-";"-";"-";"-";"-";"-";"-"
"18 Kw 2024 14:31:49";"Zmodyfikowano Stop Loss";"O2-CS-8ZL1VB";"-";"O2-CS-8ZL2PS";"Solana (USD)";"50 Jednost.";"134,796";"-";"133,300";"-";"-";"-";"-";"-";"-";"-";"-";"-";"-";"-";"-";"-";"-";"-";"-";"-";"-";"-";"-";"-";"-";"-";"-";"-";"-";"-";"-";"-";"-"
"18 Kw 2024 14:29:15";"Zmodyfikowano Transakcję Sprzedaży";"O2-CS-8ZL1VB";"T2-CS-5E27K2";"-";"Solana (USD)";"50 Jednost.";"134,796";"-";"134,300";"-";"-";"-";"-";"0,00";"-";"-";"-";"-";"-";"-";"-";"-";"-";"-";"-";"-";"-";"-";"-";"-";"-";"-";"-";"-";"-";"-";"-";"-";"-"
"18 Kw 2024 14:13:47";"Transakcja Sprzedaży";"O2-CS-8ZL1VB";"T2-CS-5E27K2";"-";"Solana (USD)";"50 Jednost.";"134,796";"-";"-";"-";"-";"4,071075";"27 438,23";"0,00";"-";"-";"-";"-";"-";"-";"-";"-";"-";"-";"-";"-";"-";"-";"-";"-";"-";"-";"-";"-";"-";"-";"-";"-";"-"
"18 Kw 2024 14:11:53";"Stop Loss";"O2-CS-8ZL16B";"T2-CS-5E27H1";"-";"Solana (USD)";"50 Jednost.";"135,120";"-";"-";"-";"-";"4,03027";"27 502,15";"184,18";"25 705,02";"-";"-";"-";"-";"-";"-";"-";"-";"-";"-";"-";"-";"-";"-";"-";"-";"-";"-";"-";"-";"-";"-";"-";"-"
"18 Kw 2024 14:11:39";"Zmodyfikowano Stop Loss";"O2-CS-8ZL16B";"-";"O2-CS-8ZL1QV";"Solana (USD)";"50 Jednost.";"136,034";"-";"135,100";"-";"-";"-";"-";"-";"-";"-";"-";"-";"-";"-";"-";"-";"-";"-";"-";"-";"-";"-";"-";"-";"-";"-";"-";"-";"-";"-";"-";"-";"-"
"18 Kw 2024 14:10:54";"Zmodyfikowano Transakcję Sprzedaży";"O2-CS-8ZL16B";"T2-CS-5E270T";"-";"Solana (USD)";"50 Jednost.";"136,034";"-";"135,300";"-";"-";"-";"-";"0,00";"-";"-";"-";"-";"-";"-";"-";"-";"-";"-";"-";"-";"-";"-";"-";"-";"-";"-";"-";"-";"-";"-";"-";"-";"-"
"18 Kw 2024 13:58:43";"Transakcja Sprzedaży";"O2-CS-8ZL16B";"T2-CS-5E270T";"-";"Solana (USD)";"50 Jednost.";"136,034";"-";"-";"-";"-";"4,073741";"27 708,36";"0,00";"-";"-";"-";"-";"-";"-";"-";"-";"-";"-";"-";"-";"-";"-";"-";"-";"-";"-";"-";"-";"-";"-";"-";"-";"-"
"18 Kw 2024 13:50:30";"Stop Loss";"O2-CS-8ZL0T9";"T2-CS-5E26TQ";"-";"Solana (USD)";"50 Jednost.";"135,900";"-";"-";"-";"-";"4,03546";"27 696,58";"21,19";"25 520,84";"-";"-";"-";"-";"-";"-";"-";"-";"-";"-";"-";"-";"-";"-";"-";"-";"-";"-";"-";"-";"-";"-";"-";"-"
"18 Kw 2024 13:50:06";"Zmodyfikowano Transakcję Sprzedaży";"O2-CS-8ZL0T9";"T2-CS-5E26PK";"-";"Solana (USD)";"50 Jednost.";"136,005";"-";"135,900";"-";"-";"-";"-";"0,00";"-";"-";"-";"-";"-";"-";"-";"-";"-";"-";"-";"-";"-";"-";"-";"-";"-";"-";"-";"-";"-";"-";"-";"-";"-"
"18 Kw 2024 13:46:19";"Transakcja Sprzedaży";"O2-CS-8ZL0T9";"T2-CS-5E26PK";"-";"Solana (USD)";"50 Jednost.";"136,005";"-";"-";"-";"-";"4,076196";"27 719,15";"0,00";"-";"-";"-";"-";"-";"-";"-";"-";"-";"-";"-";"-";"-";"-";"-";"-";"-";"-";"-";"-";"-";"-";"-";"-";"-"
"18 Kw 2024 13:25:35";" Transakcja Kupna";"O2-CS-8ZKZVK";"T2-CS-5E25SL";"-";"Solana (USD)";"50 Jednost.";"136,945";"-";"-";"-";"-";"4,077067";"27 916,69";"0,00";"-";"-";"-";"-";"-";"-";"-";"-";"-";"-";"-";"-";"-";"-";"-";"-";"-";"-";"-";"-";"-";"-";"-";"-";"-"
"18 Kw 2024 13:04:18";"Stop Loss";"O2-CS-8ZKYR4";"T2-CS-5E253B";"-";"Solana (USD)";"50 Jednost.";"134,070";"-";"-";"-";"-";"4,03538";"27 323,09";"94,83";"25 499,65";"-";"-";"-";"-";"-";"-";"-";"-";"-";"-";"-";"-";"-";"-";"-";"-";"-";"-";"-";"-";"-";"-";"-";"-"
"18 Kw 2024 13:04:16";"Zmodyfikowano Stop Loss";"O2-CS-8ZKYR4";"-";"O2-CS-8ZKYZ8";"Solana (USD)";"50 Jednost.";"133,600";"-";"134,100";"-";"-";"-";"-";"-";"-";"-";"-";"-";"-";"-";"-";"-";"-";"-";"-";"-";"-";"-";"-";"-";"-";"-";"-";"-";"-";"-";"-";"-";"-"
"18 Kw 2024 13:03:39";"Zmodyfikowano Stop Loss";"O2-CS-8ZKYR4";"-";"O2-CS-8ZKYZ8";"Solana (USD)";"50 Jednost.";"133,600";"-";"133,900";"-";"-";"-";"-";"-";"-";"-";"-";"-";"-";"-";"-";"-";"-";"-";"-";"-";"-";"-";"-";"-";"-";"-";"-";"-";"-";"-";"-";"-";"-"
"18 Kw 2024 13:03:13";" Zmodyfikowano Transakcję Kupna";"O2-CS-8ZKYR4";"T2-CS-5E24XE";"-";"Solana (USD)";"50 Jednost.";"133,600";"-";"133,700";"-";"-";"-";"-";"0,00";"-";"-";"-";"-";"-";"-";"-";"-";"-";"-";"-";"-";"-";"-";"-";"-";"-";"-";"-";"-";"-";"-";"-";"-";"-"
"18 Kw 2024 12:58:06";" Transakcja Kupna";"O2-CS-8ZKYR4";"T2-CS-5E24XE";"-";"Solana (USD)";"50 Jednost.";"133,600";"-";"-";"-";"-";"4,077599";"27 238,36";"0,00";"-";"-";"-";"-";"-";"-";"-";"-";"-";"-";"-";"-";"-";"-";"-";"-";"-";"-";"-";"-";"-";"-";"-";"-";"-"
"18 Kw 2024 12:22:23";"Zmodyfikowano Transakcję Sprzedaży";"O2-CS-8ZKWEW";"T2-CS-5E2303";"-";"Solana (USD)";"50 Jednost.";"130,575";"-";"-";"128,500";"-";"-";"-";"0,00";"-";"-";"-";"-";"-";"-";"-";"-";"-";"-";"-";"-";"-";"-";"-";"-";"-";"-";"-";"-";"-";"-";"-";"-";"-"
"18 Kw 2024 12:02:17";"Transakcja Sprzedaży";"O2-CS-8ZKWEW";"T2-CS-5E2303";"-";"Solana (USD)";"50 Jednost.";"130,575";"-";"-";"-";"-";"4,07846";"26 627,24";"0,00";"-";"-";"-";"-";"-";"-";"-";"-";"-";"-";"-";"-";"-";"-";"-";"-";"-";"-";"-";"-";"-";"-";"-";"-";"-"
"18 Kw 2024 11:57:36";"Stop Loss";"O2-CS-8ZKW4D";"T2-CS-5E22WK";"-";"Solana (USD)";"50 Jednost.";"130,720";"-";"-";"-";"-";"4,0382";"26 658,97";"10,10";"25 404,82";"-";"-";"-";"-";"-";"-";"-";"-";"-";"-";"-";"-";"-";"-";"-";"-";"-";"-";"-";"-";"-";"-";"-";"-"
"18 Kw 2024 11:57:29";"Zmodyfikowano Transakcję Sprzedaży";"O2-CS-8ZKW4D";"T2-CS-5E22TD";"-";"Solana (USD)";"50 Jednost.";"130,770";"-";"130,720";"128,500";"-";"-";"-";"0,00";"-";"-";"-";"-";"-";"-";"-";"-";"-";"-";"-";"-";"-";"-";"-";"-";"-";"-";"-";"-";"-";"-";"-";"-";"-"
"18 Kw 2024 11:54:36";"Transakcja Sprzedaży";"O2-CS-8ZKW4D";"T2-CS-5E22TD";"-";"Solana (USD)";"50 Jednost.";"130,770";"-";"-";"-";"-";"4,07837";"26 666,42";"0,00";"-";"-";"-";"-";"-";"-";"-";"-";"-";"-";"-";"-";"-";"-";"-";"-";"-";"-";"-";"-";"-";"-";"-";"-";"-"
"18 Kw 2024 11:19:22";"Stop Loss";"O2-CS-8ZKT60";"T2-CS-5E21CK";"-";"Solana (USD)";"50 Jednost.";"130,730";"-";"-";"-";"-";"4,03539";"26 642,47";"46,41";"25 394,72";"-";"-";"-";"-";"-";"-";"-";"-";"-";"-";"-";"-";"-";"-";"-";"-";"-";"-";"-";"-";"-";"-";"-";"-"
"18 Kw 2024 11:19:21";"Zmodyfikowano Stop Loss";"O2-CS-8ZKT60";"-";"O2-CS-8ZKTBE";"Solana (USD)";"50 Jednost.";"130,960";"-";"130,700";"-";"-";"-";"-";"-";"-";"-";"-";"-";"-";"-";"-";"-";"-";"-";"-";"-";"-";"-";"-";"-";"-";"-";"-";"-";"-";"-";"-";"-";"-"
"18 Kw 2024 11:18:45";"Zmodyfikowano Transakcję Sprzedaży";"O2-CS-8ZKT60";"T2-CS-5E217K";"-";"Solana (USD)";"50 Jednost.";"130,960";"-";"130,800";"128,500";"-";"-";"-";"0,00";"-";"-";"-";"-";"-";"-";"-";"-";"-";"-";"-";"-";"-";"-";"-";"-";"-";"-";"-";"-";"-";"-";"-";"-";"-"
"18 Kw 2024 11:16:15";"Zmodyfikowano Transakcję Sprzedaży";"O2-CS-8ZKT60";"T2-CS-5E217K";"-";"Solana (USD)";"50 Jednost.";"130,960";"-";"-";"128,500";"-";"-";"-";"0,00";"-";"-";"-";"-";"-";"-";"-";"-";"-";"-";"-";"-";"-";"-";"-";"-";"-";"-";"-";"-";"-";"-";"-";"-";"-"
"18 Kw 2024 11:15:42";"Transakcja Sprzedaży";"O2-CS-8ZKT60";"T2-CS-5E217K";"-";"Solana (USD)";"50 Jednost.";"130,960";"-";"-";"-";"-";"4,075615";"26 687,12";"0,00";"-";"-";"-";"-";"-";"-";"-";"-";"-";"-";"-";"-";"-";"-";"-";"-";"-";"-";"-";"-";"-";"-";"-";"-";"-"
"18 Kw 2024 10:58:51";"Zmodyfikowano Transakcję Sprzedaży";"O2-CS-8ZKSHX";"T2-CS-5E20P8";"-";"Solana (USD)";"50 Jednost.";"129,740";"-";"-";"128,500";"-";"-";"-";"0,00";"-";"-";"-";"-";"-";"-";"-";"-";"-";"-";"-";"-";"-";"-";"-";"-";"-";"-";"-";"-";"-";"-";"-";"-";"-"
"18 Kw 2024 10:56:57";"Transakcja Sprzedaży";"O2-CS-8ZKSHX";"T2-CS-5E20P8";"-";"Solana (USD)";"50 Jednost.";"129,740";"-";"-";"-";"-";"4,075955";"26 440,72";"0,00";"-";"-";"-";"-";"-";"-";"-";"-";"-";"-";"-";"-";"-";"-";"-";"-";"-";"-";"-";"-";"-";"-";"-";"-";"-"
"18 Kw 2024 10:55:42";" Zamknięcie Transakcji";"O2-CS-8ZKSE2";"T2-CS-5E20LE";"O2-CS-8ZKSDK";"Solana (USD)";"11 Jednost.";"129,840";"-";"-";"-";"-";"4,03583";"5 822,07";"7,77";"25 348,31";"-";"-";"-";"-";"-";"-";"-";"-";"-";"-";"-";"-";"-";"-";"-";"-";"-";"-";"-";"-";"-";"-";"-";"-"
"18 Kw 2024 10:55:17";"Transakcja Sprzedaży";"O2-CS-8ZKSDK";"T2-CS-5E20KR";"-";"Solana (USD)";"11 Jednost.";"130,015";"-";"-";"-";"-";"4,076075";"5 829,45";"0,00";"-";"-";"-";"-";"-";"-";"-";"-";"-";"-";"-";"-";"-";"-";"-";"-";"-";"-";"-";"-";"-";"-";"-";"-";"-"
"18 Kw 2024 10:36:39";"Stop Loss";"O2-CS-8ZKQ93";"T2-CS-5E1ZS0";"-";"Solana (USD)";"10 Jednost.";"130,500";"-";"-";"-";"-";"4,04046";"5 325,78";"77,78";"25 340,54";"-";"-";"-";"-";"-";"-";"-";"-";"-";"-";"-";"-";"-";"-";"-";"-";"-";"-";"-";"-";"-";"-";"-";"-"
"18 Kw 2024 10:34:20";"Zmodyfikowano Stop Loss";"O2-CS-8ZKQ93";"-";"O2-CS-8ZKR61";"Solana (USD)";"10 Jednost.";"128,575";"-";"130,500";"-";"-";"-";"-";"-";"-";"-";"-";"-";"-";"-";"-";"-";"-";"-";"-";"-";"-";"-";"-";"-";"-";"-";"-";"-";"-";"-";"-";"-";"-"
"18 Kw 2024 10:32:37";" Zmodyfikowano Transakcję Kupna";"O2-CS-8ZKQ93";"T2-CS-5E1YTQ";"-";"Solana (USD)";"10 Jednost.";"128,575";"-";"129,500";"-";"-";"-";"-";"0,00";"-";"-";"-";"-";"-";"-";"-";"-";"-";"-";"-";"-";"-";"-";"-";"-";"-";"-";"-";"-";"-";"-";"-";"-";"-"
"18 Kw 2024 10:19:38";" Transakcja Kupna";"O2-CS-8ZKQ93";"T2-CS-5E1YTQ";"-";"Solana (USD)";"10 Jednost.";"128,575";"-";"-";"-";"-";"4,074893";"5 239,29";"0,00";"-";"-";"-";"-";"-";"-";"-";"-";"-";"-";"-";"-";"-";"-";"-";"-";"-";"-";"-";"-";"-";"-";"-";"-";"-"
"18 Kw 2024 01:55:41";"Take Profit";"O2-CS-8ZK4ZN";"T2-CS-5E1J0G";"-";"Solana (USD)";"50 Jednost.";"132,000";"-";"-";"-";"-";"4,04563";"26 969,48";"667,53";"25 262,76";"-";"-";"-";"-";"-";"-";"-";"-";"-";"-";"-";"-";"-";"-";"-";"-";"-";"-";"-";"-";"-";"-";"-";"-"
"17 Kw 2024 23:17:26";"Zmodyfikowano Take Profit";"O2-CS-8ZK4ZN";"-";"O2-CS-8ZK4ZS";"Solana (USD)";"50 Jednost.";"135,300";"-";"-";"132,000";"-";"-";"-";"-";"-";"-";"-";"-";"-";"-";"-";"-";"-";"-";"-";"-";"-";"-";"-";"-";"-";"-";"-";"-";"-";"-";"-";"-";"-"
"17 Kw 2024 23:15:21";"Zmodyfikowano Transakcję Sprzedaży";"O2-CS-8ZK4ZN";"T2-CS-5E1GZF";"-";"Solana (USD)";"50 Jednost.";"135,300";"-";"-";"133,000";"-";"-";"-";"0,00";"-";"-";"-";"-";"-";"-";"-";"-";"-";"-";"-";"-";"-";"-";"-";"-";"-";"-";"-";"-";"-";"-";"-";"-";"-"
"17 Kw 2024 23:15:05";"Transakcja Sprzedaży";"O2-CS-8ZK4ZN";"T2-CS-5E1GZF";"-";"Solana (USD)";"50 Jednost.";"135,300";"-";"-";"-";"-";"4,089122";"27 662,91";"0,00";"-";"-";"-";"-";"-";"-";"-";"-";"-";"-";"-";"-";"-";"-";"-";"-";"-";"-";"-";"-";"-";"-";"-";"-";"-"
"17 Kw 2024 23:12:02";"Stop Loss";"O2-CS-8ZK4Y2";"T2-CS-5E1GZ9";"-";"Solana (USD)";"7,3 Jednost.";"135,100";"-";"-";"-";"-";"4,04719";"4 031,56";"17,14";"24 595,23";"-";"-";"-";"-";"-";"-";"-";"-";"-";"-";"-";"-";"-";"-";"-";"-";"-";"-";"-";"-";"-";"-";"-";"-"
"17 Kw 2024 23:11:54";"Zmodyfikowano Stop Loss";"O2-CS-8ZK4Y2";"-";"O2-CS-8ZK4YG";"Solana (USD)";"7,3 Jednost.";"134,520";"-";"135,100";"-";"-";"-";"-";"-";"-";"-";"-";"-";"-";"-";"-";"-";"-";"-";"-";"-";"-";"-";"-";"-";"-";"-";"-";"-";"-";"-";"-";"-";"-"
"17 Kw 2024 23:10:53";" Zmodyfikowano Transakcję Kupna";"O2-CS-8ZK4Y2";"T2-CS-5E1GYY";"-";"Solana (USD)";"7,3 Jednost.";"134,520";"-";"134,800";"-";"-";"-";"-";"0,00";"-";"-";"-";"-";"-";"-";"-";"-";"-";"-";"-";"-";"-";"-";"-";"-";"-";"-";"-";"-";"-";"-";"-";"-";"-"
"17 Kw 2024 23:07:36";" Transakcja Kupna";"O2-CS-8ZK4Y2";"T2-CS-5E1GYY";"-";"Solana (USD)";"7,3 Jednost.";"134,520";"-";"-";"-";"-";"4,08811";"4 014,50";"0,00";"-";"-";"-";"-";"-";"-";"-";"-";"-";"-";"-";"-";"-";"-";"-";"-";"-";"-";"-";"-";"-";"-";"-";"-";"-"
"17 Kw 2024 23:01:20";"Koszty Utrzymania Pozycji";"1327760649";"-";"-";"Rachunek";"-";"-";"-";"-";"-";"-";"-";"-";"-20,52";"24 578,09";"-";"-";"-";"-";"-";"-20,52";"-";"-";"-";"-";"-";"-";"-";"-";"-";"-";"-";"-";"-";"-";"-";"-";"-";"-"
"17 Kw 2024 23:01:20";"Koszty Utrzymania Pozycji";"O2-CR-8Z7P36";"-";"-";"Solana (USD)";"-";"-";"-";"-";"-";"-";"-";"-";"-";"-";"-";"-";"6 669,75";"-27,50000%";"-20,52";"-20,52";"-";"-";"-";"-";"-";"-";"-";"-";"-";"-";"-";"-";"-";"-";"-";"-";"-";"-"
"17 Kw 2024 22:56:08";"Stop Loss";"O2-CS-8ZK4FS";"T2-CS-5E1GVT";"-";"Solana (USD)";"10 Jednost.";"133,602";"-";"-";"-";"-";"4,04373";"5 456,78";"38,58";"24 465,57";"-";"-";"-";"-";"-";"-";"-";"-";"-";"-";"-";"-";"-";"-";"-";"-";"-";"-";"-";"-";"-";"-";"-";"-"
"17 Kw 2024 22:56:08";"Stop Loss";"O2-CS-8ZK2LM";"T2-CS-5E1GVV";"-";"Solana (USD)";"50 Jednost.";"133,602";"-";"-";"-";"-";"4,04373";"27 283,94";"133,04";"24 598,61";"-";"-";"-";"-";"-";"-";"-";"-";"-";"-";"-";"-";"-";"-";"-";"-";"-";"-";"-";"-";"-";"-";"-";"-"
"17 Kw 2024 22:52:06";"Zmodyfikowano Stop Loss";"O2-CS-8ZK4FS";"-";"O2-CS-8ZK4JX";"Solana (USD)";"10 Jednost.";"134,556";"-";"133,600";"-";"-";"-";"-";"-";"-";"-";"-";"-";"-";"-";"-";"-";"-";"-";"-";"-";"-";"-";"-";"-";"-";"-";"-";"-";"-";"-";"-";"-";"-"
"17 Kw 2024 22:51:49";"Zmodyfikowano Stop Loss";"O2-CS-8ZK2LM";"-";"O2-CS-8ZK4L1";"Solana (USD)";"50 Jednost.";"134,260";"-";"133,600";"-";"-";"-";"-";"-";"-";"-";"-";"-";"-";"-";"-";"-";"-";"-";"-";"-";"-";"-";"-";"-";"-";"-";"-";"-";"-";"-";"-";"-";"-"
"17 Kw 2024 22:51:01";"Zmodyfikowano Stop Loss";"O2-CS-8ZK4FS";"-";"O2-CS-8ZK4JX";"Solana (USD)";"10 Jednost.";"134,556";"-";"133,800";"-";"-";"-";"-";"-";"-";"-";"-";"-";"-";"-";"-";"-";"-";"-";"-";"-";"-";"-";"-";"-";"-";"-";"-";"-";"-";"-";"-";"-";"-"
"17 Kw 2024 22:50:43";"Zmodyfikowano Transakcję Sprzedaży";"O2-CS-8ZK2LM";"T2-CS-5E1EXV";"-";"Solana (USD)";"50 Jednost.";"134,260";"-";"133,800";"131,000";"-";"-";"-";"0,00";"-";"-";"-";"-";"-";"-";"-";"-";"-";"-";"-";"-";"-";"-";"-";"-";"-";"-";"-";"-";"-";"-";"-";"-";"-"
"17 Kw 2024 22:49:27";"Zmodyfikowano Transakcję Sprzedaży";"O2-CS-8ZK4FS";"T2-CS-5E1GJ7";"-";"Solana (USD)";"10 Jednost.";"134,556";"-";"134,400";"131,000";"-";"-";"-";"0,00";"-";"-";"-";"-";"-";"-";"-";"-";"-";"-";"-";"-";"-";"-";"-";"-";"-";"-";"-";"-";"-";"-";"-";"-";"-"
"17 Kw 2024 22:47:09";"Zmodyfikowano Transakcję Sprzedaży";"O2-CS-8ZK4FS";"T2-CS-5E1GJ7";"-";"Solana (USD)";"10 Jednost.";"134,556";"-";"-";"131,000";"-";"-";"-";"0,00";"-";"-";"-";"-";"-";"-";"-";"-";"-";"-";"-";"-";"-";"-";"-";"-";"-";"-";"-";"-";"-";"-";"-";"-";"-"
"17 Kw 2024 22:44:19";"Transakcja Sprzedaży";"O2-CS-8ZK4FS";"T2-CS-5E1GJ7";"-";"Solana (USD)";"10 Jednost.";"134,556";"-";"-";"-";"-";"4,083801";"5 494,99";"0,00";"-";"-";"-";"-";"-";"-";"-";"-";"-";"-";"-";"-";"-";"-";"-";"-";"-";"-";"-";"-";"-";"-";"-";"-";"-"
"17 Kw 2024 21:48:04";"Zmodyfikowano Transakcję Sprzedaży";"O2-CS-8ZK2LM";"T2-CS-5E1EXV";"-";"Solana (USD)";"50 Jednost.";"134,260";"-";"-";"131,000";"-";"-";"-";"0,00";"-";"-";"-";"-";"-";"-";"-";"-";"-";"-";"-";"-";"-";"-";"-";"-";"-";"-";"-";"-";"-";"-";"-";"-";"-"
"17 Kw 2024 21:47:31";"Transakcja Sprzedaży";"O2-CS-8ZK2LM";"T2-CS-5E1EXV";"-";"Solana (USD)";"50 Jednost.";"134,260";"-";"-";"-";"-";"4,085975";"27 429,15";"0,00";"-";"-";"-";"-";"-";"-";"-";"-";"-";"-";"-";"-";"-";"-";"-";"-";"-";"-";"-";"-";"-";"-";"-";"-";"-"
"17 Kw 2024 21:41:28";"Stop Loss";"O2-CS-8ZK1QF";"T2-CS-5E1EET";"-";"Solana (USD)";"50 Jednost.";"133,164";"-";"-";"-";"-";"4,04649";"27 213,11";"234,90";"24 426,99";"-";"-";"-";"-";"-";"-";"-";"-";"-";"-";"-";"-";"-";"-";"-";"-";"-";"-";"-";"-";"-";"-";"-";"-"
"17 Kw 2024 21:41:08";"Zmodyfikowano Stop Loss";"O2-CS-8ZK1QF";"-";"O2-CS-8ZK215";"Solana (USD)";"50 Jednost.";"134,325";"-";"133,150";"-";"-";"-";"-";"-";"-";"-";"-";"-";"-";"-";"-";"-";"-";"-";"-";"-";"-";"-";"-";"-";"-";"-";"-";"-";"-";"-";"-";"-";"-"
"17 Kw 2024 21:40:20";"Zmodyfikowano Stop Loss";"O2-CS-8ZK1QF";"-";"O2-CS-8ZK215";"Solana (USD)";"50 Jednost.";"134,325";"-";"133,450";"-";"-";"-";"-";"-";"-";"-";"-";"-";"-";"-";"-";"-";"-";"-";"-";"-";"-";"-";"-";"-";"-";"-";"-";"-";"-";"-";"-";"-";"-"
"17 Kw 2024 21:39:47";"Zmodyfikowano Transakcję Sprzedaży";"O2-CS-8ZK1QF";"T2-CS-5E1E1T";"-";"Solana (USD)";"50 Jednost.";"134,325";"-";"133,650";"-";"-";"-";"-";"0,00";"-";"-";"-";"-";"-";"-";"-";"-";"-";"-";"-";"-";"-";"-";"-";"-";"-";"-";"-";"-";"-";"-";"-";"-";"-"
"17 Kw 2024 21:35:11";"Transakcja Sprzedaży";"O2-CS-8ZK1QF";"T2-CS-5E1E1T";"-";"Solana (USD)";"50 Jednost.";"134,325";"-";"-";"-";"-";"4,08839";"27 458,64";"0,00";"-";"-";"-";"-";"-";"-";"-";"-";"-";"-";"-";"-";"-";"-";"-";"-";"-";"-";"-";"-";"-";"-";"-";"-";"-"
"17 Kw 2024 21:27:06";"Stop Loss";"O2-CS-8ZJZFX";"T2-CS-5E1DGR";"-";"Solana (USD)";"50 Jednost.";"133,420";"-";"-";"-";"-";"4,04734";"27 271,10";"54,64";"24 192,09";"-";"-";"-";"-";"-";"-";"-";"-";"-";"-";"-";"-";"-";"-";"-";"-";"-";"-";"-";"-";"-";"-";"-";"-"
"17 Kw 2024 21:24:59";"Zmodyfikowano Transakcję Sprzedaży";"O2-CS-8ZJZFX";"T2-CS-5E1C31";"-";"Solana (USD)";"50 Jednost.";"133,690";"-";"133,400";"132,000";"-";"-";"-";"0,00";"-";"-";"-";"-";"-";"-";"-";"-";"-";"-";"-";"-";"-";"-";"-";"-";"-";"-";"-";"-";"-";"-";"-";"-";"-"
"17 Kw 2024 21:22:33";"Zmodyfikowano Take Profit";"O2-CS-8ZJZFX";"-";"O2-CS-8ZJZZ9";"Solana (USD)";"50 Jednost.";"133,690";"-";"-";"132,000";"-";"-";"-";"-";"-";"-";"-";"-";"-";"-";"-";"-";"-";"-";"-";"-";"-";"-";"-";"-";"-";"-";"-";"-";"-";"-";"-";"-";"-"
"17 Kw 2024 21:14:04";"Zmodyfikowano Transakcję Sprzedaży";"O2-CS-8ZJZFX";"T2-CS-5E1C31";"-";"Solana (USD)";"50 Jednost.";"133,690";"-";"-";"133,000";"-";"-";"-";"0,00";"-";"-";"-";"-";"-";"-";"-";"-";"-";"-";"-";"-";"-";"-";"-";"-";"-";"-";"-";"-";"-";"-";"-";"-";"-"
"17 Kw 2024 21:09:28";"Transakcja Sprzedaży";"O2-CS-8ZJZFX";"T2-CS-5E1C31";"-";"Solana (USD)";"50 Jednost.";"133,690";"-";"-";"-";"-";"4,08856";"27 329,97";"0,00";"-";"-";"-";"-";"-";"-";"-";"-";"-";"-";"-";"-";"-";"-";"-";"-";"-";"-";"-";"-";"-";"-";"-";"-";"-"
"17 Kw 2024 21:02:32";"Stop Loss";"O2-CS-8ZJXSC";"T2-CS-5E1BGG";"-";"Solana (USD)";"30 Jednost.";"134,800";"-";"-";"-";"-";"4,04724";"16 531,50";"67,27";"24 137,45";"-";"-";"-";"-";"-";"-";"-";"-";"-";"-";"-";"-";"-";"-";"-";"-";"-";"-";"-";"-";"-";"-";"-";"-"
"17 Kw 2024 21:02:30";"Zmodyfikowano Stop Loss";"O2-CS-8ZJXSC";"-";"O2-CS-8ZJYQC";"Solana (USD)";"30 Jednost.";"135,354";"-";"134,800";"-";"-";"-";"-";"-";"-";"-";"-";"-";"-";"-";"-";"-";"-";"-";"-";"-";"-";"-";"-";"-";"-";"-";"-";"-";"-";"-";"-";"-";"-"
"17 Kw 2024 21:01:56";"Zmodyfikowano Transakcję Sprzedaży";"O2-CS-8ZJXSC";"T2-CS-5E19N0";"-";"Solana (USD)";"30 Jednost.";"135,354";"-";"135,800";"132,000";"-";"-";"-";"0,00";"-";"-";"-";"-";"-";"-";"-";"-";"-";"-";"-";"-";"-";"-";"-";"-";"-";"-";"-";"-";"-";"-";"-";"-";"-"
"17 Kw 2024 21:00:02";"Zmodyfikowano Transakcję Sprzedaży";"O2-CS-8ZJXSC";"T2-CS-5E19N0";"-";"Solana (USD)";"30 Jednost.";"135,354";"-";"-";"132,000";"-";"-";"-";"0,00";"-";"-";"-";"-";"-";"-";"-";"-";"-";"-";"-";"-";"-";"-";"-";"-";"-";"-";"-";"-";"-";"-";"-";"-";"-"
"17 Kw 2024 20:54:13";"Transakcja Sprzedaży";"O2-CS-8ZJXSC";"T2-CS-5E19N0";"-";"Solana (USD)";"30 Jednost.";"135,354";"-";"-";"-";"-";"4,084041";"16 583,73";"0,00";"-";"-";"-";"-";"-";"-";"-";"-";"-";"-";"-";"-";"-";"-";"-";"-";"-";"-";"-";"-";"-";"-";"-";"-";"-"
"17 Kw 2024 20:37:59";" Zamknięcie Transakcji";"O2-CS-8ZJVWC";"T2-CS-5E17VD";"O2-CS-8ZJVK6";"Solana (USD)";"8,97 Jednost.";"136,270";"-";"-";"-";"-";"4,04722";"4 996,79";"5,30";"24 070,18";"-";"-";"-";"-";"-";"-";"-";"-";"-";"-";"-";"-";"-";"-";"-";"-";"-";"-";"-";"-";"-";"-";"-";"-"
"17 Kw 2024 20:31:16";"Transakcja Sprzedaży";"O2-CS-8ZJVK6";"T2-CS-5E17KJ";"-";"Solana (USD)";"8,97 Jednost.";"136,416";"-";"-";"-";"-";"4,087328";"5 001,46";"0,00";"-";"-";"-";"-";"-";"-";"-";"-";"-";"-";"-";"-";"-";"-";"-";"-";"-";"-";"-";"-";"-";"-";"-";"-";"-"
"17 Kw 2024 20:16:16";"Stop Loss";"O2-CS-8ZJR95";"T2-CS-5E16N0";"-";"Solana (USD)";"4,45 Jednost.";"134,500";"-";"-";"-";"-";"4,04578";"2 445,84";"48,07";"23 998,82";"-";"-";"-";"-";"-";"-";"-";"-";"-";"-";"-";"-";"-";"-";"-";"-";"-";"-";"-";"-";"-";"-";"-";"-"
"17 Kw 2024 20:16:16";"Stop Loss";"O2-CS-8ZJCTG";"T2-CS-5E16N1";"-";"Solana (USD)";"3,02 Jednost.";"134,500";"-";"-";"-";"-";"4,04578";"1 659,87";"66,06";"24 064,88";"-";"-";"-";"-";"-";"-";"-";"-";"-";"-";"-";"-";"-";"-";"-";"-";"-";"-";"-";"-";"-";"-";"-";"-"
"17 Kw 2024 20:13:57";"Zmodyfikowano Stop Loss";"O2-CS-8ZJCTG";"-";"O2-CS-8ZJSND";"Solana (USD)";"3,02 Jednost.";"129,093";"-";"134,500";"-";"-";"-";"-";"-";"-";"-";"-";"-";"-";"-";"-";"-";"-";"-";"-";"-";"-";"-";"-";"-";"-";"-";"-";"-";"-";"-";"-";"-";"-"
"17 Kw 2024 20:13:44";"Zmodyfikowano Stop Loss";"O2-CS-8ZJR95";"-";"O2-CS-8ZJSMS";"Solana (USD)";"4,45 Jednost.";"131,830";"-";"134,500";"-";"-";"-";"-";"-";"-";"-";"-";"-";"-";"-";"-";"-";"-";"-";"-";"-";"-";"-";"-";"-";"-";"-";"-";"-";"-";"-";"-";"-";"-"
"17 Kw 2024 20:10:45";"Zmodyfikowano Stop Loss";"O2-CS-8ZJCTG";"-";"O2-CS-8ZJSND";"Solana (USD)";"3,02 Jednost.";"129,093";"-";"134,300";"-";"-";"-";"-";"-";"-";"-";"-";"-";"-";"-";"-";"-";"-";"-";"-";"-";"-";"-";"-";"-";"-";"-";"-";"-";"-";"-";"-";"-";"-"
"17 Kw 2024 20:10:35";"Zmodyfikowano Stop Loss";"O2-CS-8ZJR95";"-";"O2-CS-8ZJSMS";"Solana (USD)";"4,45 Jednost.";"131,830";"-";"134,300";"-";"-";"-";"-";"-";"-";"-";"-";"-";"-";"-";"-";"-";"-";"-";"-";"-";"-";"-";"-";"-";"-";"-";"-";"-";"-";"-";"-";"-";"-"
"17 Kw 2024 20:06:34";" Zmodyfikowano Transakcję Kupna";"O2-CS-8ZJCTG";"T2-CS-5E0RVK";"-";"Solana (USD)";"3,02 Jednost.";"129,093";"-";"134,000";"139,000";"-";"-";"-";"0,00";"-";"-";"-";"-";"-";"-";"-";"-";"-";"-";"-";"-";"-";"-";"-";"-";"-";"-";"-";"-";"-";"-";"-";"-";"-"
"17 Kw 2024 20:06:19";" Zmodyfikowano Transakcję Kupna";"O2-CS-8ZJR95";"T2-CS-5E14R2";"-";"Solana (USD)";"4,45 Jednost.";"131,830";"-";"134,000";"139,000";"-";"-";"-";"0,00";"-";"-";"-";"-";"-";"-";"-";"-";"-";"-";"-";"-";"-";"-";"-";"-";"-";"-";"-";"-";"-";"-";"-";"-";"-"
"17 Kw 2024 19:51:21";" Zmodyfikowano Transakcję Kupna";"O2-CS-8ZJR95";"T2-CS-5E14R2";"-";"Solana (USD)";"4,45 Jednost.";"131,830";"-";"-";"139,000";"-";"-";"-";"0,00";"-";"-";"-";"-";"-";"-";"-";"-";"-";"-";"-";"-";"-";"-";"-";"-";"-";"-";"-";"-";"-";"-";"-";"-";"-"
"17 Kw 2024 19:50:58";" Transakcja Kupna";"O2-CS-8ZJR95";"T2-CS-5E14R2";"-";"Solana (USD)";"4,45 Jednost.";"131,830";"-";"-";"-";"-";"4,092148";"2 400,63";"0,00";"-";"-";"-";"-";"-";"-";"-";"-";"-";"-";"-";"-";"-";"-";"-";"-";"-";"-";"-";"-";"-";"-";"-";"-";"-"
"17 Kw 2024 17:55:26";" Zmodyfikowano Transakcję Kupna";"O2-CS-8ZJCTG";"T2-CS-5E0RVK";"-";"Solana (USD)";"3,02 Jednost.";"129,093";"-";"-";"139,000";"-";"-";"-";"0,00";"-";"-";"-";"-";"-";"-";"-";"-";"-";"-";"-";"-";"-";"-";"-";"-";"-";"-";"-";"-";"-";"-";"-";"-";"-"
"17 Kw 2024 17:54:19";" Transakcja Kupna";"O2-CS-8ZJCTG";"T2-CS-5E0RVK";"-";"Solana (USD)";"3,02 Jednost.";"129,093";"-";"-";"-";"-";"4,106055";"1 600,79";"0,00";"-";"-";"-";"-";"-";"-";"-";"-";"-";"-";"-";"-";"-";"-";"-";"-";"-";"-";"-";"-";"-";"-";"-";"-";"-"
"16 Kw 2024 23:01:11";"Koszty Utrzymania Pozycji";"1327304031";"-";"-";"Rachunek";"-";"-";"-";"-";"-";"-";"-";"-";"-20,88";"23 950,75";"-";"-";"-";"-";"-";"-20,88";"-";"-";"-";"-";"-";"-";"-";"-";"-";"-";"-";"-";"-";"-";"-";"-";"-";"-"
"16 Kw 2024 23:01:11";"Koszty Utrzymania Pozycji";"O2-CR-8Z7P36";"-";"-";"Solana (USD)";"-";"-";"-";"-";"-";"-";"-";"-";"-";"-";"-";"-";"6 707,60";"-27,50000%";"-20,88";"-20,88";"-";"-";"-";"-";"-";"-";"-";"-";"-";"-";"-";"-";"-";"-";"-";"-";"-";"-"
"16 Kw 2024 20:54:20";" Zamknięcie Transakcji";"O2-CS-8ZGGWT";"T2-CS-5DZ5S1";"O2-CR-8Z7P36";"Solana (USD)";"9 Jednost.";"134,048";"-";"-";"-";"-";"4,119422";"4 969,80";"-1 456,37";"23 971,63";"-";"-";"-";"-";"-";"-";"-";"-";"-";"-";"-";"-";"-";"-";"-";"-";"-";"-";"-";"-";"-";"-";"-";"-"
"16 Kw 2024 18:20:11";" Wpłata";"1327135843";"BD.46833655";"-";"Rachunek";"-";"-";"-";"-";"-";"-";"-";"-";"5 000,00";"25 428,00";"5 000,00";"0,00";"-";"-";"-";"-";"-";"-";"-";"-";"-";"-";"-";"-";"-";"-";"-";"-";"-";"-";"-";"-";"-";"-"
"15 Kw 2024 23:01:05";"Koszty Utrzymania Pozycji";"1326773191";"-";"-";"Rachunek";"-";"-";"-";"-";"-";"-";"-";"-";"-24,66";"20 428,00";"-";"-";"-";"-";"-";"-24,66";"-";"-";"-";"-";"-";"-";"-";"-";"-";"-";"-";"-";"-";"-";"-";"-";"-";"-"
"15 Kw 2024 23:01:05";"Koszty Utrzymania Pozycji";"O2-CR-8Z7P36";"-";"-";"Solana (USD)";"-";"-";"-";"-";"-";"-";"-";"-";"-";"-";"-";"-";"8 037,57";"-27,50000%";"-24,66";"-24,66";"-";"-";"-";"-";"-";"-";"-";"-";"-";"-";"-";"-";"-";"-";"-";"-";"-";"-"
"12 Kw 2024 23:01:12";"Koszty Utrzymania Pozycji";"1326329733";"-";"-";"Rachunek";"-";"-";"-";"-";"-";"-";"-";"-";"-80,58";"20 452,66";"-";"-";"-";"-";"-";"-80,58";"-";"-";"-";"-";"-";"-";"-";"-";"-";"-";"-";"-";"-";"-";"-";"-";"-";"-"
"12 Kw 2024 23:01:12";"Koszty Utrzymania Pozycji";"O2-CR-8Z7P36";"-";"-";"Solana (USD)";"-";"-";"-";"-";"-";"-";"-";"-";"-";"-";"-";"-";"8 805,16";"-27,50000%";"-80,58";"-80,58";"-";"-";"-";"-";"-";"-";"-";"-";"-";"-";"-";"-";"-";"-";"-";"-";"-";"-"
"12 Kw 2024 17:19:02";" Zmodyfikowano Transakcję Kupna";"O2-CR-8Z7P36";"T2-CR-5DRKG7";"-";"Solana (USD)";"59 Jednost.";"173,330";"-";"-";"-";"-";"-";"-";"0,00";"-";"-";"-";"-";"-";"-";"-";"-";"-";"-";"-";"-";"-";"-";"-";"-";"-";"-";"-";"-";"-";"-";"-";"-";"-"
"12 Kw 2024 13:43:49";"Zmodyfikowano Take Profit";"O2-CR-8Z7P36";"-";"O2-CR-8Z7Y6G";"Solana (USD)";"59 Jednost.";"173,330";"-";"-";"173,550";"-";"-";"-";"-";"-";"-";"-";"-";"-";"-";"-";"-";"-";"-";"-";"-";"-";"-";"-";"-";"-";"-";"-";"-";"-";"-";"-";"-";"-"
"12 Kw 2024 12:07:25";" Zmodyfikowano Transakcję Kupna";"O2-CR-8Z7P36";"T2-CR-5DRKG7";"-";"Solana (USD)";"59 Jednost.";"173,330";"-";"-";"173,450";"-";"-";"-";"0,00";"-";"-";"-";"-";"-";"-";"-";"-";"-";"-";"-";"-";"-";"-";"-";"-";"-";"-";"-";"-";"-";"-";"-";"-";"-"
"12 Kw 2024 10:10:35";" Transakcja Kupna";"O2-CR-8Z7P36";"T2-CR-5DRKG7";"-";"Solana (USD)";"59 Jednost.";"173,330";"-";"-";"-";"-";"4,012639";"41 035,13";"0,00";"-";"-";"-";"-";"-";"-";"-";"-";"-";"-";"-";"-";"-";"-";"-";"-";"-";"-";"-";"-";"-";"-";"-";"-";"-"
"12 Kw 2024 06:51:35";"Take Profit";"O2-CR-8Z71S2";"T2-CR-5DRBKT";"-";"Solana (USD)";"58,5 Jednost.";"174,500";"-";"-";"-";"-";"3,96036";"40 834,67";"396,17";"20 533,24";"-";"-";"-";"-";"-";"-";"-";"-";"-";"-";"-";"-";"-";"-";"-";"-";"-";"-";"-";"-";"-";"-";"-";"-"
"12 Kw 2024 00:09:04";" Zmodyfikowano Transakcję Kupna";"O2-CR-8Z71S2";"T2-CR-5DR3RD";"-";"Solana (USD)";"58,5 Jednost.";"172,790";"-";"-";"174,500";"-";"-";"-";"0,00";"-";"-";"-";"-";"-";"-";"-";"-";"-";"-";"-";"-";"-";"-";"-";"-";"-";"-";"-";"-";"-";"-";"-";"-";"-"
"12 Kw 2024 00:07:45";" Transakcja Kupna";"O2-CR-8Z71S2";"T2-CR-5DR3RD";"-";"Solana (USD)";"58,5 Jednost.";"172,790";"-";"-";"-";"-";"3,99328";"40 364,93";"0,00";"-";"-";"-";"-";"-";"-";"-";"-";"-";"-";"-";"-";"-";"-";"-";"-";"-";"-";"-";"-";"-";"-";"-";"-";"-"
"11 Kw 2024 19:07:05";"Stop Loss";"O2-CR-8Z6F8C";"T2-CR-5DQPCR";"-";"Solana (USD)";"57,8 Jednost.";"173,952";"-";"-";"-";"-";"3,95509";"40 165,75";"278,67";"20 137,07";"-";"-";"-";"-";"-";"-";"-";"-";"-";"-";"-";"-";"-";"-";"-";"-";"-";"-";"-";"-";"-";"-";"-";"-"
"11 Kw 2024 19:05:47";" Zmodyfikowano Transakcję Kupna";"O2-CR-8Z6F8C";"T2-CR-5DQLWN";"-";"Solana (USD)";"57,8 Jednost.";"172,733";"-";"174,000";"174,600";"-";"-";"-";"0,00";"-";"-";"-";"-";"-";"-";"-";"-";"-";"-";"-";"-";"-";"-";"-";"-";"-";"-";"-";"-";"-";"-";"-";"-";"-"
"11 Kw 2024 18:37:21";"Zmodyfikowano Take Profit";"O2-CR-8Z6F8C";"-";"O2-CR-8Z6FB0";"Solana (USD)";"57,8 Jednost.";"172,733";"-";"-";"174,600";"-";"-";"-";"-";"-";"-";"-";"-";"-";"-";"-";"-";"-";"-";"-";"-";"-";"-";"-";"-";"-";"-";"-";"-";"-";"-";"-";"-";"-"
"11 Kw 2024 18:34:09";"Zmodyfikowano Take Profit";"O2-CR-8Z6F8C";"-";"O2-CR-8Z6FB0";"Solana (USD)";"57,8 Jednost.";"172,733";"-";"-";"174,200";"-";"-";"-";"-";"-";"-";"-";"-";"-";"-";"-";"-";"-";"-";"-";"-";"-";"-";"-";"-";"-";"-";"-";"-";"-";"-";"-";"-";"-"
"11 Kw 2024 18:27:15";" Zmodyfikowano Transakcję Kupna";"O2-CR-8Z6F8C";"T2-CR-5DQLWN";"-";"Solana (USD)";"57,8 Jednost.";"172,733";"-";"-";"173,800";"-";"-";"-";"0,00";"-";"-";"-";"-";"-";"-";"-";"-";"-";"-";"-";"-";"-";"-";"-";"-";"-";"-";"-";"-";"-";"-";"-";"-";"-"
"11 Kw 2024 18:26:27";" Transakcja Kupna";"O2-CR-8Z6F8C";"T2-CR-5DQLWN";"-";"Solana (USD)";"57,8 Jednost.";"172,733";"-";"-";"-";"-";"3,996988";"39 905,79";"0,00";"-";"-";"-";"-";"-";"-";"-";"-";"-";"-";"-";"-";"-";"-";"-";"-";"-";"-";"-";"-";"-";"-";"-";"-";"-"
"11 Kw 2024 18:09:41";"Stop Loss";"O2-CR-8Z6DNL";"T2-CR-5DQKZG";"-";"Solana (USD)";"57,2 Jednost.";"174,185";"-";"-";"-";"-";"3,95721";"39 823,41";"108,65";"19 858,40";"-";"-";"-";"-";"-";"-";"-";"-";"-";"-";"-";"-";"-";"-";"-";"-";"-";"-";"-";"-";"-";"-";"-";"-"
"11 Kw 2024 18:09:40";"Zmodyfikowano Stop Loss";"O2-CR-8Z6DNL";"-";"O2-CR-8Z6E4W";"Solana (USD)";"0 Jednost.";"173,705";"-";"174,200";"-";"-";"-";"-";"-";"-";"-";"-";"-";"-";"-";"-";"-";"-";"-";"-";"-";"-";"-";"-";"-";"-";"-";"-";"-";"-";"-";"-";"-";"-"
"11 Kw 2024 18:08:56";" Zmodyfikowano Transakcję Kupna";"O2-CR-8Z6DNL";"T2-CR-5DQKKN";"-";"Solana (USD)";"57,2 Jednost.";"173,705";"-";"174,000";"-";"-";"-";"-";"0,00";"-";"-";"-";"-";"-";"-";"-";"-";"-";"-";"-";"-";"-";"-";"-";"-";"-";"-";"-";"-";"-";"-";"-";"-";"-"
"11 Kw 2024 18:02:31";" Transakcja Kupna";"O2-CR-8Z6DNL";"T2-CR-5DQKKN";"-";"Solana (USD)";"57,2 Jednost.";"173,705";"-";"-";"-";"-";"3,995595";"39 699,93";"0,00";"-";"-";"-";"-";"-";"-";"-";"-";"-";"-";"-";"-";"-";"-";"-";"-";"-";"-";"-";"-";"-";"-";"-";"-";"-"
"11 Kw 2024 18:00:12";"Stop Loss";"O2-CR-8Z6CTZ";"T2-CR-5DQKBR";"-";"Solana (USD)";"57,2 Jednost.";"173,100";"-";"-";"-";"-";"3,95606";"39 563,94";"56,57";"19 749,75";"-";"-";"-";"-";"-";"-";"-";"-";"-";"-";"-";"-";"-";"-";"-";"-";"-";"-";"-";"-";"-";"-";"-";"-"
"11 Kw 2024 17:59:19";" Zmodyfikowano Transakcję Kupna";"O2-CR-8Z6CTZ";"T2-CR-5DQJW3";"-";"Solana (USD)";"57,2 Jednost.";"172,850";"-";"173,100";"-";"-";"-";"-";"0,00";"-";"-";"-";"-";"-";"-";"-";"-";"-";"-";"-";"-";"-";"-";"-";"-";"-";"-";"-";"-";"-";"-";"-";"-";"-"
"11 Kw 2024 17:57:29";" Transakcja Kupna";"O2-CR-8Z6CTZ";"T2-CR-5DQJW3";"-";"Solana (USD)";"57,2 Jednost.";"172,850";"-";"-";"-";"-";"3,996106";"39 509,57";"0,00";"-";"-";"-";"-";"-";"-";"-";"-";"-";"-";"-";"-";"-";"-";"-";"-";"-";"-";"-";"-";"-";"-";"-";"-";"-"
"11 Kw 2024 17:54:22";" Zamknięcie Transakcji";"O2-CR-8Z6CJW";"T2-CR-5DQJM6";"O2-CR-8Z6CH2";"Solana (USD)";"28 Jednost.";"172,215";"-";"-";"-";"-";"3,95698";"19 272,39";"7,20";"19 693,18";"-";"-";"-";"-";"-";"-";"-";"-";"-";"-";"-";"-";"-";"-";"-";"-";"-";"-";"-";"-";"-";"-";"-";"-"
"11 Kw 2024 17:52:51";"Transakcja Sprzedaży";"O2-CR-8Z6CH2";"T2-CR-5DQJKP";"-";"Solana (USD)";"28 Jednost.";"172,280";"-";"-";"-";"-";"3,996557";"19 278,75";"0,00";"-";"-";"-";"-";"-";"-";"-";"-";"-";"-";"-";"-";"-";"-";"-";"-";"-";"-";"-";"-";"-";"-";"-";"-";"-"
"11 Kw 2024 17:35:27";"Stop Loss";"O2-CR-8Z64S4";"T2-CR-5DQGZ2";"-";"Solana (USD)";"56 Jednost.";"172,510";"-";"-";"-";"-";"3,96236";"38 663,37";"254,07";"19 685,98";"-";"-";"-";"-";"-";"-";"-";"-";"-";"-";"-";"-";"-";"-";"-";"-";"-";"-";"-";"-";"-";"-";"-";"-"
"11 Kw 2024 17:35:13";"Zmodyfikowano Stop Loss";"O2-CR-8Z64S4";"-";"O2-CR-8Z68WK";"Solana (USD)";"56 Jednost.";"173,655";"-";"172,500";"-";"-";"-";"-";"-";"-";"-";"-";"-";"-";"-";"-";"-";"-";"-";"-";"-";"-";"-";"-";"-";"-";"-";"-";"-";"-";"-";"-";"-";"-"
"11 Kw 2024 17:31:54";"Zmodyfikowano Stop Loss";"O2-CR-8Z64S4";"-";"O2-CR-8Z68WK";"Solana (USD)";"56 Jednost.";"173,655";"-";"172,700";"-";"-";"-";"-";"-";"-";"-";"-";"-";"-";"-";"-";"-";"-";"-";"-";"-";"-";"-";"-";"-";"-";"-";"-";"-";"-";"-";"-";"-";"-"
"11 Kw 2024 17:31:03";"Zmodyfikowano Stop Loss";"O2-CR-8Z64S4";"-";"O2-CR-8Z68WK";"Solana (USD)";"56 Jednost.";"173,655";"-";"173,000";"-";"-";"-";"-";"-";"-";"-";"-";"-";"-";"-";"-";"-";"-";"-";"-";"-";"-";"-";"-";"-";"-";"-";"-";"-";"-";"-";"-";"-";"-"
"11 Kw 2024 17:30:03";"Zmodyfikowano Transakcję Sprzedaży";"O2-CR-8Z64S4";"T2-CR-5DQDHE";"-";"Solana (USD)";"56 Jednost.";"173,655";"-";"173,400";"-";"-";"-";"-";"0,00";"-";"-";"-";"-";"-";"-";"-";"-";"-";"-";"-";"-";"-";"-";"-";"-";"-";"-";"-";"-";"-";"-";"-";"-";"-"
"11 Kw 2024 17:27:17";"Zmodyfikowano Transakcję Sprzedaży";"O2-CR-8Z64S4";"T2-CR-5DQDHE";"-";"Solana (USD)";"56 Jednost.";"173,655";"-";"-";"-";"-";"-";"-";"0,00";"-";"-";"-";"-";"-";"-";"-";"-";"-";"-";"-";"-";"-";"-";"-";"-";"-";"-";"-";"-";"-";"-";"-";"-";"-"
"11 Kw 2024 17:14:21";"Zmodyfikowano Transakcję Sprzedaży";"O2-CR-8Z64S4";"T2-CR-5DQDHE";"-";"Solana (USD)";"56 Jednost.";"173,655";"-";"-";"173,500";"-";"-";"-";"0,00";"-";"-";"-";"-";"-";"-";"-";"-";"-";"-";"-";"-";"-";"-";"-";"-";"-";"-";"-";"-";"-";"-";"-";"-";"-"
"11 Kw 2024 16:56:31";"Transakcja Sprzedaży";"O2-CR-8Z64S4";"T2-CR-5DQDHE";"-";"Solana (USD)";"56 Jednost.";"173,655";"-";"-";"-";"-";"4,001937";"38 917,55";"0,00";"-";"-";"-";"-";"-";"-";"-";"-";"-";"-";"-";"-";"-";"-";"-";"-";"-";"-";"-";"-";"-";"-";"-";"-";"-"
"11 Kw 2024 16:52:59";" Zamknięcie Transakcji";"O2-CR-8Z64D6";"T2-CR-5DQD80";"O2-CR-8Z5RT6";"Solana (USD)";"56 Jednost.";"173,855";"-";"-";"-";"-";"3,96338";"38 974,77";"37,51";"19 431,91";"-";"-";"-";"-";"-";"-";"-";"-";"-";"-";"-";"-";"-";"-";"-";"-";"-";"-";"-";"-";"-";"-";"-";"-"
"11 Kw 2024 16:46:52";" Zmodyfikowano Transakcję Kupna";"O2-CR-8Z5RT6";"T2-CR-5DQ34B";"-";"Solana (USD)";"56 Jednost.";"173,686";"-";"-";"-";"-";"-";"-";"0,00";"-";"-";"-";"-";"-";"-";"-";"-";"-";"-";"-";"-";"-";"-";"-";"-";"-";"-";"-";"-";"-";"-";"-";"-";"-"
"11 Kw 2024 16:31:20";" Zmodyfikowano Transakcję Kupna";"O2-CR-8Z5RT6";"T2-CR-5DQ34B";"-";"Solana (USD)";"56 Jednost.";"173,686";"-";"-";"174,000";"-";"-";"-";"0,00";"-";"-";"-";"-";"-";"-";"-";"-";"-";"-";"-";"-";"-";"-";"-";"-";"-";"-";"-";"-";"-";"-";"-";"-";"-"
"11 Kw 2024 15:57:09";" Transakcja Kupna";"O2-CR-8Z5RT6";"T2-CR-5DQ34B";"-";"Solana (USD)";"56 Jednost.";"173,686";"-";"-";"-";"-";"3,989984";"38 808,24";"0,00";"-";"-";"-";"-";"-";"-";"-";"-";"-";"-";"-";"-";"-";"-";"-";"-";"-";"-";"-";"-";"-";"-";"-";"-";"-"
"11 Kw 2024 15:55:55";"Stop Loss";"O2-CR-8Z5RBJ";"T2-CR-5DQ30N";"-";"Solana (USD)";"56,5 Jednost.";"172,595";"-";"-";"-";"-";"3,95002";"38 906,15";"68,07";"19 394,40";"-";"-";"-";"-";"-";"-";"-";"-";"-";"-";"-";"-";"-";"-";"-";"-";"-";"-";"-";"-";"-";"-";"-";"-"
"11 Kw 2024 15:55:48";" Zmodyfikowano Transakcję Kupna";"O2-CR-8Z5RBJ";"T2-CR-5DQ2R1";"-";"Solana (USD)";"56,5 Jednost.";"172,290";"-";"172,600";"-";"-";"-";"-";"0,00";"-";"-";"-";"-";"-";"-";"-";"-";"-";"-";"-";"-";"-";"-";"-";"-";"-";"-";"-";"-";"-";"-";"-";"-";"-"
"11 Kw 2024 15:53:03";" Transakcja Kupna";"O2-CR-8Z5RBJ";"T2-CR-5DQ2R1";"-";"Solana (USD)";"56,5 Jednost.";"172,290";"-";"-";"-";"-";"3,988601";"38 826,57";"0,00";"-";"-";"-";"-";"-";"-";"-";"-";"-";"-";"-";"-";"-";"-";"-";"-";"-";"-";"-";"-";"-";"-";"-";"-";"-"
"11 Kw 2024 15:50:39";" Zamknięcie Transakcji";"O2-CR-8Z5QZD";"T2-CR-5DQ2HF";"O2-CR-8Z5QQM";"Solana (USD)";"56 Jednost.";"171,832";"-";"-";"-";"-";"3,9489";"38 380,58";"18,35";"19 326,33";"-";"-";"-";"-";"-";"-";"-";"-";"-";"-";"-";"-";"-";"-";"-";"-";"-";"-";"-";"-";"-";"-";"-";"-"
"11 Kw 2024 15:48:54";"Transakcja Sprzedaży";"O2-CR-8Z5QQM";"T2-CR-5DQ2BJ";"-";"Solana (USD)";"56 Jednost.";"171,915";"-";"-";"-";"-";"3,98832";"38 396,51";"0,00";"-";"-";"-";"-";"-";"-";"-";"-";"-";"-";"-";"-";"-";"-";"-";"-";"-";"-";"-";"-";"-";"-";"-";"-";"-"
"11 Kw 2024 15:47:01";" Zamknięcie Transakcji";"O2-CR-8Z5QFC";"T2-CR-5DQ24D";"O2-CR-8Z5Q20";"Solana (USD)";"56 Jednost.";"172,215";"-";"-";"-";"-";"3,94822";"38 459,36";"7,74";"19 307,98";"-";"-";"-";"-";"-";"-";"-";"-";"-";"-";"-";"-";"-";"-";"-";"-";"-";"-";"-";"-";"-";"-";"-";"-"
"11 Kw 2024 15:44:43";"Transakcja Sprzedaży";"O2-CR-8Z5Q20";"T2-CR-5DQ1VY";"-";"Solana (USD)";"56 Jednost.";"172,250";"-";"-";"-";"-";"3,987569";"38 464,09";"0,00";"-";"-";"-";"-";"-";"-";"-";"-";"-";"-";"-";"-";"-";"-";"-";"-";"-";"-";"-";"-";"-";"-";"-";"-";"-"
"11 Kw 2024 15:36:03";" Zamknięcie Transakcji";"O2-CR-8Z5MXB";"T2-CR-5DQ0JJ";"O2-CR-8Z5HEG";"Solana (USD)";"55 Jednost.";"174,605";"-";"-";"-";"-";"3,9457";"38 272,54";"545,79";"19 300,24";"-";"-";"-";"-";"-";"-";"-";"-";"-";"-";"-";"-";"-";"-";"-";"-";"-";"-";"-";"-";"-";"-";"-";"-"
"11 Kw 2024 15:34:42";"Zmodyfikowano Stop Loss";"O2-CR-8Z5HEG";"-";"O2-CR-8Z5LJT";"Solana (USD)";"55 Jednost.";"172,090";"-";"174,500";"-";"-";"-";"-";"-";"-";"-";"-";"-";"-";"-";"-";"-";"-";"-";"-";"-";"-";"-";"-";"-";"-";"-";"-";"-";"-";"-";"-";"-";"-"
"11 Kw 2024 15:34:16";"Zmodyfikowano Stop Loss";"O2-CR-8Z5HEG";"-";"O2-CR-8Z5LJT";"Solana (USD)";"55 Jednost.";"172,090";"-";"174,000";"-";"-";"-";"-";"-";"-";"-";"-";"-";"-";"-";"-";"-";"-";"-";"-";"-";"-";"-";"-";"-";"-";"-";"-";"-";"-";"-";"-";"-";"-"
"11 Kw 2024 15:34:16";" Zmodyfikowano Transakcję Kupna";"O2-CR-8Z5HEG";"T2-CR-5DPWYX";"-";"Solana (USD)";"55 Jednost.";"172,090";"-";"174,000";"-";"-";"-";"-";"0,00";"-";"-";"-";"-";"-";"-";"-";"-";"-";"-";"-";"-";"-";"-";"-";"-";"-";"-";"-";"-";"-";"-";"-";"-";"-"
"11 Kw 2024 15:31:07";" Zmodyfikowano Transakcję Kupna";"O2-CR-8Z5HEG";"T2-CR-5DPWYX";"-";"Solana (USD)";"55 Jednost.";"172,090";"-";"173,500";"175,800";"-";"-";"-";"0,00";"-";"-";"-";"-";"-";"-";"-";"-";"-";"-";"-";"-";"-";"-";"-";"-";"-";"-";"-";"-";"-";"-";"-";"-";"-"
"11 Kw 2024 15:20:06";" Zmodyfikowano Transakcję Kupna";"O2-CR-8Z5HEG";"T2-CR-5DPWYX";"-";"Solana (USD)";"55 Jednost.";"172,090";"-";"-";"175,800";"-";"-";"-";"0,00";"-";"-";"-";"-";"-";"-";"-";"-";"-";"-";"-";"-";"-";"-";"-";"-";"-";"-";"-";"-";"-";"-";"-";"-";"-"
"11 Kw 2024 15:03:42";" Transakcja Kupna";"O2-CR-8Z5HEG";"T2-CR-5DPWYX";"-";"Solana (USD)";"55 Jednost.";"172,090";"-";"-";"-";"-";"3,984042";"37 708,75";"0,00";"-";"-";"-";"-";"-";"-";"-";"-";"-";"-";"-";"-";"-";"-";"-";"-";"-";"-";"-";"-";"-";"-";"-";"-";"-"
"11 Kw 2024 14:55:43";" Zamknięcie Transakcji";"O2-CR-8Z5GKX";"T2-CR-5DPW87";"O2-CR-8Z58E5";"Solana (USD)";"56 Jednost.";"171,950";"-";"-";"-";"-";"3,982058";"38 344,03";"-323,12";"18 754,45";"-";"-";"-";"-";"-";"-";"-";"-";"-";"-";"-";"-";"-";"-";"-";"-";"-";"-";"-";"-";"-";"-";"-";"-"
"11 Kw 2024 13:55:34";"Transakcja Sprzedaży";"O2-CR-8Z58E5";"T2-CR-5DPNG6";"-";"Solana (USD)";"56 Jednost.";"170,501";"-";"-";"-";"-";"3,989122";"38 088,36";"0,00";"-";"-";"-";"-";"-";"-";"-";"-";"-";"-";"-";"-";"-";"-";"-";"-";"-";"-";"-";"-";"-";"-";"-";"-";"-"
"11 Kw 2024 13:54:55";" Zamknięcie Transakcji";"O2-CR-8Z58D3";"T2-CR-5DPNFC";"O2-CR-8Z58CM";"Solana (USD)";"56,4 Jednost.";"170,665";"-";"-";"-";"-";"3,989152";"38 397,60";"-82,12";"19 077,57";"-";"-";"-";"-";"-";"-";"-";"-";"-";"-";"-";"-";"-";"-";"-";"-";"-";"-";"-";"-";"-";"-";"-";"-"
"11 Kw 2024 13:54:36";" Transakcja Kupna";"O2-CR-8Z58CM";"T2-CR-5DPNF2";"-";"Solana (USD)";"56,4 Jednost.";"171,030";"-";"-";"-";"-";"3,989002";"38 478,28";"0,00";"-";"-";"-";"-";"-";"-";"-";"-";"-";"-";"-";"-";"-";"-";"-";"-";"-";"-";"-";"-";"-";"-";"-";"-";"-"
"11 Kw 2024 13:47:11";"Stop Loss";"O2-CR-8Z52BH";"T2-CR-5DPMZ0";"-";"Solana (USD)";"26,8 Jednost.";"172,230";"-";"-";"-";"-";"3,95029";"18 416,87";"103,75";"19 159,69";"-";"-";"-";"-";"-";"-";"-";"-";"-";"-";"-";"-";"-";"-";"-";"-";"-";"-";"-";"-";"-";"-";"-";"-"
"11 Kw 2024 13:47:11";"Stop Loss";"O2-CR-8Z51WC";"T2-CR-5DPMYZ";"-";"Solana (USD)";"28 Jednost.";"172,230";"-";"-";"-";"-";"3,95029";"19 241,50";"82,07";"19 055,94";"-";"-";"-";"-";"-";"-";"-";"-";"-";"-";"-";"-";"-";"-";"-";"-";"-";"-";"-";"-";"-";"-";"-";"-"
"11 Kw 2024 13:41:50";"Zmodyfikowano Stop Loss";"O2-CR-8Z52BH";"-";"O2-CR-8Z55TD";"Solana (USD)";"26,8 Jednost.";"173,210";"-";"172,200";"-";"-";"-";"-";"-";"-";"-";"-";"-";"-";"-";"-";"-";"-";"-";"-";"-";"-";"-";"-";"-";"-";"-";"-";"-";"-";"-";"-";"-";"-"
"11 Kw 2024 13:41:38";"Zmodyfikowano Stop Loss";"O2-CR-8Z51WC";"-";"O2-CR-8Z55SX";"Solana (USD)";"28 Jednost.";"172,972";"-";"172,200";"-";"-";"-";"-";"-";"-";"-";"-";"-";"-";"-";"-";"-";"-";"-";"-";"-";"-";"-";"-";"-";"-";"-";"-";"-";"-";"-";"-";"-";"-"
"11 Kw 2024 13:00:27";"Zmodyfikowano Transakcję Sprzedaży";"O2-CR-8Z52BH";"T2-CR-5DPHBQ";"-";"Solana (USD)";"26,8 Jednost.";"173,210";"-";"172,700";"-";"-";"-";"-";"0,00";"-";"-";"-";"-";"-";"-";"-";"-";"-";"-";"-";"-";"-";"-";"-";"-";"-";"-";"-";"-";"-";"-";"-";"-";"-"
"11 Kw 2024 13:00:07";"Zmodyfikowano Transakcję Sprzedaży";"O2-CR-8Z51WC";"T2-CR-5DPGXC";"-";"Solana (USD)";"28 Jednost.";"172,972";"-";"172,700";"-";"-";"-";"-";"0,00";"-";"-";"-";"-";"-";"-";"-";"-";"-";"-";"-";"-";"-";"-";"-";"-";"-";"-";"-";"-";"-";"-";"-";"-";"-"
"11 Kw 2024 11:49:38";"Transakcja Sprzedaży";"O2-CR-8Z52BH";"T2-CR-5DPHBQ";"-";"Solana (USD)";"26,8 Jednost.";"173,210";"-";"-";"-";"-";"3,991497";"18 528,64";"0,00";"-";"-";"-";"-";"-";"-";"-";"-";"-";"-";"-";"-";"-";"-";"-";"-";"-";"-";"-";"-";"-";"-";"-";"-";"-"
"11 Kw 2024 11:39:17";"Transakcja Sprzedaży";"O2-CR-8Z51WC";"T2-CR-5DPGXC";"-";"Solana (USD)";"28 Jednost.";"172,972";"-";"-";"-";"-";"3,992539";"19 336,72";"0,00";"-";"-";"-";"-";"-";"-";"-";"-";"-";"-";"-";"-";"-";"-";"-";"-";"-";"-";"-";"-";"-";"-";"-";"-";"-"
"11 Kw 2024 11:19:33";" Zamknięcie Transakcji";"O2-CR-8Z50P0";"T2-CR-5DPFX7";"O2-CR-8Z4DFT";"Solana (USD)";"54,5 Jednost.";"174,090";"-";"-";"-";"-";"3,95156";"37 868,75";"8,61";"18 973,87";"-";"-";"-";"-";"-";"-";"-";"-";"-";"-";"-";"-";"-";"-";"-";"-";"-";"-";"-";"-";"-";"-";"-";"-"
"11 Kw 2024 00:21:28";"Zmodyfikowano Transakcję Sprzedaży";"O2-CR-8Z4DFT";"T2-CR-5DNZMQ";"-";"Solana (USD)";"54,5 Jednost.";"174,130";"-";"-";"168,000";"-";"-";"-";"0,00";"-";"-";"-";"-";"-";"-";"-";"-";"-";"-";"-";"-";"-";"-";"-";"-";"-";"-";"-";"-";"-";"-";"-";"-";"-"
"11 Kw 2024 00:20:29";"Transakcja Sprzedaży";"O2-CR-8Z4DFT";"T2-CR-5DNZMQ";"-";"Solana (USD)";"54,5 Jednost.";"174,130";"-";"-";"-";"-";"3,991427";"37 878,98";"0,00";"-";"-";"-";"-";"-";"-";"-";"-";"-";"-";"-";"-";"-";"-";"-";"-";"-";"-";"-";"-";"-";"-";"-";"-";"-"
"11 Kw 2024 00:16:58";"Odrzucono Zlecenie: brak wystarczających środków";"O2-CR-8Z4DDQ";"-";"-";"Solana (USD)";"55 Jednost.";"-";"-";"-";"-";"-";"-";"-";"-";"-";"-";"-";"-";"-";"-";"-";"-";"-";"-";"-";"-";"-";"-";"-";"-";"-";"-";"-";"-";"-";"-";"-";"-";"-"
"11 Kw 2024 00:15:31";"Stop Loss";"O2-CR-8Z155Y";"T2-CR-5DNZK8";"-";"Solana (USD)";"28 Jednost.";"173,700";"-";"-";"-";"-";"3,991657";"19 413,82";"-134,79";"18 965,26";"-";"-";"-";"-";"-";"-";"-";"-";"-";"-";"-";"-";"-";"-";"-";"-";"-";"-";"-";"-";"-";"-";"-";"-"
"11 Kw 2024 00:15:05";" Zmodyfikowano Transakcję Kupna";"O2-CR-8Z155Y";"T2-CR-5DL7CQ";"-";"Solana (USD)";"28 Jednost.";"174,906";"-";"173,700";"175,700";"-";"-";"-";"0,00";"-";"-";"-";"-";"-";"-";"-";"-";"-";"-";"-";"-";"-";"-";"-";"-";"-";"-";"-";"-";"-";"-";"-";"-";"-"
"11 Kw 2024 00:14:04";"Stop Loss";"O2-CR-8Z149Q";"T2-CR-5DNZJ6";"-";"Solana (USD)";"28 Jednost.";"173,685";"-";"-";"-";"-";"3,991687";"19 412,29";"-220,18";"19 100,05";"-";"-";"-";"-";"-";"-";"-";"-";"-";"-";"-";"-";"-";"-";"-";"-";"-";"-";"-";"-";"-";"-";"-";"-"
"11 Kw 2024 00:14:00";" Zmodyfikowano Transakcję Kupna";"O2-CR-8Z149Q";"T2-CR-5DL6KZ";"-";"Solana (USD)";"28 Jednost.";"175,655";"-";"173,700";"175,700";"-";"-";"-";"0,00";"-";"-";"-";"-";"-";"-";"-";"-";"-";"-";"-";"-";"-";"-";"-";"-";"-";"-";"-";"-";"-";"-";"-";"-";"-"
"10 Kw 2024 23:01:11";"Koszty Utrzymania Pozycji";"1325362371";"-";"-";"Rachunek";"-";"-";"-";"-";"-";"-";"-";"-";"-28,80";"19 320,23";"-";"-";"-";"-";"-";"-28,80";"-";"-";"-";"-";"-";"-";"-";"-";"-";"-";"-";"-";"-";"-";"-";"-";"-";"-"
"10 Kw 2024 23:01:11";"Koszty Utrzymania Pozycji";"O2-CR-8Z155Y";"-";"-";"Solana (USD)";"-";"-";"-";"-";"-";"-";"-";"-";"-";"-";"-";"-";"4 788,84";"-27,50000%";"-14,40";"-14,40";"-";"-";"-";"-";"-";"-";"-";"-";"-";"-";"-";"-";"-";"-";"-";"-";"-";"-"
"10 Kw 2024 23:01:11";"Koszty Utrzymania Pozycji";"O2-CR-8Z149Q";"-";"-";"Solana (USD)";"-";"-";"-";"-";"-";"-";"-";"-";"-";"-";"-";"-";"4 788,84";"-27,50000%";"-14,40";"-14,40";"-";"-";"-";"-";"-";"-";"-";"-";"-";"-";"-";"-";"-";"-";"-";"-";"-";"-"
"10 Kw 2024 22:27:24";"Zmodyfikowano Take Profit";"O2-CR-8Z155Y";"-";"O2-CR-8Z1F31";"Solana (USD)";"28 Jednost.";"174,906";"-";"-";"175,700";"-";"-";"-";"-";"-";"-";"-";"-";"-";"-";"-";"-";"-";"-";"-";"-";"-";"-";"-";"-";"-";"-";"-";"-";"-";"-";"-";"-";"-"
"10 Kw 2024 22:27:01";"Zmodyfikowano Take Profit";"O2-CR-8Z149Q";"-";"O2-CR-8Z1F2Q";"Solana (USD)";"28 Jednost.";"175,655";"-";"-";"175,700";"-";"-";"-";"-";"-";"-";"-";"-";"-";"-";"-";"-";"-";"-";"-";"-";"-";"-";"-";"-";"-";"-";"-";"-";"-";"-";"-";"-";"-"
"09 Kw 2024 23:48:47";"Zmodyfikowano Take Profit";"O2-CR-8Z155Y";"-";"O2-CR-8Z1F31";"Solana (USD)";"28 Jednost.";"174,906";"-";"-";"180,500";"-";"-";"-";"-";"-";"-";"-";"-";"-";"-";"-";"-";"-";"-";"-";"-";"-";"-";"-";"-";"-";"-";"-";"-";"-";"-";"-";"-";"-"
"09 Kw 2024 23:48:22";"Zmodyfikowano Take Profit";"O2-CR-8Z149Q";"-";"O2-CR-8Z1F2Q";"Solana (USD)";"28 Jednost.";"175,655";"-";"-";"180,500";"-";"-";"-";"-";"-";"-";"-";"-";"-";"-";"-";"-";"-";"-";"-";"-";"-";"-";"-";"-";"-";"-";"-";"-";"-";"-";"-";"-";"-"
"09 Kw 2024 23:01:11";"Koszty Utrzymania Pozycji";"1324865953";"-";"-";"Rachunek";"-";"-";"-";"-";"-";"-";"-";"-";"-29,14";"19 349,03";"-";"-";"-";"-";"-";"-29,14";"-";"-";"-";"-";"-";"-";"-";"-";"-";"-";"-";"-";"-";"-";"-";"-";"-";"-"
"09 Kw 2024 23:01:11";"Koszty Utrzymania Pozycji";"O2-CR-8Z155Y";"-";"-";"Solana (USD)";"-";"-";"-";"-";"-";"-";"-";"-";"-";"-";"-";"-";"4 900,08";"-27,50000%";"-14,57";"-14,57";"-";"-";"-";"-";"-";"-";"-";"-";"-";"-";"-";"-";"-";"-";"-";"-";"-";"-"
"09 Kw 2024 23:01:11";"Koszty Utrzymania Pozycji";"O2-CR-8Z149Q";"-";"-";"Solana (USD)";"-";"-";"-";"-";"-";"-";"-";"-";"-";"-";"-";"-";"4 900,08";"-27,50000%";"-14,57";"-14,57";"-";"-";"-";"-";"-";"-";"-";"-";"-";"-";"-";"-";"-";"-";"-";"-";"-";"-"
"09 Kw 2024 22:44:25";" Zmodyfikowano Transakcję Kupna";"O2-CR-8Z155Y";"T2-CR-5DL7CQ";"-";"Solana (USD)";"28 Jednost.";"174,906";"-";"-";"177,500";"-";"-";"-";"0,00";"-";"-";"-";"-";"-";"-";"-";"-";"-";"-";"-";"-";"-";"-";"-";"-";"-";"-";"-";"-";"-";"-";"-";"-";"-"
"09 Kw 2024 22:43:37";" Zmodyfikowano Transakcję Kupna";"O2-CR-8Z149Q";"T2-CR-5DL6KZ";"-";"Solana (USD)";"28 Jednost.";"175,655";"-";"-";"177,500";"-";"-";"-";"0,00";"-";"-";"-";"-";"-";"-";"-";"-";"-";"-";"-";"-";"-";"-";"-";"-";"-";"-";"-";"-";"-";"-";"-";"-";"-"
"09 Kw 2024 20:17:03";" Transakcja Kupna";"O2-CR-8Z155Y";"T2-CR-5DL7CQ";"-";"Solana (USD)";"28 Jednost.";"174,906";"-";"-";"-";"-";"3,951256";"19 350,75";"0,00";"-";"-";"-";"-";"-";"-";"-";"-";"-";"-";"-";"-";"-";"-";"-";"-";"-";"-";"-";"-";"-";"-";"-";"-";"-"
"09 Kw 2024 20:00:12";" Transakcja Kupna";"O2-CR-8Z149Q";"T2-CR-5DL6KZ";"-";"Solana (USD)";"28 Jednost.";"175,655";"-";"-";"-";"-";"3,951557";"19 435,10";"0,00";"-";"-";"-";"-";"-";"-";"-";"-";"-";"-";"-";"-";"-";"-";"-";"-";"-";"-";"-";"-";"-";"-";"-";"-";"-"
"09 Kw 2024 19:57:18";" Zamknięcie Transakcji";"O2-CR-8Z146D";"T2-CR-5DL6H5";"O2-CR-8Z13R5";"Solana (USD)";"20 Jednost.";"175,643";"-";"-";"-";"-";"3,952078";"13 883,09";"-37,39";"19 378,17";"-";"-";"-";"-";"-";"-";"-";"-";"-";"-";"-";"-";"-";"-";"-";"-";"-";"-";"-";"-";"-";"-";"-";"-"
"09 Kw 2024 19:47:03";"Transakcja Sprzedaży";"O2-CR-8Z13R5";"T2-CR-5DL65D";"-";"Solana (USD)";"20 Jednost.";"175,170";"-";"-";"-";"-";"3,951286";"13 842,93";"0,00";"-";"-";"-";"-";"-";"-";"-";"-";"-";"-";"-";"-";"-";"-";"-";"-";"-";"-";"-";"-";"-";"-";"-";"-";"-"
"09 Kw 2024 19:42:56";" Zamknięcie Transakcji";"O2-CR-8Z13J9";"T2-CR-5DL618";"O2-CR-8Z1356";"Solana (USD)";"40 Jednost.";"176,294";"-";"-";"-";"-";"3,91213";"27 864,65";"3,29";"19 415,56";"-";"-";"-";"-";"-";"-";"-";"-";"-";"-";"-";"-";"-";"-";"-";"-";"-";"-";"-";"-";"-";"-";"-";"-"
"09 Kw 2024 19:35:56";"Transakcja Sprzedaży";"O2-CR-8Z1356";"T2-CR-5DL5RH";"-";"Solana (USD)";"40 Jednost.";"176,315";"-";"-";"-";"-";"3,951988";"27 871,79";"0,00";"-";"-";"-";"-";"-";"-";"-";"-";"-";"-";"-";"-";"-";"-";"-";"-";"-";"-";"-";"-";"-";"-";"-";"-";"-"
"09 Kw 2024 19:01:05";"Take Profit";"O2-CR-8Z0ZM8";"T2-CR-5DL43G";"-";"Solana (USD)";"56,8 Jednost.";"174,060";"-";"-";"-";"-";"3,90967";"39 041,93";"4,44";"19 412,27";"-";"-";"-";"-";"-";"-";"-";"-";"-";"-";"-";"-";"-";"-";"-";"-";"-";"-";"-";"-";"-";"-";"-";"-"
"09 Kw 2024 18:56:23";"Zmodyfikowano Take Profit";"O2-CR-8Z0ZM8";"-";"O2-CR-8Z0ZX7";"Solana (USD)";"56,8 Jednost.";"174,040";"-";"-";"174,060";"-";"-";"-";"-";"-";"-";"-";"-";"-";"-";"-";"-";"-";"-";"-";"-";"-";"-";"-";"-";"-";"-";"-";"-";"-";"-";"-";"-";"-"
"09 Kw 2024 18:40:21";" Zmodyfikowano Transakcję Kupna";"O2-CR-8Z0ZM8";"T2-CR-5DL2W6";"-";"Solana (USD)";"56,8 Jednost.";"174,040";"-";"-";"174,340";"-";"-";"-";"0,00";"-";"-";"-";"-";"-";"-";"-";"-";"-";"-";"-";"-";"-";"-";"-";"-";"-";"-";"-";"-";"-";"-";"-";"-";"-"
"09 Kw 2024 18:34:38";" Transakcja Kupna";"O2-CR-8Z0ZM8";"T2-CR-5DL2W6";"-";"Solana (USD)";"56,8 Jednost.";"174,040";"-";"-";"-";"-";"3,947208";"39 020,01";"0,00";"-";"-";"-";"-";"-";"-";"-";"-";"-";"-";"-";"-";"-";"-";"-";"-";"-";"-";"-";"-";"-";"-";"-";"-";"-"
"09 Kw 2024 18:34:20";"Odrzucono Zlecenie: brak wystarczających środków";"O2-CR-8Z0ZLD";"-";"-";"Solana (USD)";"56,8 Jednost.";"-";"-";"-";"-";"-";"-";"-";"-";"-";"-";"-";"-";"-";"-";"-";"-";"-";"-";"-";"-";"-";"-";"-";"-";"-";"-";"-";"-";"-";"-";"-";"-";"-"
"09 Kw 2024 18:23:06";" Zamknięcie Transakcji";"O2-CR-8Z0YR2";"T2-CR-5DL23G";"O2-CR-8Z0Y6T";"Solana (USD)";"57 Jednost.";"173,304";"-";"-";"-";"-";"3,90764";"38 988,85";"3,79";"19 407,83";"-";"-";"-";"-";"-";"-";"-";"-";"-";"-";"-";"-";"-";"-";"-";"-";"-";"-";"-";"-";"-";"-";"-";"-"
"09 Kw 2024 18:15:56";" Transakcja Kupna";"O2-CR-8Z0Y6T";"T2-CR-5DL1ML";"-";"Solana (USD)";"57 Jednost.";"173,287";"-";"-";"-";"-";"3,946617";"38 982,15";"0,00";"-";"-";"-";"-";"-";"-";"-";"-";"-";"-";"-";"-";"-";"-";"-";"-";"-";"-";"-";"-";"-";"-";"-";"-";"-"
"09 Kw 2024 18:11:45";" Zamknięcie Transakcji";"O2-CR-8Z0XTC";"T2-CR-5DL18H";"O2-CR-8Z0WDR";"Solana (USD)";"57 Jednost.";"172,751";"-";"-";"-";"-";"3,90765";"38 864,53";"97,78";"19 404,04";"-";"-";"-";"-";"-";"-";"-";"-";"-";"-";"-";"-";"-";"-";"-";"-";"-";"-";"-";"-";"-";"-";"-";"-"
"09 Kw 2024 17:55:00";" Transakcja Kupna";"O2-CR-8Z0WDR";"T2-CR-5DKZZX";"-";"Solana (USD)";"57 Jednost.";"172,312";"-";"-";"-";"-";"3,947018";"38 766,75";"0,00";"-";"-";"-";"-";"-";"-";"-";"-";"-";"-";"-";"-";"-";"-";"-";"-";"-";"-";"-";"-";"-";"-";"-";"-";"-"
"09 Kw 2024 17:48:57";" Zamknięcie Transakcji";"O2-CR-8Z0VXS";"T2-CR-5DKZKE";"O2-CR-8Z0VCZ";"Solana (USD)";"57,2 Jednost.";"171,560";"-";"-";"-";"-";"3,9077";"38 732,51";"10,06";"19 306,26";"-";"-";"-";"-";"-";"-";"-";"-";"-";"-";"-";"-";"-";"-";"-";"-";"-";"-";"-";"-";"-";"-";"-";"-"
"09 Kw 2024 17:43:18";" Transakcja Kupna";"O2-CR-8Z0VCZ";"T2-CR-5DKZ1P";"-";"Solana (USD)";"57,2 Jednost.";"171,515";"-";"-";"-";"-";"3,947258";"38 725,19";"0,00";"-";"-";"-";"-";"-";"-";"-";"-";"-";"-";"-";"-";"-";"-";"-";"-";"-";"-";"-";"-";"-";"-";"-";"-";"-"
"09 Kw 2024 17:36:32";"Take Profit";"O2-CR-8Z0RQW";"T2-CR-5DKYMG";"-";"Solana (USD)";"57,2 Jednost.";"170,900";"-";"-";"-";"-";"3,90903";"38 596,72";"110,68";"19 296,20";"-";"-";"-";"-";"-";"-";"-";"-";"-";"-";"-";"-";"-";"-";"-";"-";"-";"-";"-";"-";"-";"-";"-";"-"
"09 Kw 2024 17:35:19";" Zmodyfikowano Transakcję Kupna";"O2-CR-8Z0RQW";"T2-CR-5DKWYG";"-";"Solana (USD)";"57,2 Jednost.";"170,405";"-";"-";"170,900";"-";"-";"-";"0,00";"-";"-";"-";"-";"-";"-";"-";"-";"-";"-";"-";"-";"-";"-";"-";"-";"-";"-";"-";"-";"-";"-";"-";"-";"-"
"09 Kw 2024 17:16:57";" Transakcja Kupna";"O2-CR-8Z0RQW";"T2-CR-5DKWYG";"-";"Solana (USD)";"57,2 Jednost.";"170,405";"-";"-";"-";"-";"3,947258";"38 474,57";"0,00";"-";"-";"-";"-";"-";"-";"-";"-";"-";"-";"-";"-";"-";"-";"-";"-";"-";"-";"-";"-";"-";"-";"-";"-";"-"
"09 Kw 2024 15:47:21";" Zamknięcie Transakcji";"O2-CR-8Z09Z1";"T2-CR-5DKH1T";"O2-CR-8YZKLQ";"Solana (USD)";"10 Jednost.";"175,025";"-";"-";"-";"-";"3,89653";"6 888,45";"2,34";"19 185,52";"-";"-";"-";"-";"-";"-";"-";"-";"-";"-";"-";"-";"-";"-";"-";"-";"-";"-";"-";"-";"-";"-";"-";"-"
"09 Kw 2024 15:47:21";" Zamknięcie Transakcji";"O2-CR-8Z09Z1";"T2-CR-5DKH1S";"O2-CR-8YZK7X";"Solana (USD)";"15 Jednost.";"175,025";"-";"-";"-";"-";"3,935695";"10 332,67";"-15,94";"19 183,18";"-";"-";"-";"-";"-";"-";"-";"-";"-";"-";"-";"-";"-";"-";"-";"-";"-";"-";"-";"-";"-";"-";"-";"-"
"09 Kw 2024 15:47:21";" Zamknięcie Transakcji";"O2-CR-8Z09Z1";"T2-CR-5DKH1R";"O2-CR-8YZK3F";"Solana (USD)";"30 Jednost.";"175,025";"-";"-";"-";"-";"3,935695";"20 665,35";"-59,63";"19 199,12";"-";"-";"-";"-";"-";"-";"-";"-";"-";"-";"-";"-";"-";"-";"-";"-";"-";"-";"-";"-";"-";"-";"-";"-"
"09 Kw 2024 10:27:02";"Transakcja Sprzedaży";"O2-CR-8YZKLQ";"T2-CR-5DJXC4";"-";"Solana (USD)";"10 Jednost.";"175,085";"-";"-";"-";"-";"3,941537";"6 901,04";"0,00";"-";"-";"-";"-";"-";"-";"-";"-";"-";"-";"-";"-";"-";"-";"-";"-";"-";"-";"-";"-";"-";"-";"-";"-";"-"
"09 Kw 2024 10:21:08";"Transakcja Sprzedaży";"O2-CR-8YZK7X";"T2-CR-5DJX5J";"-";"Solana (USD)";"15 Jednost.";"174,755";"-";"-";"-";"-";"3,940625";"10 329,65";"0,00";"-";"-";"-";"-";"-";"-";"-";"-";"-";"-";"-";"-";"-";"-";"-";"-";"-";"-";"-";"-";"-";"-";"-";"-";"-"
"09 Kw 2024 10:18:23";"Transakcja Sprzedaży";"O2-CR-8YZK3F";"T2-CR-5DJX2X";"-";"Solana (USD)";"30 Jednost.";"174,520";"-";"-";"-";"-";"3,93791";"20 617,32";"0,00";"-";"-";"-";"-";"-";"-";"-";"-";"-";"-";"-";"-";"-";"-";"-";"-";"-";"-";"-";"-";"-";"-";"-";"-";"-"
"09 Kw 2024 10:09:02";"Stop Loss";"O2-CR-8YZJ8G";"T2-CR-5DJWS4";"-";"Solana (USD)";"35 Jednost.";"174,409";"-";"-";"-";"-";"3,90435";"24 072,86";"91,01";"19 258,75";"-";"-";"-";"-";"-";"-";"-";"-";"-";"-";"-";"-";"-";"-";"-";"-";"-";"-";"-";"-";"-";"-";"-";"-"
"09 Kw 2024 10:08:06";"Zmodyfikowano Stop Loss";"O2-CR-8YZJ8G";"-";"O2-CR-8YZJJ6";"Solana (USD)";"35 Jednost.";"175,075";"-";"174,400";"-";"-";"-";"-";"-";"-";"-";"-";"-";"-";"-";"-";"-";"-";"-";"-";"-";"-";"-";"-";"-";"-";"-";"-";"-";"-";"-";"-";"-";"-"
"09 Kw 2024 10:07:38";"Zmodyfikowano Transakcję Sprzedaży";"O2-CR-8YZJ8G";"T2-CR-5DJWJC";"-";"Solana (USD)";"35 Jednost.";"175,075";"-";"174,900";"-";"-";"-";"-";"0,00";"-";"-";"-";"-";"-";"-";"-";"-";"-";"-";"-";"-";"-";"-";"-";"-";"-";"-";"-";"-";"-";"-";"-";"-";"-"
"09 Kw 2024 10:04:39";"Transakcja Sprzedaży";"O2-CR-8YZJ8G";"T2-CR-5DJWJC";"-";"Solana (USD)";"35 Jednost.";"175,075";"-";"-";"-";"-";"3,945705";"24 177,80";"0,00";"-";"-";"-";"-";"-";"-";"-";"-";"-";"-";"-";"-";"-";"-";"-";"-";"-";"-";"-";"-";"-";"-";"-";"-";"-"
"09 Kw 2024 10:02:25";"Stop Loss";"O2-CR-8YZH82";"T2-CR-5DJWE0";"-";"Solana (USD)";"10 Jednost.";"175,545";"-";"-";"-";"-";"3,90654";"6 926,66";"18,95";"19 167,74";"-";"-";"-";"-";"-";"-";"-";"-";"-";"-";"-";"-";"-";"-";"-";"-";"-";"-";"-";"-";"-";"-";"-";"-"
"09 Kw 2024 10:02:25";"Stop Loss";"O2-CR-8YZGZS";"T2-CR-5DJWDZ";"-";"Solana (USD)";"27 Jednost.";"175,545";"-";"-";"-";"-";"3,90654";"18 701,99";"22,57";"19 148,79";"-";"-";"-";"-";"-";"-";"-";"-";"-";"-";"-";"-";"-";"-";"-";"-";"-";"-";"-";"-";"-";"-";"-";"-"
"09 Kw 2024 10:01:49";"Zmodyfikowano Transakcję Sprzedaży";"O2-CR-8YZH82";"T2-CR-5DJVTJ";"-";"Solana (USD)";"10 Jednost.";"176,030";"-";"175,500";"-";"-";"-";"-";"0,00";"-";"-";"-";"-";"-";"-";"-";"-";"-";"-";"-";"-";"-";"-";"-";"-";"-";"-";"-";"-";"-";"-";"-";"-";"-"
"09 Kw 2024 10:01:09";"Zmodyfikowano Transakcję Sprzedaży";"O2-CR-8YZGZS";"T2-CR-5DJVLV";"-";"Solana (USD)";"27 Jednost.";"175,759";"-";"175,500";"-";"-";"-";"-";"0,00";"-";"-";"-";"-";"-";"-";"-";"-";"-";"-";"-";"-";"-";"-";"-";"-";"-";"-";"-";"-";"-";"-";"-";"-";"-"
"09 Kw 2024 09:53:36";"Transakcja Sprzedaży";"O2-CR-8YZH82";"T2-CR-5DJVTJ";"-";"Solana (USD)";"10 Jednost.";"176,030";"-";"-";"-";"-";"3,945615";"6 945,46";"0,00";"-";"-";"-";"-";"-";"-";"-";"-";"-";"-";"-";"-";"-";"-";"-";"-";"-";"-";"-";"-";"-";"-";"-";"-";"-"
"09 Kw 2024 09:49:47";"Transakcja Sprzedaży";"O2-CR-8YZGZS";"T2-CR-5DJVLV";"-";"Solana (USD)";"27 Jednost.";"175,759";"-";"-";"-";"-";"3,944142";"18 716,89";"0,00";"-";"-";"-";"-";"-";"-";"-";"-";"-";"-";"-";"-";"-";"-";"-";"-";"-";"-";"-";"-";"-";"-";"-";"-";"-"
"09 Kw 2024 09:46:47";"Stop Loss";"O2-CR-8YZGMF";"T2-CR-5DJVHD";"-";"Solana (USD)";"25 Jednost.";"175,579";"-";"-";"-";"-";"3,90425";"17 309,81";"9,37";"19 126,22";"-";"-";"-";"-";"-";"-";"-";"-";"-";"-";"-";"-";"-";"-";"-";"-";"-";"-";"-";"-";"-";"-";"-";"-"
"09 Kw 2024 09:46:23";"Zmodyfikowano Transakcję Sprzedaży";"O2-CR-8YZGMF";"T2-CR-5DJVCZ";"-";"Solana (USD)";"25 Jednost.";"175,675";"-";"175,500";"-";"-";"-";"-";"0,00";"-";"-";"-";"-";"-";"-";"-";"-";"-";"-";"-";"-";"-";"-";"-";"-";"-";"-";"-";"-";"-";"-";"-";"-";"-"
"09 Kw 2024 09:44:19";"Transakcja Sprzedaży";"O2-CR-8YZGMF";"T2-CR-5DJVCZ";"-";"Solana (USD)";"25 Jednost.";"175,675";"-";"-";"-";"-";"3,94331";"17 318,52";"0,00";"-";"-";"-";"-";"-";"-";"-";"-";"-";"-";"-";"-";"-";"-";"-";"-";"-";"-";"-";"-";"-";"-";"-";"-";"-"
"08 Kw 2024 23:55:16";"Stop Loss";"O2-CR-8YYWKF";"T2-CR-5DJHER";"-";"Solana (USD)";"25 Jednost.";"180,995";"-";"-";"-";"-";"3,90446";"17 844,70";"166,43";"19 150,86";"-";"-";"-";"-";"-";"-";"-";"-";"-";"-";"-";"-";"-";"-";"-";"-";"-";"-";"-";"-";"-";"-";"-";"-"
"08 Kw 2024 23:55:16";"Stop Loss";"O2-CR-8YYNR6";"T2-CR-5DJHES";"-";"Solana (USD)";"25 Jednost.";"180,995";"-";"-";"-";"-";"3,943691";"17 844,70";"-34,01";"19 116,85";"-";"-";"-";"-";"-";"-";"-";"-";"-";"-";"-";"-";"-";"-";"-";"-";"-";"-";"-";"-";"-";"-";"-";"-"
"08 Kw 2024 23:54:14";"Zmodyfikowano Stop Loss";"O2-CR-8YYWKF";"-";"O2-CR-8YYZJY";"Solana (USD)";"25 Jednost.";"179,290";"-";"181,000";"-";"-";"-";"-";"-";"-";"-";"-";"-";"-";"-";"-";"-";"-";"-";"-";"-";"-";"-";"-";"-";"-";"-";"-";"-";"-";"-";"-";"-";"-"
"08 Kw 2024 23:53:52";"Zmodyfikowano Stop Loss";"O2-CR-8YYNR6";"-";"O2-CR-8YYZK1";"Solana (USD)";"25 Jednost.";"181,340";"-";"181,000";"-";"-";"-";"-";"-";"-";"-";"-";"-";"-";"-";"-";"-";"-";"-";"-";"-";"-";"-";"-";"-";"-";"-";"-";"-";"-";"-";"-";"-";"-"
"08 Kw 2024 23:42:49";"Zmodyfikowano Stop Loss";"O2-CR-8YYWKF";"-";"O2-CR-8YYZJY";"Solana (USD)";"25 Jednost.";"179,290";"-";"180,700";"-";"-";"-";"-";"-";"-";"-";"-";"-";"-";"-";"-";"-";"-";"-";"-";"-";"-";"-";"-";"-";"-";"-";"-";"-";"-";"-";"-";"-";"-"
"08 Kw 2024 23:42:37";"Zmodyfikowano Stop Loss";"O2-CR-8YYNR6";"-";"O2-CR-8YYZK1";"Solana (USD)";"25 Jednost.";"181,340";"-";"180,700";"-";"-";"-";"-";"-";"-";"-";"-";"-";"-";"-";"-";"-";"-";"-";"-";"-";"-";"-";"-";"-";"-";"-";"-";"-";"-";"-";"-";"-";"-"
"08 Kw 2024 23:41:56";"Zmodyfikowano Stop Loss";"O2-CR-8YYWKF";"-";"O2-CR-8YYZJY";"Solana (USD)";"25 Jednost.";"179,290";"-";"180,600";"-";"-";"-";"-";"-";"-";"-";"-";"-";"-";"-";"-";"-";"-";"-";"-";"-";"-";"-";"-";"-";"-";"-";"-";"-";"-";"-";"-";"-";"-"
"08 Kw 2024 23:41:43";"Zmodyfikowano Stop Loss";"O2-CR-8YYNR6";"-";"O2-CR-8YYZK1";"Solana (USD)";"25 Jednost.";"181,340";"-";"180,600";"-";"-";"-";"-";"-";"-";"-";"-";"-";"-";"-";"-";"-";"-";"-";"-";"-";"-";"-";"-";"-";"-";"-";"-";"-";"-";"-";"-";"-";"-"
"08 Kw 2024 23:40:41";"Zmodyfikowano Stop Loss";"O2-CR-8YYWKF";"-";"O2-CR-8YYZJY";"Solana (USD)";"25 Jednost.";"179,290";"-";"180,500";"-";"-";"-";"-";"-";"-";"-";"-";"-";"-";"-";"-";"-";"-";"-";"-";"-";"-";"-";"-";"-";"-";"-";"-";"-";"-";"-";"-";"-";"-"
"08 Kw 2024 23:40:27";"Zmodyfikowano Stop Loss";"O2-CR-8YYNR6";"-";"O2-CR-8YYZK1";"Solana (USD)";"25 Jednost.";"181,340";"-";"180,500";"-";"-";"-";"-";"-";"-";"-";"-";"-";"-";"-";"-";"-";"-";"-";"-";"-";"-";"-";"-";"-";"-";"-";"-";"-";"-";"-";"-";"-";"-"
"08 Kw 2024 23:39:12";" Zmodyfikowano Transakcję Kupna";"O2-CR-8YYNR6";"T2-CR-5DJ83X";"-";"Solana (USD)";"25 Jednost.";"181,340";"-";"180,400";"183,000";"-";"-";"-";"0,00";"-";"-";"-";"-";"-";"-";"-";"-";"-";"-";"-";"-";"-";"-";"-";"-";"-";"-";"-";"-";"-";"-";"-";"-";"-"
"08 Kw 2024 23:38:52";" Zmodyfikowano Transakcję Kupna";"O2-CR-8YYWKF";"T2-CR-5DJEN8";"-";"Solana (USD)";"25 Jednost.";"179,290";"-";"180,400";"183,000";"-";"-";"-";"0,00";"-";"-";"-";"-";"-";"-";"-";"-";"-";"-";"-";"-";"-";"-";"-";"-";"-";"-";"-";"-";"-";"-";"-";"-";"-"
"08 Kw 2024 23:00:59";"Koszty Utrzymania Pozycji";"1324364369";"-";"-";"Rachunek";"-";"-";"-";"-";"-";"-";"-";"-";"-26,72";"18 984,43";"-";"-";"-";"-";"-";"-26,72";"-";"-";"-";"-";"-";"-";"-";"-";"-";"-";"-";"-";"-";"-";"-";"-";"-";"-"
"08 Kw 2024 23:00:59";"Koszty Utrzymania Pozycji";"O2-CR-8YYWKF";"-";"-";"Solana (USD)";"-";"-";"-";"-";"-";"-";"-";"-";"-";"-";"-";"-";"4 497,97";"-27,50000%";"-13,36";"-13,36";"-";"-";"-";"-";"-";"-";"-";"-";"-";"-";"-";"-";"-";"-";"-";"-";"-";"-"
"08 Kw 2024 23:00:59";"Koszty Utrzymania Pozycji";"O2-CR-8YYNR6";"-";"-";"Solana (USD)";"-";"-";"-";"-";"-";"-";"-";"-";"-";"-";"-";"-";"4 497,97";"-27,50000%";"-13,36";"-13,36";"-";"-";"-";"-";"-";"-";"-";"-";"-";"-";"-";"-";"-";"-";"-";"-";"-";"-"
"08 Kw 2024 21:50:30";" Zmodyfikowano Transakcję Kupna";"O2-CR-8YYWKF";"T2-CR-5DJEN8";"-";"Solana (USD)";"25 Jednost.";"179,290";"-";"-";"183,000";"-";"-";"-";"0,00";"-";"-";"-";"-";"-";"-";"-";"-";"-";"-";"-";"-";"-";"-";"-";"-";"-";"-";"-";"-";"-";"-";"-";"-";"-"
"08 Kw 2024 21:50:14";" Zmodyfikowano Transakcję Kupna";"O2-CR-8YYNR6";"T2-CR-5DJ83X";"-";"Solana (USD)";"25 Jednost.";"181,340";"-";"-";"183,000";"-";"-";"-";"0,00";"-";"-";"-";"-";"-";"-";"-";"-";"-";"-";"-";"-";"-";"-";"-";"-";"-";"-";"-";"-";"-";"-";"-";"-";"-"
"08 Kw 2024 21:24:39";" Transakcja Kupna";"O2-CR-8YYWKF";"T2-CR-5DJEN8";"-";"Solana (USD)";"25 Jednost.";"179,290";"-";"-";"-";"-";"3,947569";"17 693,99";"0,00";"-";"-";"-";"-";"-";"-";"-";"-";"-";"-";"-";"-";"-";"-";"-";"-";"-";"-";"-";"-";"-";"-";"-";"-";"-"
"08 Kw 2024 21:23:24";" Zamknięcie Transakcji";"O2-CR-8YYWJC";"T2-CR-5DJEMG";"O2-CR-8YYCQ0";"Solana (USD)";"25 Jednost.";"179,290";"-";"-";"-";"-";"3,90854";"17 695,06";"42,51";"19 011,15";"-";"-";"-";"-";"-";"-";"-";"-";"-";"-";"-";"-";"-";"-";"-";"-";"-";"-";"-";"-";"-";"-";"-";"-"
"08 Kw 2024 18:44:56";" Transakcja Kupna";"O2-CR-8YYNR6";"T2-CR-5DJ83X";"-";"Solana (USD)";"25 Jednost.";"181,340";"-";"-";"-";"-";"3,955084";"17 930,37";"0,00";"-";"-";"-";"-";"-";"-";"-";"-";"-";"-";"-";"-";"-";"-";"-";"-";"-";"-";"-";"-";"-";"-";"-";"-";"-"
"08 Kw 2024 18:38:47";" Zamknięcie Transakcji";"O2-CR-8YYNFV";"T2-CR-5DJ7W1";"O2-CR-8YYJBW";"Solana (USD)";"20 Jednost.";"181,352";"-";"-";"-";"-";"3,91561";"14 344,84";"12,84";"18 968,64";"-";"-";"-";"-";"-";"-";"-";"-";"-";"-";"-";"-";"-";"-";"-";"-";"-";"-";"-";"-";"-";"-";"-";"-"
"08 Kw 2024 17:49:54";"Transakcja Sprzedaży";"O2-CR-8YYJBW";"T2-CR-5DJ4FT";"-";"Solana (USD)";"20 Jednost.";"181,516";"-";"-";"-";"-";"3,955645";"14 360,25";"0,00";"-";"-";"-";"-";"-";"-";"-";"-";"-";"-";"-";"-";"-";"-";"-";"-";"-";"-";"-";"-";"-";"-";"-";"-";"-"
"08 Kw 2024 16:48:10";"Transakcja Sprzedaży";"O2-CR-8YYCQ0";"T2-CR-5DHZL9";"-";"Solana (USD)";"25 Jednost.";"179,725";"-";"-";"-";"-";"3,956286";"17 776,08";"0,00";"-";"-";"-";"-";"-";"-";"-";"-";"-";"-";"-";"-";"-";"-";"-";"-";"-";"-";"-";"-";"-";"-";"-";"-";"-"
"08 Kw 2024 16:44:21";" Zamknięcie Transakcji";"O2-CR-8YYC7X";"T2-CR-5DHZ8K";"O2-CR-8YY9D2";"Solana (USD)";"20 Jednost.";"179,795";"-";"-";"-";"-";"3,91613";"14 223,56";"34,46";"18 955,80";"-";"-";"-";"-";"-";"-";"-";"-";"-";"-";"-";"-";"-";"-";"-";"-";"-";"-";"-";"-";"-";"-";"-";"-"
"08 Kw 2024 16:44:21";" Zamknięcie Transakcji";"O2-CR-8YYC7X";"T2-CR-5DHZ8J";"O2-CR-8YY7NE";"Solana (USD)";"10 Jednost.";"179,795";"-";"-";"-";"-";"3,91613";"7 111,78";"1,96";"18 921,34";"-";"-";"-";"-";"-";"-";"-";"-";"-";"-";"-";"-";"-";"-";"-";"-";"-";"-";"-";"-";"-";"-";"-";"-"
"08 Kw 2024 16:32:19";"Transakcja Sprzedaży";"O2-CR-8YY9D2";"T2-CR-5DHY4V";"-";"Solana (USD)";"20 Jednost.";"180,235";"-";"-";"-";"-";"3,954643";"14 255,30";"0,00";"-";"-";"-";"-";"-";"-";"-";"-";"-";"-";"-";"-";"-";"-";"-";"-";"-";"-";"-";"-";"-";"-";"-";"-";"-"
"08 Kw 2024 16:20:48";"Transakcja Sprzedaży";"O2-CR-8YY7NE";"T2-CR-5DHWPB";"-";"Solana (USD)";"10 Jednost.";"179,845";"-";"-";"-";"-";"3,958761";"7 119,63";"0,00";"-";"-";"-";"-";"-";"-";"-";"-";"-";"-";"-";"-";"-";"-";"-";"-";"-";"-";"-";"-";"-";"-";"-";"-";"-"
"08 Kw 2024 16:05:54";"Stop Loss";"O2-CR-8YY4HV";"T2-CR-5DHTXG";"-";"Solana (USD)";"30 Jednost.";"180,855";"-";"-";"-";"-";"3,91619";"21 461,45";"2,94";"18 919,38";"-";"-";"-";"-";"-";"-";"-";"-";"-";"-";"-";"-";"-";"-";"-";"-";"-";"-";"-";"-";"-";"-";"-";"-"
"08 Kw 2024 16:05:49";"Zmodyfikowano Transakcję Sprzedaży";"O2-CR-8YY4HV";"T2-CR-5DHSXS";"-";"Solana (USD)";"30 Jednost.";"180,880";"-";"180,800";"-";"-";"-";"-";"0,00";"-";"-";"-";"-";"-";"-";"-";"-";"-";"-";"-";"-";"-";"-";"-";"-";"-";"-";"-";"-";"-";"-";"-";"-";"-"
"08 Kw 2024 15:59:48";"Transakcja Sprzedaży";"O2-CR-8YY4HV";"T2-CR-5DHSXS";"-";"Solana (USD)";"30 Jednost.";"180,880";"-";"-";"-";"-";"3,954483";"21 458,60";"0,00";"-";"-";"-";"-";"-";"-";"-";"-";"-";"-";"-";"-";"-";"-";"-";"-";"-";"-";"-";"-";"-";"-";"-";"-";"-"
"08 Kw 2024 15:40:54";" Zamknięcie Transakcji";"O2-CR-8YY1C8";"T2-CR-5DHQ5F";"O2-CR-8YXXNH";"Solana (USD)";"15 Jednost.";"180,450";"-";"-";"-";"-";"3,91665";"10 707,94";"64,92";"18 916,44";"-";"-";"-";"-";"-";"-";"-";"-";"-";"-";"-";"-";"-";"-";"-";"-";"-";"-";"-";"-";"-";"-";"-";"-"
"08 Kw 2024 15:40:54";" Zamknięcie Transakcji";"O2-CR-8YY1C8";"T2-CR-5DHQ5E";"O2-CR-8YXWB4";"Solana (USD)";"10 Jednost.";"180,450";"-";"-";"-";"-";"3,91665";"7 138,63";"24,87";"18 851,52";"-";"-";"-";"-";"-";"-";"-";"-";"-";"-";"-";"-";"-";"-";"-";"-";"-";"-";"-";"-";"-";"-";"-";"-"
"08 Kw 2024 15:40:28";"Stop Loss";"O2-CR-8YXVC6";"T2-CR-5DHQ1Z";"-";"Solana (USD)";"25 Jednost.";"180,300";"-";"-";"-";"-";"3,91781";"17 836,97";"23,02";"18 826,65";"-";"-";"-";"-";"-";"-";"-";"-";"-";"-";"-";"-";"-";"-";"-";"-";"-";"-";"-";"-";"-";"-";"-";"-"
"08 Kw 2024 15:40:21";"Zmodyfikowano Transakcję Sprzedaży";"O2-CR-8YXVC6";"T2-CR-5DHJPM";"-";"Solana (USD)";"25 Jednost.";"180,535";"-";"180,300";"-";"-";"-";"-";"0,00";"-";"-";"-";"-";"-";"-";"-";"-";"-";"-";"-";"-";"-";"-";"-";"-";"-";"-";"-";"-";"-";"-";"-";"-";"-"
"08 Kw 2024 15:21:05";"Transakcja Sprzedaży";"O2-CR-8YXXNH";"T2-CR-5DHLYS";"-";"Solana (USD)";"15 Jednost.";"181,555";"-";"-";"-";"-";"3,961066";"10 787,27";"0,00";"-";"-";"-";"-";"-";"-";"-";"-";"-";"-";"-";"-";"-";"-";"-";"-";"-";"-";"-";"-";"-";"-";"-";"-";"-"
"08 Kw 2024 15:06:57";"Transakcja Sprzedaży";"O2-CR-8YXWB4";"T2-CR-5DHKSP";"-";"Solana (USD)";"10 Jednost.";"181,085";"-";"-";"-";"-";"3,962539";"7 175,56";"0,00";"-";"-";"-";"-";"-";"-";"-";"-";"-";"-";"-";"-";"-";"-";"-";"-";"-";"-";"-";"-";"-";"-";"-";"-";"-"
"08 Kw 2024 14:55:22";"Transakcja Sprzedaży";"O2-CR-8YXVC6";"T2-CR-5DHJPM";"-";"Solana (USD)";"25 Jednost.";"180,535";"-";"-";"-";"-";"3,963711";"17 889,71";"0,00";"-";"-";"-";"-";"-";"-";"-";"-";"-";"-";"-";"-";"-";"-";"-";"-";"-";"-";"-";"-";"-";"-";"-";"-";"-"
"08 Kw 2024 14:53:34";"Stop Loss";"O2-CR-8YXSMD";"T2-CR-5DHJJZ";"-";"Solana (USD)";"20 Jednost.";"181,105";"-";"-";"-";"-";"3,92437";"14 357,28";"26,76";"18 803,63";"-";"-";"-";"-";"-";"-";"-";"-";"-";"-";"-";"-";"-";"-";"-";"-";"-";"-";"-";"-";"-";"-";"-";"-"
"08 Kw 2024 14:51:46";"Zmodyfikowano Transakcję Sprzedaży";"O2-CR-8YXSMD";"T2-CR-5DHH5X";"-";"Solana (USD)";"20 Jednost.";"181,446";"-";"181,100";"-";"-";"-";"-";"0,00";"-";"-";"-";"-";"-";"-";"-";"-";"-";"-";"-";"-";"-";"-";"-";"-";"-";"-";"-";"-";"-";"-";"-";"-";"-"
"08 Kw 2024 14:32:17";"Transakcja Sprzedaży";"O2-CR-8YXSMD";"T2-CR-5DHH5X";"-";"Solana (USD)";"20 Jednost.";"181,446";"-";"-";"-";"-";"3,96805";"14 399,73";"0,00";"-";"-";"-";"-";"-";"-";"-";"-";"-";"-";"-";"-";"-";"-";"-";"-";"-";"-";"-";"-";"-";"-";"-";"-";"-"
"08 Kw 2024 12:48:24";" Zamknięcie Transakcji";"O2-CR-8YXM6H";"T2-CR-5DHCZ3";"O2-CR-8YXLS3";"Solana (USD)";"20 Jednost.";"183,373";"-";"-";"-";"-";"3,92937";"14 555,63";"2,20";"18 776,87";"-";"-";"-";"-";"-";"-";"-";"-";"-";"-";"-";"-";"-";"-";"-";"-";"-";"-";"-";"-";"-";"-";"-";"-"
"08 Kw 2024 12:38:37";" Transakcja Kupna";"O2-CR-8YXLS3";"T2-CR-5DHCN8";"-";"Solana (USD)";"20 Jednost.";"183,345";"-";"-";"-";"-";"3,969142";"14 554,44";"0,00";"-";"-";"-";"-";"-";"-";"-";"-";"-";"-";"-";"-";"-";"-";"-";"-";"-";"-";"-";"-";"-";"-";"-";"-";"-"
"08 Kw 2024 11:27:18";" Zamknięcie Transakcji";"O2-CR-8YXH8P";"T2-CR-5DH93N";"O2-CR-8YXG07";"Solana (USD)";"20 Jednost.";"184,110";"-";"-";"-";"-";"3,93297";"14 627,53";"3,78";"18 774,67";"-";"-";"-";"-";"-";"-";"-";"-";"-";"-";"-";"-";"-";"-";"-";"-";"-";"-";"-";"-";"-";"-";"-";"-"
"08 Kw 2024 11:04:36";" Transakcja Kupna";"O2-CR-8YXG07";"T2-CR-5DH83V";"-";"Solana (USD)";"20 Jednost.";"184,062";"-";"-";"-";"-";"3,974262";"14 630,21";"0,00";"-";"-";"-";"-";"-";"-";"-";"-";"-";"-";"-";"-";"-";"-";"-";"-";"-";"-";"-";"-";"-";"-";"-";"-";"-"
"08 Kw 2024 10:55:55";" Zamknięcie Transakcji";"O2-CR-8YXFDB";"T2-CR-5DH7KD";"O2-CR-8YSYMX";"Solana (USD)";"50 Jednost.";"183,546";"-";"-";"-";"-";"3,93389";"36 465,27";"62,35";"18 770,89";"-";"-";"-";"-";"-";"-";"-";"-";"-";"-";"-";"-";"-";"-";"-";"-";"-";"-";"-";"-";"-";"-";"-";"-"
"05 Kw 2024 23:01:15";"Koszty Utrzymania Pozycji";"1323992307";"-";"-";"Rachunek";"-";"-";"-";"-";"-";"-";"-";"-";"-78,74";"18 708,54";"-";"-";"-";"-";"-";"-78,74";"-";"-";"-";"-";"-";"-";"-";"-";"-";"-";"-";"-";"-";"-";"-";"-";"-";"-"
"05 Kw 2024 23:01:15";"Koszty Utrzymania Pozycji";"O2-CR-8YSYMX";"-";"-";"Solana (USD)";"-";"-";"-";"-";"-";"-";"-";"-";"-";"-";"-";"-";"8 774,50";"-27,50000%";"-78,74";"-78,74";"-";"-";"-";"-";"-";"-";"-";"-";"-";"-";"-";"-";"-";"-";"-";"-";"-";"-"
"04 Kw 2024 23:26:48";"Zmodyfikowano Take Profit";"O2-CR-8YSYMX";"-";"O2-CR-8YSYQL";"Solana (USD)";"50 Jednost.";"183,229";"-";"-";"188,500";"-";"-";"-";"-";"-";"-";"-";"-";"-";"-";"-";"-";"-";"-";"-";"-";"-";"-";"-";"-";"-";"-";"-";"-";"-";"-";"-";"-";"-"
"04 Kw 2024 23:01:17";"Koszty Utrzymania Pozycji";"1323516875";"-";"-";"Rachunek";"-";"-";"-";"-";"-";"-";"-";"-";"-27,36";"18 787,28";"-";"-";"-";"-";"-";"-27,36";"-";"-";"-";"-";"-";"-";"-";"-";"-";"-";"-";"-";"-";"-";"-";"-";"-";"-"
"04 Kw 2024 23:01:17";"Koszty Utrzymania Pozycji";"O2-CR-8YSYMX";"-";"-";"Solana (USD)";"-";"-";"-";"-";"-";"-";"-";"-";"-";"-";"-";"-";"9 129,25";"-27,50000%";"-27,36";"-27,36";"-";"-";"-";"-";"-";"-";"-";"-";"-";"-";"-";"-";"-";"-";"-";"-";"-";"-"
"04 Kw 2024 22:16:06";" Zmodyfikowano Transakcję Kupna";"O2-CR-8YSYMX";"T2-CR-5DE8FP";"-";"Solana (USD)";"50 Jednost.";"183,229";"-";"-";"187,000";"-";"-";"-";"0,00";"-";"-";"-";"-";"-";"-";"-";"-";"-";"-";"-";"-";"-";"-";"-";"-";"-";"-";"-";"-";"-";"-";"-";"-";"-"
"04 Kw 2024 22:13:43";" Transakcja Kupna";"O2-CR-8YSYMX";"T2-CR-5DE8FP";"-";"Solana (USD)";"50 Jednost.";"183,229";"-";"-";"-";"-";"3,97806";"36 444,79";"0,00";"-";"-";"-";"-";"-";"-";"-";"-";"-";"-";"-";"-";"-";"-";"-";"-";"-";"-";"-";"-";"-";"-";"-";"-";"-"
"04 Kw 2024 22:09:49";" Zamknięcie Transakcji";"O2-CR-8YSYFM";"T2-CR-5DE88Y";"O2-CR-8YSNRE";"Solana (USD)";"2 Jednost.";"183,040";"-";"-";"-";"-";"3,93913";"1 456,53";"26,86";"18 814,64";"-";"-";"-";"-";"-";"-";"-";"-";"-";"-";"-";"-";"-";"-";"-";"-";"-";"-";"-";"-";"-";"-";"-";"-"
"04 Kw 2024 22:09:36";"Stop Loss";"O2-CR-8YSM5L";"T2-CR-5DE88K";"-";"Solana (USD)";"45 Jednost.";"183,005";"-";"-";"-";"-";"3,93907";"32 765,16";"483,91";"18 787,78";"-";"-";"-";"-";"-";"-";"-";"-";"-";"-";"-";"-";"-";"-";"-";"-";"-";"-";"-";"-";"-";"-";"-";"-"
"04 Kw 2024 22:09:34";"Zmodyfikowano Transakcję Sprzedaży";"O2-CR-8YSM5L";"T2-CR-5DDYQ4";"-";"Solana (USD)";"45 Jednost.";"185,735";"-";"183,000";"-";"-";"-";"-";"0,00";"-";"-";"-";"-";"-";"-";"-";"-";"-";"-";"-";"-";"-";"-";"-";"-";"-";"-";"-";"-";"-";"-";"-";"-";"-"
"04 Kw 2024 21:10:02";"Transakcja Sprzedaży";"O2-CR-8YSNRE";"T2-CR-5DE03Y";"-";"Solana (USD)";"2 Jednost.";"186,450";"-";"-";"-";"-";"3,972839";"1 481,47";"0,00";"-";"-";"-";"-";"-";"-";"-";"-";"-";"-";"-";"-";"-";"-";"-";"-";"-";"-";"-";"-";"-";"-";"-";"-";"-"
"04 Kw 2024 21:01:32";"Transakcja Sprzedaży";"O2-CR-8YSM5L";"T2-CR-5DDYQ4";"-";"Solana (USD)";"45 Jednost.";"185,735";"-";"-";"-";"-";"3,972168";"33 199,67";"0,00";"-";"-";"-";"-";"-";"-";"-";"-";"-";"-";"-";"-";"-";"-";"-";"-";"-";"-";"-";"-";"-";"-";"-";"-";"-"
"04 Kw 2024 20:56:15";"Stop Loss";"O2-CR-8YSK5P";"T2-CR-5DDXLT";"-";"Solana (USD)";"40 Jednost.";"186,020";"-";"-";"-";"-";"3,93117";"29 544,99";"95,92";"18 303,87";"-";"-";"-";"-";"-";"-";"-";"-";"-";"-";"-";"-";"-";"-";"-";"-";"-";"-";"-";"-";"-";"-";"-";"-"
"04 Kw 2024 20:55:37";"Zmodyfikowano Stop Loss";"O2-CR-8YSK5P";"-";"O2-CR-8YSKJK";"Solana (USD)";"40 Jednost.";"186,630";"-";"186,000";"-";"-";"-";"-";"-";"-";"-";"-";"-";"-";"-";"-";"-";"-";"-";"-";"-";"-";"-";"-";"-";"-";"-";"-";"-";"-";"-";"-";"-";"-"
"04 Kw 2024 20:54:54";"Zmodyfikowano Transakcję Sprzedaży";"O2-CR-8YSK5P";"T2-CR-5DDWQ9";"-";"Solana (USD)";"40 Jednost.";"186,630";"-";"186,300";"-";"-";"-";"-";"0,00";"-";"-";"-";"-";"-";"-";"-";"-";"-";"-";"-";"-";"-";"-";"-";"-";"-";"-";"-";"-";"-";"-";"-";"-";"-"
"04 Kw 2024 20:52:24";"Transakcja Sprzedaży";"O2-CR-8YSK5P";"T2-CR-5DDWQ9";"-";"Solana (USD)";"40 Jednost.";"186,630";"-";"-";"-";"-";"3,969132";"29 630,36";"0,00";"-";"-";"-";"-";"-";"-";"-";"-";"-";"-";"-";"-";"-";"-";"-";"-";"-";"-";"-";"-";"-";"-";"-";"-";"-"
"04 Kw 2024 20:38:44";"Stop Loss";"O2-CR-8YSGES";"T2-CR-5DDTJ0";"-";"Solana (USD)";"20 Jednost.";"187,023";"-";"-";"-";"-";"3,93024";"14 848,66";"6,52";"18 207,95";"-";"-";"-";"-";"-";"-";"-";"-";"-";"-";"-";"-";"-";"-";"-";"-";"-";"-";"-";"-";"-";"-";"-";"-"
"04 Kw 2024 20:38:39";" Zmodyfikowano Transakcję Kupna";"O2-CR-8YSGES";"T2-CR-5DDT54";"-";"Solana (USD)";"20 Jednost.";"186,940";"-";"187,050";"-";"-";"-";"-";"0,00";"-";"-";"-";"-";"-";"-";"-";"-";"-";"-";"-";"-";"-";"-";"-";"-";"-";"-";"-";"-";"-";"-";"-";"-";"-"
"04 Kw 2024 20:36:33";" Transakcja Kupna";"O2-CR-8YSGES";"T2-CR-5DDT54";"-";"Solana (USD)";"20 Jednost.";"186,940";"-";"-";"-";"-";"3,969773";"14 842,18";"0,00";"-";"-";"-";"-";"-";"-";"-";"-";"-";"-";"-";"-";"-";"-";"-";"-";"-";"-";"-";"-";"-";"-";"-";"-";"-"
"04 Kw 2024 20:33:57";" Zamknięcie Transakcji";"O2-CR-8YSFZH";"T2-CR-5DDST9";"O2-CR-8YS46J";"Solana (USD)";"20 Jednost.";"187,001";"-";"-";"-";"-";"3,92991";"14 845,68";"22,32";"18 201,43";"-";"-";"-";"-";"-";"-";"-";"-";"-";"-";"-";"-";"-";"-";"-";"-";"-";"-";"-";"-";"-";"-";"-";"-"
"04 Kw 2024 20:21:57";" Zamknięcie Transakcji";"O2-CR-8YSDMG";"T2-CR-5DDQDX";"O2-CR-8YS9DW";"Solana (USD)";"20 Jednost.";"188,600";"-";"-";"-";"-";"3,92847";"14 967,06";"22,08";"18 179,11";"-";"-";"-";"-";"-";"-";"-";"-";"-";"-";"-";"-";"-";"-";"-";"-";"-";"-";"-";"-";"-";"-";"-";"-"
"04 Kw 2024 19:59:32";"Zmodyfikowano Transakcję Sprzedaży";"O2-CR-8YS46J";"T2-CR-5DDGR7";"-";"Solana (USD)";"20 Jednost.";"187,285";"-";"-";"183,500";"-";"-";"-";"0,00";"-";"-";"-";"-";"-";"-";"-";"-";"-";"-";"-";"-";"-";"-";"-";"-";"-";"-";"-";"-";"-";"-";"-";"-";"-"
"04 Kw 2024 19:59:06";"Zmodyfikowano Transakcję Sprzedaży";"O2-CR-8YS9DW";"T2-CR-5DDM41";"-";"Solana (USD)";"20 Jednost.";"188,881";"-";"-";"183,500";"-";"-";"-";"0,00";"-";"-";"-";"-";"-";"-";"-";"-";"-";"-";"-";"-";"-";"-";"-";"-";"-";"-";"-";"-";"-";"-";"-";"-";"-"
"04 Kw 2024 19:56:46";"Transakcja Sprzedaży";"O2-CR-8YS9DW";"T2-CR-5DDM41";"-";"Solana (USD)";"20 Jednost.";"188,881";"-";"-";"-";"-";"3,966407";"14 983,57";"0,00";"-";"-";"-";"-";"-";"-";"-";"-";"-";"-";"-";"-";"-";"-";"-";"-";"-";"-";"-";"-";"-";"-";"-";"-";"-"
"04 Kw 2024 17:54:17";"Transakcja Sprzedaży";"O2-CR-8YS46J";"T2-CR-5DDGR7";"-";"Solana (USD)";"20 Jednost.";"187,285";"-";"-";"-";"-";"3,965515";"14 853,62";"0,00";"-";"-";"-";"-";"-";"-";"-";"-";"-";"-";"-";"-";"-";"-";"-";"-";"-";"-";"-";"-";"-";"-";"-";"-";"-"
"04 Kw 2024 17:15:53";"Stop Loss";"O2-CR-8YRYVF";"T2-CR-5DDF6Q";"-";"Solana (USD)";"20 Jednost.";"187,540";"-";"-";"-";"-";"3,92346";"14 864,00";"33,74";"18 157,03";"-";"-";"-";"-";"-";"-";"-";"-";"-";"-";"-";"-";"-";"-";"-";"-";"-";"-";"-";"-";"-";"-";"-";"-"
"04 Kw 2024 17:15:01";"Zmodyfikowano Transakcję Sprzedaży";"O2-CR-8YRYVF";"T2-CR-5DDCDL";"-";"Solana (USD)";"20 Jednost.";"187,970";"-";"187,500";"-";"-";"-";"-";"0,00";"-";"-";"-";"-";"-";"-";"-";"-";"-";"-";"-";"-";"-";"-";"-";"-";"-";"-";"-";"-";"-";"-";"-";"-";"-"
"04 Kw 2024 16:23:51";"Transakcja Sprzedaży";"O2-CR-8YRYVF";"T2-CR-5DDCDL";"-";"Solana (USD)";"20 Jednost.";"187,970";"-";"-";"-";"-";"3,963641";"14 900,91";"0,00";"-";"-";"-";"-";"-";"-";"-";"-";"-";"-";"-";"-";"-";"-";"-";"-";"-";"-";"-";"-";"-";"-";"-";"-";"-"
"04 Kw 2024 16:13:31";"Stop Loss";"O2-CR-8YRXLJ";"T2-CR-5DDBQL";"-";"Solana (USD)";"4 Jednost.";"188,970";"-";"-";"-";"-";"3,9207";"2 993,37";"8,80";"18 123,29";"-";"-";"-";"-";"-";"-";"-";"-";"-";"-";"-";"-";"-";"-";"-";"-";"-";"-";"-";"-";"-";"-";"-";"-"
"04 Kw 2024 16:13:31";"Stop Loss";"O2-CR-8YRTHJ";"T2-CR-5DDBQK";"-";"Solana (USD)";"4 Jednost.";"188,970";"-";"-";"-";"-";"3,9207";"2 993,37";"9,17";"18 114,49";"-";"-";"-";"-";"-";"-";"-";"-";"-";"-";"-";"-";"-";"-";"-";"-";"-";"-";"-";"-";"-";"-";"-";"-"
"04 Kw 2024 16:13:31";"Stop Loss";"O2-CR-8YRSHW";"T2-CR-5DDBQJ";"-";"Solana (USD)";"40 Jednost.";"188,970";"-";"-";"-";"-";"3,9207";"29 933,70";"7,06";"18 105,32";"-";"-";"-";"-";"-";"-";"-";"-";"-";"-";"-";"-";"-";"-";"-";"-";"-";"-";"-";"-";"-";"-";"-";"-"
"04 Kw 2024 16:13:03";" Zmodyfikowano Transakcję Kupna";"O2-CR-8YRXLJ";"T2-CR-5DDBBF";"-";"Solana (USD)";"4 Jednost.";"188,409";"-";"189,000";"191,000";"-";"-";"-";"0,00";"-";"-";"-";"-";"-";"-";"-";"-";"-";"-";"-";"-";"-";"-";"-";"-";"-";"-";"-";"-";"-";"-";"-";"-";"-"
"04 Kw 2024 16:12:38";" Zmodyfikowano Transakcję Kupna";"O2-CR-8YRTHJ";"T2-CR-5DD7RN";"-";"Solana (USD)";"4 Jednost.";"188,385";"-";"189,000";"191,000";"-";"-";"-";"0,00";"-";"-";"-";"-";"-";"-";"-";"-";"-";"-";"-";"-";"-";"-";"-";"-";"-";"-";"-";"-";"-";"-";"-";"-";"-"
"04 Kw 2024 16:11:55";" Zmodyfikowano Transakcję Kupna";"O2-CR-8YRSHW";"T2-CR-5DD6VT";"-";"Solana (USD)";"40 Jednost.";"188,925";"-";"189,000";"191,000";"-";"-";"-";"0,00";"-";"-";"-";"-";"-";"-";"-";"-";"-";"-";"-";"-";"-";"-";"-";"-";"-";"-";"-";"-";"-";"-";"-";"-";"-"
"04 Kw 2024 16:06:29";" Zmodyfikowano Transakcję Kupna";"O2-CR-8YRXLJ";"T2-CR-5DDBBF";"-";"Solana (USD)";"4 Jednost.";"188,409";"-";"-";"191,000";"-";"-";"-";"0,00";"-";"-";"-";"-";"-";"-";"-";"-";"-";"-";"-";"-";"-";"-";"-";"-";"-";"-";"-";"-";"-";"-";"-";"-";"-"
"04 Kw 2024 16:06:01";" Transakcja Kupna";"O2-CR-8YRXLJ";"T2-CR-5DDBBF";"-";"Solana (USD)";"4 Jednost.";"188,409";"-";"-";"-";"-";"3,964423";"2 987,73";"0,00";"-";"-";"-";"-";"-";"-";"-";"-";"-";"-";"-";"-";"-";"-";"-";"-";"-";"-";"-";"-";"-";"-";"-";"-";"-"
"04 Kw 2024 16:02:29";" Zmodyfikowano Transakcję Kupna";"O2-CR-8YRTHJ";"T2-CR-5DD7RN";"-";"Solana (USD)";"4 Jednost.";"188,385";"-";"-";"191,000";"-";"-";"-";"0,00";"-";"-";"-";"-";"-";"-";"-";"-";"-";"-";"-";"-";"-";"-";"-";"-";"-";"-";"-";"-";"-";"-";"-";"-";"-"
"04 Kw 2024 16:02:12";" Zmodyfikowano Transakcję Kupna";"O2-CR-8YRSHW";"T2-CR-5DD6VT";"-";"Solana (USD)";"40 Jednost.";"188,925";"-";"-";"191,000";"-";"-";"-";"0,00";"-";"-";"-";"-";"-";"-";"-";"-";"-";"-";"-";"-";"-";"-";"-";"-";"-";"-";"-";"-";"-";"-";"-";"-";"-"
"04 Kw 2024 15:38:17";" Transakcja Kupna";"O2-CR-8YRTHJ";"T2-CR-5DD7RN";"-";"Solana (USD)";"4 Jednost.";"188,385";"-";"-";"-";"-";"3,964703";"2 987,56";"0,00";"-";"-";"-";"-";"-";"-";"-";"-";"-";"-";"-";"-";"-";"-";"-";"-";"-";"-";"-";"-";"-";"-";"-";"-";"-"
"04 Kw 2024 15:31:42";" Transakcja Kupna";"O2-CR-8YRSHW";"T2-CR-5DD6VT";"-";"Solana (USD)";"40 Jednost.";"188,925";"-";"-";"-";"-";"3,966687";"29 976,25";"0,00";"-";"-";"-";"-";"-";"-";"-";"-";"-";"-";"-";"-";"-";"-";"-";"-";"-";"-";"-";"-";"-";"-";"-";"-";"-"
"04 Kw 2024 15:23:00";"Stop Loss";"O2-CR-8YQF4B";"T2-CR-5DD64D";"-";"Solana (USD)";"25 Jednost.";"188,985";"-";"-";"-";"-";"3,93022";"18 755,45";"361,58";"18 098,26";"-";"-";"-";"-";"-";"-";"-";"-";"-";"-";"-";"-";"-";"-";"-";"-";"-";"-";"-";"-";"-";"-";"-";"-"
"04 Kw 2024 15:23:00";"Stop Loss";"O2-CR-8YQ4PR";"T2-CR-5DD64C";"-";"Solana (USD)";"20 Jednost.";"188,985";"-";"-";"-";"-";"3,93022";"15 004,36";"69,96";"17 736,68";"-";"-";"-";"-";"-";"-";"-";"-";"-";"-";"-";"-";"-";"-";"-";"-";"-";"-";"-";"-";"-";"-";"-";"-"
"04 Kw 2024 15:21:47";" Zmodyfikowano Transakcję Kupna";"O2-CR-8YQF4B";"T2-CR-5DC5DF";"-";"Solana (USD)";"25 Jednost.";"185,305";"-";"189,000";"190,000";"-";"-";"-";"0,00";"-";"-";"-";"-";"-";"-";"-";"-";"-";"-";"-";"-";"-";"-";"-";"-";"-";"-";"-";"-";"-";"-";"-";"-";"-"
"04 Kw 2024 15:21:31";" Zmodyfikowano Transakcję Kupna";"O2-CR-8YQ4PR";"T2-CR-5DBWLW";"-";"Solana (USD)";"20 Jednost.";"188,095";"-";"189,000";"190,000";"-";"-";"-";"0,00";"-";"-";"-";"-";"-";"-";"-";"-";"-";"-";"-";"-";"-";"-";"-";"-";"-";"-";"-";"-";"-";"-";"-";"-";"-"
"03 Kw 2024 23:01:18";"Koszty Utrzymania Pozycji";"1323085460";"-";"-";"Rachunek";"-";"-";"-";"-";"-";"-";"-";"-";"-24,77";"17 666,72";"-";"-";"-";"-";"-";"-24,77";"-";"-";"-";"-";"-";"-";"-";"-";"-";"-";"-";"-";"-";"-";"-";"-";"-";"-"
"03 Kw 2024 23:01:18";"Koszty Utrzymania Pozycji";"O2-CR-8YQ4PR";"-";"-";"Solana (USD)";"-";"-";"-";"-";"-";"-";"-";"-";"-";"-";"-";"-";"3 671,40";"-27,50000%";"-11,01";"-11,01";"-";"-";"-";"-";"-";"-";"-";"-";"-";"-";"-";"-";"-";"-";"-";"-";"-";"-"
"03 Kw 2024 23:01:18";"Koszty Utrzymania Pozycji";"O2-CR-8YQF4B";"-";"-";"Solana (USD)";"-";"-";"-";"-";"-";"-";"-";"-";"-";"-";"-";"-";"4 589,25";"-27,50000%";"-13,76";"-13,76";"-";"-";"-";"-";"-";"-";"-";"-";"-";"-";"-";"-";"-";"-";"-";"-";"-";"-"
"03 Kw 2024 22:34:54";" Zmodyfikowano Transakcję Kupna";"O2-CR-8YQF4B";"T2-CR-5DC5DF";"-";"Solana (USD)";"25 Jednost.";"185,305";"-";"-";"190,000";"-";"-";"-";"0,00";"-";"-";"-";"-";"-";"-";"-";"-";"-";"-";"-";"-";"-";"-";"-";"-";"-";"-";"-";"-";"-";"-";"-";"-";"-"
"03 Kw 2024 22:34:23";" Zmodyfikowano Transakcję Kupna";"O2-CR-8YQ4PR";"T2-CR-5DBWLW";"-";"Solana (USD)";"20 Jednost.";"188,095";"-";"-";"190,000";"-";"-";"-";"0,00";"-";"-";"-";"-";"-";"-";"-";"-";"-";"-";"-";"-";"-";"-";"-";"-";"-";"-";"-";"-";"-";"-";"-";"-";"-"
"03 Kw 2024 22:05:03";" Transakcja Kupna";"O2-CR-8YQF4B";"T2-CR-5DC5DF";"-";"Solana (USD)";"25 Jednost.";"185,305";"-";"-";"-";"-";"3,980054";"18 438,09";"0,00";"-";"-";"-";"-";"-";"-";"-";"-";"-";"-";"-";"-";"-";"-";"-";"-";"-";"-";"-";"-";"-";"-";"-";"-";"-"
"03 Kw 2024 21:59:47";"Stop Loss";"O2-CR-8YQDS7";"T2-CR-5DC4ZC";"-";"Solana (USD)";"25 Jednost.";"185,785";"-";"-";"-";"-";"3,93886";"18 478,41";"73,66";"17 691,49";"-";"-";"-";"-";"-";"-";"-";"-";"-";"-";"-";"-";"-";"-";"-";"-";"-";"-";"-";"-";"-";"-";"-";"-"
"03 Kw 2024 21:59:42";"Zmodyfikowano Stop Loss";"O2-CR-8YQDS7";"-";"O2-CR-8YQELP";"Solana (USD)";"25 Jednost.";"185,037";"-";"185,800";"-";"-";"-";"-";"-";"-";"-";"-";"-";"-";"-";"-";"-";"-";"-";"-";"-";"-";"-";"-";"-";"-";"-";"-";"-";"-";"-";"-";"-";"-"
"03 Kw 2024 21:59:06";"Zmodyfikowano Stop Loss";"O2-CR-8YQDS7";"-";"O2-CR-8YQELP";"Solana (USD)";"25 Jednost.";"185,037";"-";"185,700";"-";"-";"-";"-";"-";"-";"-";"-";"-";"-";"-";"-";"-";"-";"-";"-";"-";"-";"-";"-";"-";"-";"-";"-";"-";"-";"-";"-";"-";"-"
"03 Kw 2024 21:58:42";"Zmodyfikowano Stop Loss";"O2-CR-8YQDS7";"-";"O2-CR-8YQELP";"Solana (USD)";"25 Jednost.";"185,037";"-";"185,600";"-";"-";"-";"-";"-";"-";"-";"-";"-";"-";"-";"-";"-";"-";"-";"-";"-";"-";"-";"-";"-";"-";"-";"-";"-";"-";"-";"-";"-";"-"
"03 Kw 2024 21:58:06";" Zmodyfikowano Transakcję Kupna";"O2-CR-8YQDS7";"T2-CR-5DC44M";"-";"Solana (USD)";"25 Jednost.";"185,037";"-";"185,400";"-";"-";"-";"-";"0,00";"-";"-";"-";"-";"-";"-";"-";"-";"-";"-";"-";"-";"-";"-";"-";"-";"-";"-";"-";"-";"-";"-";"-";"-";"-"
"03 Kw 2024 21:46:16";" Transakcja Kupna";"O2-CR-8YQDS7";"T2-CR-5DC44M";"-";"Solana (USD)";"25 Jednost.";"185,037";"-";"-";"-";"-";"3,980695";"18 414,39";"0,00";"-";"-";"-";"-";"-";"-";"-";"-";"-";"-";"-";"-";"-";"-";"-";"-";"-";"-";"-";"-";"-";"-";"-";"-";"-"
"03 Kw 2024 21:27:16";"Stop Loss";"O2-CR-8YQ9FD";"T2-CR-5DC2LR";"-";"Solana (USD)";"20 Jednost.";"186,175";"-";"-";"-";"-";"3,94206";"14 825,81";"35,48";"17 617,83";"-";"-";"-";"-";"-";"-";"-";"-";"-";"-";"-";"-";"-";"-";"-";"-";"-";"-";"-";"-";"-";"-";"-";"-"
"03 Kw 2024 21:26:21";"Zmodyfikowano Stop Loss";"O2-CR-8YQ9FD";"-";"O2-CR-8YQC1F";"Solana (USD)";"20 Jednost.";"185,725";"-";"186,200";"-";"-";"-";"-";"-";"-";"-";"-";"-";"-";"-";"-";"-";"-";"-";"-";"-";"-";"-";"-";"-";"-";"-";"-";"-";"-";"-";"-";"-";"-"
"03 Kw 2024 21:24:48";" Zmodyfikowano Transakcję Kupna";"O2-CR-8YQ9FD";"T2-CR-5DC0RN";"-";"Solana (USD)";"20 Jednost.";"185,725";"-";"186,100";"-";"-";"-";"-";"0,00";"-";"-";"-";"-";"-";"-";"-";"-";"-";"-";"-";"-";"-";"-";"-";"-";"-";"-";"-";"-";"-";"-";"-";"-";"-"
"03 Kw 2024 21:12:14";" Transakcja Kupna";"O2-CR-8YQ9FD";"T2-CR-5DC0RN";"-";"Solana (USD)";"20 Jednost.";"185,725";"-";"-";"-";"-";"3,980845";"14 786,84";"0,00";"-";"-";"-";"-";"-";"-";"-";"-";"-";"-";"-";"-";"-";"-";"-";"-";"-";"-";"-";"-";"-";"-";"-";"-";"-"
"03 Kw 2024 20:55:45";"Stop Loss";"O2-CR-8YQ7P0";"T2-CR-5DBZWD";"-";"Solana (USD)";"20 Jednost.";"186,600";"-";"-";"-";"-";"3,94041";"14 853,41";"54,77";"17 582,35";"-";"-";"-";"-";"-";"-";"-";"-";"-";"-";"-";"-";"-";"-";"-";"-";"-";"-";"-";"-";"-";"-";"-";"-"
"03 Kw 2024 20:55:10";"Zmodyfikowano Stop Loss";"O2-CR-8YQ7P0";"-";"O2-CR-8YQ882";"Solana (USD)";"20 Jednost.";"185,905";"-";"186,600";"-";"-";"-";"-";"-";"-";"-";"-";"-";"-";"-";"-";"-";"-";"-";"-";"-";"-";"-";"-";"-";"-";"-";"-";"-";"-";"-";"-";"-";"-"
"03 Kw 2024 20:53:28";" Zmodyfikowano Transakcję Kupna";"O2-CR-8YQ7P0";"T2-CR-5DBZC7";"-";"Solana (USD)";"20 Jednost.";"185,905";"-";"186,500";"-";"-";"-";"-";"0,00";"-";"-";"-";"-";"-";"-";"-";"-";"-";"-";"-";"-";"-";"-";"-";"-";"-";"-";"-";"-";"-";"-";"-";"-";"-"
"03 Kw 2024 20:44:18";" Transakcja Kupna";"O2-CR-8YQ7P0";"T2-CR-5DBZC7";"-";"Solana (USD)";"20 Jednost.";"185,905";"-";"-";"-";"-";"3,980605";"14 800,28";"0,00";"-";"-";"-";"-";"-";"-";"-";"-";"-";"-";"-";"-";"-";"-";"-";"-";"-";"-";"-";"-";"-";"-";"-";"-";"-"
"03 Kw 2024 20:36:36";" Zamknięcie Transakcji";"O2-CR-8YQ7C0";"T2-CR-5DBZ17";"O2-CR-8YQ5NP";"Solana (USD)";"25 Jednost.";"185,495";"-";"-";"-";"-";"3,94087";"18 458,95";"140,39";"17 527,58";"-";"-";"-";"-";"-";"-";"-";"-";"-";"-";"-";"-";"-";"-";"-";"-";"-";"-";"-";"-";"-";"-";"-";"-"
"03 Kw 2024 20:06:43";"Transakcja Sprzedaży";"O2-CR-8YQ5NP";"T2-CR-5DBXJ5";"-";"Solana (USD)";"25 Jednost.";"186,920";"-";"-";"-";"-";"3,980344";"18 600,14";"0,00";"-";"-";"-";"-";"-";"-";"-";"-";"-";"-";"-";"-";"-";"-";"-";"-";"-";"-";"-";"-";"-";"-";"-";"-";"-"
"03 Kw 2024 19:44:19";" Transakcja Kupna";"O2-CR-8YQ4PR";"T2-CR-5DBWLW";"-";"Solana (USD)";"20 Jednost.";"188,095";"-";"-";"-";"-";"3,980805";"14 975,39";"0,00";"-";"-";"-";"-";"-";"-";"-";"-";"-";"-";"-";"-";"-";"-";"-";"-";"-";"-";"-";"-";"-";"-";"-";"-";"-"
"03 Kw 2024 15:26:09";" Zamknięcie Transakcji";"O2-CR-8YP5SR";"T2-CR-5DB02G";"O2-CR-8YNXV9";"Solana (USD)";"45 Jednost.";"187,215";"-";"-";"-";"-";"3,96424";"33 733,00";"22,30";"17 387,19";"-";"-";"-";"-";"-";"-";"-";"-";"-";"-";"-";"-";"-";"-";"-";"-";"-";"-";"-";"-";"-";"-";"-";"-"
"03 Kw 2024 13:57:45";"Zmodyfikowano Transakcję Sprzedaży";"O2-CR-8YNXV9";"T2-CR-5D9S56";"-";"Solana (USD)";"45 Jednost.";"187,340";"-";"-";"182,500";"-";"-";"-";"0,00";"-";"-";"-";"-";"-";"-";"-";"-";"-";"-";"-";"-";"-";"-";"-";"-";"-";"-";"-";"-";"-";"-";"-";"-";"-"
"03 Kw 2024 13:28:33";"Transakcja Sprzedaży";"O2-CR-8YNXV9";"T2-CR-5D9S56";"-";"Solana (USD)";"45 Jednost.";"187,340";"-";"-";"-";"-";"4,00332";"33 749,18";"0,00";"-";"-";"-";"-";"-";"-";"-";"-";"-";"-";"-";"-";"-";"-";"-";"-";"-";"-";"-";"-";"-";"-";"-";"-";"-"
"03 Kw 2024 13:13:05";"Stop Loss";"O2-CR-8YNMN6";"T2-CR-5D9RBP";"-";"Solana (USD)";"40 Jednost.";"187,220";"-";"-";"-";"-";"3,96296";"29 976,08";"241,74";"17 364,89";"-";"-";"-";"-";"-";"-";"-";"-";"-";"-";"-";"-";"-";"-";"-";"-";"-";"-";"-";"-";"-";"-";"-";"-"
"03 Kw 2024 13:12:37";"Zmodyfikowano Transakcję Sprzedaży";"O2-CR-8YNMN6";"T2-CR-5D9J5D";"-";"Solana (USD)";"40 Jednost.";"188,745";"-";"187,200";"181,000";"-";"-";"-";"0,00";"-";"-";"-";"-";"-";"-";"-";"-";"-";"-";"-";"-";"-";"-";"-";"-";"-";"-";"-";"-";"-";"-";"-";"-";"-"
"03 Kw 2024 10:32:00";"Zmodyfikowano Take Profit";"O2-CR-8YNMN6";"-";"O2-CR-8YNNFH";"Solana (USD)";"40 Jednost.";"188,745";"-";"-";"181,000";"-";"-";"-";"-";"-";"-";"-";"-";"-";"-";"-";"-";"-";"-";"-";"-";"-";"-";"-";"-";"-";"-";"-";"-";"-";"-";"-";"-";"-"
"03 Kw 2024 10:31:12";"Zmodyfikowano Transakcję Sprzedaży";"O2-CR-8YNMN6";"T2-CR-5D9J5D";"-";"Solana (USD)";"40 Jednost.";"188,745";"-";"-";"180,500";"-";"-";"-";"0,00";"-";"-";"-";"-";"-";"-";"-";"-";"-";"-";"-";"-";"-";"-";"-";"-";"-";"-";"-";"-";"-";"-";"-";"-";"-"
"03 Kw 2024 10:10:59";"Transakcja Sprzedaży";"O2-CR-8YNMN6";"T2-CR-5D9J5D";"-";"Solana (USD)";"40 Jednost.";"188,745";"-";"-";"-";"-";"4,006216";"30 246,12";"0,00";"-";"-";"-";"-";"-";"-";"-";"-";"-";"-";"-";"-";"-";"-";"-";"-";"-";"-";"-";"-";"-";"-";"-";"-";"-"
"02 Kw 2024 23:28:49";"Stop Loss";"O2-CR-8YMZGK";"T2-CR-5D93L3";"-";"Solana (USD)";"40 Jednost.";"183,400";"-";"-";"-";"-";"3,96281";"29 363,35";"183,08";"17 123,15";"-";"-";"-";"-";"-";"-";"-";"-";"-";"-";"-";"-";"-";"-";"-";"-";"-";"-";"-";"-";"-";"-";"-";"-"
"02 Kw 2024 23:28:15";"Zmodyfikowano Stop Loss";"O2-CR-8YMZGK";"-";"O2-CR-8YN3DC";"Solana (USD)";"40 Jednost.";"184,555";"-";"183,400";"-";"-";"-";"-";"-";"-";"-";"-";"-";"-";"-";"-";"-";"-";"-";"-";"-";"-";"-";"-";"-";"-";"-";"-";"-";"-";"-";"-";"-";"-"
"02 Kw 2024 23:27:02";"Zmodyfikowano Transakcję Sprzedaży";"O2-CR-8YMZGK";"T2-CR-5D906Z";"-";"Solana (USD)";"40 Jednost.";"184,555";"-";"183,600";"180,500";"-";"-";"-";"0,00";"-";"-";"-";"-";"-";"-";"-";"-";"-";"-";"-";"-";"-";"-";"-";"-";"-";"-";"-";"-";"-";"-";"-";"-";"-"
"02 Kw 2024 23:02:40";"Zmodyfikowano Transakcję Sprzedaży";"O2-CR-8YMZGK";"T2-CR-5D906Z";"-";"Solana (USD)";"40 Jednost.";"184,555";"-";"-";"180,500";"-";"-";"-";"0,00";"-";"-";"-";"-";"-";"-";"-";"-";"-";"-";"-";"-";"-";"-";"-";"-";"-";"-";"-";"-";"-";"-";"-";"-";"-"
"02 Kw 2024 23:01:09";"Koszty Utrzymania Pozycji";"1322605171";"-";"-";"Rachunek";"-";"-";"-";"-";"-";"-";"-";"-";"8,03";"16 940,07";"-";"-";"-";"-";"-";"8,03";"-";"-";"-";"-";"-";"-";"-";"-";"-";"-";"-";"-";"-";"-";"-";"-";"-";"-"
"02 Kw 2024 23:01:09";"Koszty Utrzymania Pozycji";"O2-CR-8YMZGK";"-";"-";"Solana (USD)";"-";"-";"-";"-";"-";"-";"-";"-";"-";"-";"-";"-";"7 394,60";"-10,00000%";"8,03";"8,03";"-";"-";"-";"-";"-";"-";"-";"-";"-";"-";"-";"-";"-";"-";"-";"-";"-";"-"
"02 Kw 2024 21:23:25";"Transakcja Sprzedaży";"O2-CR-8YMZGK";"T2-CR-5D906Z";"-";"Solana (USD)";"40 Jednost.";"184,555";"-";"-";"-";"-";"4,007038";"29 580,75";"0,00";"-";"-";"-";"-";"-";"-";"-";"-";"-";"-";"-";"-";"-";"-";"-";"-";"-";"-";"-";"-";"-";"-";"-";"-";"-"
"02 Kw 2024 21:16:20";"Stop Loss";"O2-CR-8YMDXC";"T2-CR-5D8ZW1";"-";"Solana (USD)";"44,5 Jednost.";"185,060";"-";"-";"-";"-";"3,96636";"32 991,95";"510,09";"16 932,04";"-";"-";"-";"-";"-";"-";"-";"-";"-";"-";"-";"-";"-";"-";"-";"-";"-";"-";"-";"-";"-";"-";"-";"-"
"02 Kw 2024 21:15:29";" Zmodyfikowano Transakcję Kupna";"O2-CR-8YMDXC";"T2-CR-5D8HBV";"-";"Solana (USD)";"44,5 Jednost.";"182,170";"-";"185,100";"-";"-";"-";"-";"0,00";"-";"-";"-";"-";"-";"-";"-";"-";"-";"-";"-";"-";"-";"-";"-";"-";"-";"-";"-";"-";"-";"-";"-";"-";"-"
"02 Kw 2024 16:34:18";" Transakcja Kupna";"O2-CR-8YMDXC";"T2-CR-5D8HBV";"-";"Solana (USD)";"44,5 Jednost.";"182,170";"-";"-";"-";"-";"4,004082";"32 459,35";"0,00";"-";"-";"-";"-";"-";"-";"-";"-";"-";"-";"-";"-";"-";"-";"-";"-";"-";"-";"-";"-";"-";"-";"-";"-";"-"
"01 Kw 2024 22:46:23";" Zamknięcie Transakcji";"O2-CR-8YKYPK";"T2-CR-5D790M";"O2-CR-8YKXZ7";"Solana (USD)";"42 Jednost.";"193,055";"-";"-";"-";"-";"3,9791";"32 588,04";"1,67";"16 421,95";"-";"-";"-";"-";"-";"-";"-";"-";"-";"-";"-";"-";"-";"-";"-";"-";"-";"-";"-";"-";"-";"-";"-";"-"
"01 Kw 2024 22:05:46";" Transakcja Kupna";"O2-CR-8YKXZ7";"T2-CR-5D78CD";"-";"Solana (USD)";"42 Jednost.";"193,045";"-";"-";"-";"-";"4,019222";"32 587,40";"0,00";"-";"-";"-";"-";"-";"-";"-";"-";"-";"-";"-";"-";"-";"-";"-";"-";"-";"-";"-";"-";"-";"-";"-";"-";"-"
"01 Kw 2024 21:58:10";"Stop Loss";"O2-CR-8YKWQ1";"T2-CR-5D781F";"-";"Solana (USD)";"42 Jednost.";"193,295";"-";"-";"-";"-";"3,97931";"32 630,26";"111,98";"16 420,28";"-";"-";"-";"-";"-";"-";"-";"-";"-";"-";"-";"-";"-";"-";"-";"-";"-";"-";"-";"-";"-";"-";"-";"-"
"01 Kw 2024 21:58:00";"Zmodyfikowano Stop Loss";"O2-CR-8YKWQ1";"-";"O2-CR-8YKXLD";"Solana (USD)";"42 Jednost.";"192,625";"-";"193,300";"-";"-";"-";"-";"-";"-";"-";"-";"-";"-";"-";"-";"-";"-";"-";"-";"-";"-";"-";"-";"-";"-";"-";"-";"-";"-";"-";"-";"-";"-"
"01 Kw 2024 21:57:20";" Zmodyfikowano Transakcję Kupna";"O2-CR-8YKWQ1";"T2-CR-5D771X";"-";"Solana (USD)";"42 Jednost.";"192,625";"-";"193,200";"-";"-";"-";"-";"0,00";"-";"-";"-";"-";"-";"-";"-";"-";"-";"-";"-";"-";"-";"-";"-";"-";"-";"-";"-";"-";"-";"-";"-";"-";"-"
"01 Kw 2024 21:33:23";" Transakcja Kupna";"O2-CR-8YKWQ1";"T2-CR-5D771X";"-";"Solana (USD)";"42 Jednost.";"192,625";"-";"-";"-";"-";"4,020104";"32 523,64";"0,00";"-";"-";"-";"-";"-";"-";"-";"-";"-";"-";"-";"-";"-";"-";"-";"-";"-";"-";"-";"-";"-";"-";"-";"-";"-"
"01 Kw 2024 21:28:36";" Zamknięcie Transakcji";"O2-CR-8YKWJF";"T2-CR-5D76WJ";"O2-CR-8YKW8K";"Solana (USD)";"42 Jednost.";"191,795";"-";"-";"-";"-";"3,98";"32 382,70";"43,80";"16 308,30";"-";"-";"-";"-";"-";"-";"-";"-";"-";"-";"-";"-";"-";"-";"-";"-";"-";"-";"-";"-";"-";"-";"-";"-"
"01 Kw 2024 21:16:22";" Transakcja Kupna";"O2-CR-8YKW8K";"T2-CR-5D76M8";"-";"Solana (USD)";"42 Jednost.";"191,533";"-";"-";"-";"-";"4,019583";"32 335,07";"0,00";"-";"-";"-";"-";"-";"-";"-";"-";"-";"-";"-";"-";"-";"-";"-";"-";"-";"-";"-";"-";"-";"-";"-";"-";"-"
"01 Kw 2024 21:13:53";" Zamknięcie Transakcji";"O2-CR-8YKW5T";"T2-CR-5D76K9";"O2-CR-8YKW3E";"Solana (USD)";"42 Jednost.";"191,000";"-";"-";"-";"-";"3,97943";"32 243,80";"85,74";"16 264,50";"-";"-";"-";"-";"-";"-";"-";"-";"-";"-";"-";"-";"-";"-";"-";"-";"-";"-";"-";"-";"-";"-";"-";"-"
"01 Kw 2024 21:11:11";" Transakcja Kupna";"O2-CR-8YKW3E";"T2-CR-5D76H7";"-";"Solana (USD)";"42 Jednost.";"190,487";"-";"-";"-";"-";"4,019422";"32 157,20";"0,00";"-";"-";"-";"-";"-";"-";"-";"-";"-";"-";"-";"-";"-";"-";"-";"-";"-";"-";"-";"-";"-";"-";"-";"-";"-"
"01 Kw 2024 21:07:13";" Zamknięcie Transakcji";"O2-CR-8YKVYV";"T2-CR-5D76D6";"O2-CR-8YKVLX";"Solana (USD)";"42 Jednost.";"189,965";"-";"-";"-";"-";"3,97949";"32 069,56";"61,84";"16 178,76";"-";"-";"-";"-";"-";"-";"-";"-";"-";"-";"-";"-";"-";"-";"-";"-";"-";"-";"-";"-";"-";"-";"-";"-"
"01 Kw 2024 20:57:19";" Transakcja Kupna";"O2-CR-8YKVLX";"T2-CR-5D761H";"-";"Solana (USD)";"42 Jednost.";"189,595";"-";"-";"-";"-";"4,021406";"32 022,41";"0,00";"-";"-";"-";"-";"-";"-";"-";"-";"-";"-";"-";"-";"-";"-";"-";"-";"-";"-";"-";"-";"-";"-";"-";"-";"-"
"01 Kw 2024 00:03:16";" Zamknięcie Transakcji";"O2-CR-8YJGBT";"T2-CR-5D60TD";"O2-CR-8YGZ6Z";"Solana (USD)";"38,4 Jednost.";"199,895";"-";"-";"-";"-";"3,96191";"30 717,20";"1 706,22";"16 116,92";"-";"-";"-";"-";"-";"-";"-";"-";"-";"-";"-";"-";"-";"-";"-";"-";"-";"-";"-";"-";"-";"-";"-";"-"
"01 Kw 2024 00:02:20";"Zmodyfikowano Stop Loss";"O2-CR-8YGZ6Z";"-";"O2-CR-8YJG4Y";"Solana (USD)";"38,4 Jednost.";"188,680";"-";"199,600";"-";"-";"-";"-";"-";"-";"-";"-";"-";"-";"-";"-";"-";"-";"-";"-";"-";"-";"-";"-";"-";"-";"-";"-";"-";"-";"-";"-";"-";"-"
"01 Kw 2024 00:01:45";" Zmodyfikowano Transakcję Kupna";"O2-CR-8YGZ6Z";"T2-CR-5D5ZFK";"-";"Solana (USD)";"38,4 Jednost.";"188,680";"-";"199,400";"-";"-";"-";"-";"0,00";"-";"-";"-";"-";"-";"-";"-";"-";"-";"-";"-";"-";"-";"-";"-";"-";"-";"-";"-";"-";"-";"-";"-";"-";"-"
"29 Mar 2024 22:01:07";"Koszty Utrzymania Pozycji";"1321835234";"-";"-";"Rachunek";"-";"-";"-";"-";"-";"-";"-";"-";"-65,18";"14 410,70";"-";"-";"-";"-";"-";"-65,18";"-";"-";"-";"-";"-";"-";"-";"-";"-";"-";"-";"-";"-";"-";"-";"-";"-";"-"
"29 Mar 2024 22:01:07";"Koszty Utrzymania Pozycji";"O2-CR-8YGZ6Z";"-";"-";"Solana (USD)";"-";"-";"-";"-";"-";"-";"-";"-";"-";"-";"-";"-";"7 192,89";"-27,50000%";"-65,18";"-65,18";"-";"-";"-";"-";"-";"-";"-";"-";"-";"-";"-";"-";"-";"-";"-";"-";"-";"-"
"28 Mar 2024 22:10:36";" Transakcja Kupna";"O2-CR-8YGZ6Z";"T2-CR-5D5ZFK";"-";"Solana (USD)";"38,4 Jednost.";"188,680";"-";"-";"-";"-";"4,009673";"29 051,33";"0,00";"-";"-";"-";"-";"-";"-";"-";"-";"-";"-";"-";"-";"-";"-";"-";"-";"-";"-";"-";"-";"-";"-";"-";"-";"-"
"28 Mar 2024 22:06:40";"Stop Loss";"O2-CR-8YGZ1N";"T2-CR-5D5ZBB";"-";"Solana (USD)";"38 Jednost.";"188,100";"-";"-";"-";"-";"3,96953";"28 658,54";"28,66";"14 475,88";"-";"-";"-";"-";"-";"-";"-";"-";"-";"-";"-";"-";"-";"-";"-";"-";"-";"-";"-";"-";"-";"-";"-";"-"
"28 Mar 2024 22:06:06";"Zmodyfikowano Stop Loss";"O2-CR-8YGZ1N";"-";"O2-CR-8YGZ28";"Solana (USD)";"38 Jednost.";"187,910";"-";"188,100";"-";"-";"-";"-";"-";"-";"-";"-";"-";"-";"-";"-";"-";"-";"-";"-";"-";"-";"-";"-";"-";"-";"-";"-";"-";"-";"-";"-";"-";"-"
"28 Mar 2024 22:03:37";" Zmodyfikowano Transakcję Kupna";"O2-CR-8YGZ1N";"T2-CR-5D5Z9T";"-";"Solana (USD)";"38 Jednost.";"187,910";"-";"188,000";"-";"-";"-";"-";"0,00";"-";"-";"-";"-";"-";"-";"-";"-";"-";"-";"-";"-";"-";"-";"-";"-";"-";"-";"-";"-";"-";"-";"-";"-";"-"
"28 Mar 2024 22:00:49";" Transakcja Kupna";"O2-CR-8YGZ1N";"T2-CR-5D5Z9T";"-";"Solana (USD)";"38 Jednost.";"187,910";"-";"-";"-";"-";"4,012068";"28 648,49";"0,00";"-";"-";"-";"-";"-";"-";"-";"-";"-";"-";"-";"-";"-";"-";"-";"-";"-";"-";"-";"-";"-";"-";"-";"-";"-"
"28 Mar 2024 21:47:28";"Stop Loss";"O2-CR-8YGXJ3";"T2-CR-5D5YP9";"-";"Solana (USD)";"36 Jednost.";"187,815";"-";"-";"-";"-";"3,97347";"27 135,96";"65,80";"14 447,22";"-";"-";"-";"-";"-";"-";"-";"-";"-";"-";"-";"-";"-";"-";"-";"-";"-";"-";"-";"-";"-";"-";"-";"-"
"28 Mar 2024 21:43:14";"Zmodyfikowano Stop Loss";"O2-CR-8YGXJ3";"-";"O2-CR-8YGY9P";"Solana (USD)";"36 Jednost.";"187,355";"-";"187,850";"-";"-";"-";"-";"-";"-";"-";"-";"-";"-";"-";"-";"-";"-";"-";"-";"-";"-";"-";"-";"-";"-";"-";"-";"-";"-";"-";"-";"-";"-"
"28 Mar 2024 21:42:10";"Zmodyfikowano Stop Loss";"O2-CR-8YGXJ3";"-";"O2-CR-8YGY9P";"Solana (USD)";"36 Jednost.";"187,355";"-";"187,750";"-";"-";"-";"-";"-";"-";"-";"-";"-";"-";"-";"-";"-";"-";"-";"-";"-";"-";"-";"-";"-";"-";"-";"-";"-";"-";"-";"-";"-";"-"
"28 Mar 2024 21:40:08";" Zmodyfikowano Transakcję Kupna";"O2-CR-8YGXJ3";"T2-CR-5D5XXE";"-";"Solana (USD)";"36 Jednost.";"187,355";"-";"187,550";"-";"-";"-";"-";"0,00";"-";"-";"-";"-";"-";"-";"-";"-";"-";"-";"-";"-";"-";"-";"-";"-";"-";"-";"-";"-";"-";"-";"-";"-";"-"
"28 Mar 2024 21:05:53";" Transakcja Kupna";"O2-CR-8YGXJ3";"T2-CR-5D5XXE";"-";"Solana (USD)";"36 Jednost.";"187,355";"-";"-";"-";"-";"4,014733";"27 078,49";"0,00";"-";"-";"-";"-";"-";"-";"-";"-";"-";"-";"-";"-";"-";"-";"-";"-";"-";"-";"-";"-";"-";"-";"-";"-";"-"
"28 Mar 2024 19:39:38";"Stop Loss";"O2-CR-8YGRW2";"T2-CR-5D5SSX";"-";"Solana (USD)";"36 Jednost.";"186,185";"-";"-";"-";"-";"3,97057";"26 880,85";"12,86";"14 381,42";"-";"-";"-";"-";"-";"-";"-";"-";"-";"-";"-";"-";"-";"-";"-";"-";"-";"-";"-";"-";"-";"-";"-";"-"
"28 Mar 2024 19:38:15";"Zmodyfikowano Transakcję Sprzedaży";"O2-CR-8YGRW2";"T2-CR-5D5SHJ";"-";"Solana (USD)";"36 Jednost.";"186,275";"-";"186,180";"185,400";"-";"-";"-";"0,00";"-";"-";"-";"-";"-";"-";"-";"-";"-";"-";"-";"-";"-";"-";"-";"-";"-";"-";"-";"-";"-";"-";"-";"-";"-"
"28 Mar 2024 19:36:57";"Zmodyfikowano Transakcję Sprzedaży";"O2-CR-8YGRW2";"T2-CR-5D5SHJ";"-";"Solana (USD)";"36 Jednost.";"186,275";"-";"-";"185,400";"-";"-";"-";"0,00";"-";"-";"-";"-";"-";"-";"-";"-";"-";"-";"-";"-";"-";"-";"-";"-";"-";"-";"-";"-";"-";"-";"-";"-";"-"
"28 Mar 2024 19:32:46";"Transakcja Sprzedaży";"O2-CR-8YGRW2";"T2-CR-5D5SHJ";"-";"Solana (USD)";"36 Jednost.";"186,275";"-";"-";"-";"-";"4,010605";"26 894,71";"0,00";"-";"-";"-";"-";"-";"-";"-";"-";"-";"-";"-";"-";"-";"-";"-";"-";"-";"-";"-";"-";"-";"-";"-";"-";"-"
"28 Mar 2024 18:03:23";"Take Profit";"O2-CR-8YG5DJ";"T2-CR-5D5PFR";"-";"Solana (USD)";"35 Jednost.";"185,000";"-";"-";"-";"-";"3,965";"25 931,35";"40,66";"14 368,56";"-";"-";"-";"-";"-";"-";"-";"-";"-";"-";"-";"-";"-";"-";"-";"-";"-";"-";"-";"-";"-";"-";"-";"-"
"28 Mar 2024 17:50:06";"Zmodyfikowano Transakcję Sprzedaży";"O2-CR-8YG5DJ";"T2-CR-5D59GD";"-";"Solana (USD)";"35 Jednost.";"185,293";"-";"-";"185,000";"-";"-";"-";"0,00";"-";"-";"-";"-";"-";"-";"-";"-";"-";"-";"-";"-";"-";"-";"-";"-";"-";"-";"-";"-";"-";"-";"-";"-";"-"
"28 Mar 2024 14:54:05";"Transakcja Sprzedaży";"O2-CR-8YG5DJ";"T2-CR-5D59GD";"-";"Solana (USD)";"35 Jednost.";"185,293";"-";"-";"-";"-";"4,004332";"25 969,11";"0,00";"-";"-";"-";"-";"-";"-";"-";"-";"-";"-";"-";"-";"-";"-";"-";"-";"-";"-";"-";"-";"-";"-";"-";"-";"-"
"28 Mar 2024 14:38:10";" Zamknięcie Transakcji";"O2-CR-8YG37N";"T2-CR-5D57QQ";"O2-CR-8YG2R1";"Solana (USD)";"35 Jednost.";"184,745";"-";"-";"-";"-";"3,96972";"25 926,52";"82,67";"14 327,90";"-";"-";"-";"-";"-";"-";"-";"-";"-";"-";"-";"-";"-";"-";"-";"-";"-";"-";"-";"-";"-";"-";"-";"-"
"28 Mar 2024 14:34:56";"Transakcja Sprzedaży";"O2-CR-8YG2R1";"T2-CR-5D57E2";"-";"Solana (USD)";"35 Jednost.";"185,340";"-";"-";"-";"-";"4,00823";"26 000,98";"0,00";"-";"-";"-";"-";"-";"-";"-";"-";"-";"-";"-";"-";"-";"-";"-";"-";"-";"-";"-";"-";"-";"-";"-";"-";"-"
"28 Mar 2024 14:29:00";" Zamknięcie Transakcji";"O2-CR-8YG1T1";"T2-CR-5D56NH";"O2-CR-8YFZDW";"Solana (USD)";"36 Jednost.";"184,642";"-";"-";"-";"-";"3,971";"26 660,93";"54,61";"14 245,23";"-";"-";"-";"-";"-";"-";"-";"-";"-";"-";"-";"-";"-";"-";"-";"-";"-";"-";"-";"-";"-";"-";"-";"-"
"28 Mar 2024 14:14:13";" Zmodyfikowano Transakcję Kupna";"O2-CR-8YFZDW";"T2-CR-5D54XW";"-";"Solana (USD)";"36 Jednost.";"184,260";"-";"-";"187,400";"-";"-";"-";"0,00";"-";"-";"-";"-";"-";"-";"-";"-";"-";"-";"-";"-";"-";"-";"-";"-";"-";"-";"-";"-";"-";"-";"-";"-";"-"
"28 Mar 2024 14:00:11";" Transakcja Kupna";"O2-CR-8YFZDW";"T2-CR-5D54XW";"-";"Solana (USD)";"36 Jednost.";"184,260";"-";"-";"-";"-";"4,008561";"26 590,22";"0,00";"-";"-";"-";"-";"-";"-";"-";"-";"-";"-";"-";"-";"-";"-";"-";"-";"-";"-";"-";"-";"-";"-";"-";"-";"-"
"28 Mar 2024 13:59:39";" Zamknięcie Transakcji";"O2-CR-8YFZ9F";"T2-CR-5D54VE";"O2-CR-8YFYQM";"Solana (USD)";"37 Jednost.";"184,190";"-";"-";"-";"-";"4,0084";"27 317,36";"-131,26";"14 190,62";"-";"-";"-";"-";"-";"-";"-";"-";"-";"-";"-";"-";"-";"-";"-";"-";"-";"-";"-";"-";"-";"-";"-";"-"
"28 Mar 2024 13:55:12";"Transakcja Sprzedaży";"O2-CR-8YFYQM";"T2-CR-5D54C9";"-";"Solana (USD)";"37 Jednost.";"183,305";"-";"-";"-";"-";"4,012138";"27 211,46";"0,00";"-";"-";"-";"-";"-";"-";"-";"-";"-";"-";"-";"-";"-";"-";"-";"-";"-";"-";"-";"-";"-";"-";"-";"-";"-"
"28 Mar 2024 13:53:17";" Zamknięcie Transakcji";"O2-CR-8YFYK3";"T2-CR-5D547V";"O2-CR-8YFYH0";"Solana (USD)";"38 Jednost.";"182,843";"-";"-";"-";"-";"4,01319";"27 883,78";"-36,91";"14 321,88";"-";"-";"-";"-";"-";"-";"-";"-";"-";"-";"-";"-";"-";"-";"-";"-";"-";"-";"-";"-";"-";"-";"-";"-"
"28 Mar 2024 13:52:44";" Transakcja Kupna";"O2-CR-8YFYH0";"T2-CR-5D546D";"-";"Solana (USD)";"38 Jednost.";"183,085";"-";"-";"-";"-";"4,012769";"27 917,75";"0,00";"-";"-";"-";"-";"-";"-";"-";"-";"-";"-";"-";"-";"-";"-";"-";"-";"-";"-";"-";"-";"-";"-";"-";"-";"-"
"28 Mar 2024 12:41:15";" Zamknięcie Transakcji";"O2-CR-8YFSJX";"T2-CR-5D50W3";"O2-CR-8YFPEC";"Solana (USD)";"38 Jednost.";"184,965";"-";"-";"-";"-";"3,97923";"28 249,78";"102,07";"14 358,79";"-";"-";"-";"-";"-";"-";"-";"-";"-";"-";"-";"-";"-";"-";"-";"-";"-";"-";"-";"-";"-";"-";"-";"-"
"28 Mar 2024 11:39:46";"Transakcja Sprzedaży";"O2-CR-8YFPEC";"T2-CR-5D4YFH";"-";"Solana (USD)";"38 Jednost.";"185,640";"-";"-";"-";"-";"4,020054";"28 358,74";"0,00";"-";"-";"-";"-";"-";"-";"-";"-";"-";"-";"-";"-";"-";"-";"-";"-";"-";"-";"-";"-";"-";"-";"-";"-";"-"
"28 Mar 2024 11:25:34";" Zamknięcie Transakcji";"O2-CR-8YFNEE";"T2-CR-5D4XQD";"O2-CR-8YFMSL";"Solana (USD)";"36 Jednost.";"185,795";"-";"-";"-";"-";"3,98379";"26 913,80";"81,03";"14 256,72";"-";"-";"-";"-";"-";"-";"-";"-";"-";"-";"-";"-";"-";"-";"-";"-";"-";"-";"-";"-";"-";"-";"-";"-"
"28 Mar 2024 11:15:41";"Transakcja Sprzedaży";"O2-CR-8YFMSL";"T2-CR-5D4X3W";"-";"Solana (USD)";"36 Jednost.";"186,360";"-";"-";"-";"-";"4,025294";"27 005,53";"0,00";"-";"-";"-";"-";"-";"-";"-";"-";"-";"-";"-";"-";"-";"-";"-";"-";"-";"-";"-";"-";"-";"-";"-";"-";"-"
"28 Mar 2024 11:14:53";" Zamknięcie Transakcji";"O2-CR-8YFMQY";"T2-CR-5D4X2R";"O2-CR-8YE9W2";"Solana (USD)";"36 Jednost.";"186,440";"-";"-";"-";"-";"3,98565";"27 019,95";"58,83";"14 175,69";"-";"-";"-";"-";"-";"-";"-";"-";"-";"-";"-";"-";"-";"-";"-";"-";"-";"-";"-";"-";"-";"-";"-";"-"
"27 Mar 2024 22:01:13";"Koszty Utrzymania Pozycji";"1321270945";"-";"-";"Rachunek";"-";"-";"-";"-";"-";"-";"-";"-";"-20,10";"14 116,86";"-";"-";"-";"-";"-";"-20,10";"-";"-";"-";"-";"-";"-";"-";"-";"-";"-";"-";"-";"-";"-";"-";"-";"-";"-"
"27 Mar 2024 22:01:13";"Koszty Utrzymania Pozycji";"O2-CR-8YE9W2";"-";"-";"Solana (USD)";"-";"-";"-";"-";"-";"-";"-";"-";"-";"-";"-";"-";"6 661,44";"-27,50000%";"-20,10";"-20,10";"-";"-";"-";"-";"-";"-";"-";"-";"-";"-";"-";"-";"-";"-";"-";"-";"-";"-"
"27 Mar 2024 16:18:11";"Zmodyfikowano Take Profit";"O2-CR-8YE9W2";"-";"O2-CR-8YEB0S";"Solana (USD)";"36 Jednost.";"186,030";"-";"-";"190,000";"-";"-";"-";"-";"-";"-";"-";"-";"-";"-";"-";"-";"-";"-";"-";"-";"-";"-";"-";"-";"-";"-";"-";"-";"-";"-";"-";"-";"-"
"27 Mar 2024 15:41:53";" Zmodyfikowano Transakcję Kupna";"O2-CR-8YE9W2";"T2-CR-5D3QV6";"-";"Solana (USD)";"36 Jednost.";"186,030";"-";"-";"188,000";"-";"-";"-";"0,00";"-";"-";"-";"-";"-";"-";"-";"-";"-";"-";"-";"-";"-";"-";"-";"-";"-";"-";"-";"-";"-";"-";"-";"-";"-"
"27 Mar 2024 15:40:29";" Transakcja Kupna";"O2-CR-8YE9W2";"T2-CR-5D3QV6";"-";"Solana (USD)";"36 Jednost.";"186,030";"-";"-";"-";"-";"4,011617";"26 866,11";"0,00";"-";"-";"-";"-";"-";"-";"-";"-";"-";"-";"-";"-";"-";"-";"-";"-";"-";"-";"-";"-";"-";"-";"-";"-";"-"
"27 Mar 2024 15:36:16";" Zamknięcie Transakcji";"O2-CR-8YE9EP";"T2-CR-5D3QF9";"O2-CR-8YE9CQ";"Solana (USD)";"36 Jednost.";"184,855";"-";"-";"-";"-";"3,97137";"26 694,15";"17,87";"14 136,96";"-";"-";"-";"-";"-";"-";"-";"-";"-";"-";"-";"-";"-";"-";"-";"-";"-";"-";"-";"-";"-";"-";"-";"-"
"27 Mar 2024 15:35:28";" Transakcja Kupna";"O2-CR-8YE9CQ";"T2-CR-5D3QDF";"-";"Solana (USD)";"36 Jednost.";"184,730";"-";"-";"-";"-";"4,010635";"26 671,84";"0,00";"-";"-";"-";"-";"-";"-";"-";"-";"-";"-";"-";"-";"-";"-";"-";"-";"-";"-";"-";"-";"-";"-";"-";"-";"-"
"27 Mar 2024 15:23:43";" Zamknięcie Transakcji";"O2-CR-8YE854";"T2-CR-5D3PBW";"O2-CR-8YE7K0";"Solana (USD)";"36 Jednost.";"185,110";"-";"-";"-";"-";"3,9716";"26 732,52";"205,17";"14 119,09";"-";"-";"-";"-";"-";"-";"-";"-";"-";"-";"-";"-";"-";"-";"-";"-";"-";"-";"-";"-";"-";"-";"-";"-"
"27 Mar 2024 15:22:37";" Zmodyfikowano Transakcję Kupna";"O2-CR-8YE7K0";"T2-CR-5D3NT7";"-";"Solana (USD)";"36 Jednost.";"183,675";"-";"183,980";"-";"-";"-";"-";"0,00";"-";"-";"-";"-";"-";"-";"-";"-";"-";"-";"-";"-";"-";"-";"-";"-";"-";"-";"-";"-";"-";"-";"-";"-";"-"
"27 Mar 2024 15:18:17";" Transakcja Kupna";"O2-CR-8YE7K0";"T2-CR-5D3NT7";"-";"Solana (USD)";"36 Jednost.";"183,675";"-";"-";"-";"-";"4,011617";"26 526,01";"0,00";"-";"-";"-";"-";"-";"-";"-";"-";"-";"-";"-";"-";"-";"-";"-";"-";"-";"-";"-";"-";"-";"-";"-";"-";"-"
"25 Mar 2024 21:09:44";" Zamknięcie Transakcji";"O2-CR-8YB1TH";"T2-CR-5D0ZZS";"O2-CR-8Y9YT8";"Solana (USD)";"30 Jednost.";"192,555";"-";"-";"-";"-";"3,95515";"23 077,15";"13,05";"13 913,92";"-";"-";"-";"-";"-";"-";"-";"-";"-";"-";"-";"-";"-";"-";"-";"-";"-";"-";"-";"-";"-";"-";"-";"-"
"25 Mar 2024 19:40:40";" Transakcja Kupna";"O2-CR-8Y9YT8";"T2-CR-5D0WXG";"-";"Solana (USD)";"30 Jednost.";"192,445";"-";"-";"-";"-";"3,994873";"23 063,80";"0,00";"-";"-";"-";"-";"-";"-";"-";"-";"-";"-";"-";"-";"-";"-";"-";"-";"-";"-";"-";"-";"-";"-";"-";"-";"-"
"25 Mar 2024 19:39:24";" Zamknięcie Transakcji";"O2-CR-8Y9YRV";"T2-CR-5D0WWC";"O2-CR-8Y9TM2";"Solana (USD)";"20 Jednost.";"192,500";"-";"-";"-";"-";"3,95509";"15 380,10";"22,54";"13 900,87";"-";"-";"-";"-";"-";"-";"-";"-";"-";"-";"-";"-";"-";"-";"-";"-";"-";"-";"-";"-";"-";"-";"-";"-"
"25 Mar 2024 19:39:18";" Zamknięcie Transakcji";"O2-CR-8Y9YRP";"T2-CR-5D0WW8";"O2-CR-8Y9WBH";"Solana (USD)";"5 Jednost.";"192,530";"-";"-";"-";"-";"3,95509";"3 845,62";"24,42";"13 878,33";"-";"-";"-";"-";"-";"-";"-";"-";"-";"-";"-";"-";"-";"-";"-";"-";"-";"-";"-";"-";"-";"-";"-";"-"
"25 Mar 2024 19:39:05";" Zamknięcie Transakcji";"O2-CR-8Y9YRB";"T2-CR-5D0WVY";"O2-CR-8Y9STN";"Solana (USD)";"10 Jednost.";"192,550";"-";"-";"-";"-";"3,994733";"7 691,85";"-73,10";"13 853,91";"-";"-";"-";"-";"-";"-";"-";"-";"-";"-";"-";"-";"-";"-";"-";"-";"-";"-";"-";"-";"-";"-";"-";"-"
"25 Mar 2024 19:20:37";"Zmodyfikowano Transakcję Sprzedaży";"O2-CR-8Y9WBH";"T2-CR-5D0TSV";"-";"Solana (USD)";"5 Jednost.";"193,765";"-";"-";"189,900";"-";"-";"-";"0,00";"-";"-";"-";"-";"-";"-";"-";"-";"-";"-";"-";"-";"-";"-";"-";"-";"-";"-";"-";"-";"-";"-";"-";"-";"-"
"25 Mar 2024 19:20:17";"Zmodyfikowano Transakcję Sprzedaży";"O2-CR-8Y9TM2";"T2-CR-5D0SBH";"-";"Solana (USD)";"20 Jednost.";"192,785";"-";"-";"189,900";"-";"-";"-";"0,00";"-";"-";"-";"-";"-";"-";"-";"-";"-";"-";"-";"-";"-";"-";"-";"-";"-";"-";"-";"-";"-";"-";"-";"-";"-"
"25 Mar 2024 19:19:50";"Zmodyfikowano Transakcję Sprzedaży";"O2-CR-8Y9STN";"T2-CR-5D0RN6";"-";"Solana (USD)";"10 Jednost.";"190,720";"-";"-";"189,900";"-";"-";"-";"0,00";"-";"-";"-";"-";"-";"-";"-";"-";"-";"-";"-";"-";"-";"-";"-";"-";"-";"-";"-";"-";"-";"-";"-";"-";"-"
"25 Mar 2024 18:25:11";"Transakcja Sprzedaży";"O2-CR-8Y9WBH";"T2-CR-5D0TSV";"-";"Solana (USD)";"5 Jednost.";"193,765";"-";"-";"-";"-";"3,994062";"3 869,54";"0,00";"-";"-";"-";"-";"-";"-";"-";"-";"-";"-";"-";"-";"-";"-";"-";"-";"-";"-";"-";"-";"-";"-";"-";"-";"-"
"25 Mar 2024 17:44:50";"Transakcja Sprzedaży";"O2-CR-8Y9TM2";"T2-CR-5D0SBH";"-";"Solana (USD)";"20 Jednost.";"192,785";"-";"-";"-";"-";"3,993761";"15 398,74";"0,00";"-";"-";"-";"-";"-";"-";"-";"-";"-";"-";"-";"-";"-";"-";"-";"-";"-";"-";"-";"-";"-";"-";"-";"-";"-"
"25 Mar 2024 17:29:09";"Transakcja Sprzedaży";"O2-CR-8Y9STN";"T2-CR-5D0RN6";"-";"Solana (USD)";"10 Jednost.";"190,720";"-";"-";"-";"-";"3,993621";"7 616,63";"0,00";"-";"-";"-";"-";"-";"-";"-";"-";"-";"-";"-";"-";"-";"-";"-";"-";"-";"-";"-";"-";"-";"-";"-";"-";"-"
"25 Mar 2024 17:26:23";"Take Profit";"O2-CR-8Y9G1X";"T2-CR-5D0RJP";"-";"Solana (USD)";"20 Jednost.";"191,000";"-";"-";"-";"-";"3,95437";"15 257,46";"17,79";"13 927,01";"-";"-";"-";"-";"-";"-";"-";"-";"-";"-";"-";"-";"-";"-";"-";"-";"-";"-";"-";"-";"-";"-";"-";"-"
"25 Mar 2024 17:22:06";"Zmodyfikowano Transakcję Sprzedaży";"O2-CR-8Y9G1X";"T2-CR-5D0F1T";"-";"Solana (USD)";"20 Jednost.";"191,225";"-";"-";"191,000";"-";"-";"-";"0,00";"-";"-";"-";"-";"-";"-";"-";"-";"-";"-";"-";"-";"-";"-";"-";"-";"-";"-";"-";"-";"-";"-";"-";"-";"-"
"25 Mar 2024 15:40:13";" Zamknięcie Transakcji";"O2-CR-8Y9KEG";"T2-CR-5D0JZ3";"O2-CR-8Y9H21";"Solana (USD)";"14 Jednost.";"192,393";"-";"-";"-";"-";"3,95729";"10 766,08";"21,72";"13 909,22";"-";"-";"-";"-";"-";"-";"-";"-";"-";"-";"-";"-";"-";"-";"-";"-";"-";"-";"-";"-";"-";"-";"-";"-"
"25 Mar 2024 15:18:37";"Transakcja Sprzedaży";"O2-CR-8Y9H21";"T2-CR-5D0GBG";"-";"Solana (USD)";"14 Jednost.";"192,785";"-";"-";"-";"-";"3,997248";"10 788,53";"0,00";"-";"-";"-";"-";"-";"-";"-";"-";"-";"-";"-";"-";"-";"-";"-";"-";"-";"-";"-";"-";"-";"-";"-";"-";"-"
"25 Mar 2024 15:10:16";"Transakcja Sprzedaży";"O2-CR-8Y9G1X";"T2-CR-5D0F1T";"-";"Solana (USD)";"20 Jednost.";"191,225";"-";"-";"-";"-";"3,998571";"15 292,53";"0,00";"-";"-";"-";"-";"-";"-";"-";"-";"-";"-";"-";"-";"-";"-";"-";"-";"-";"-";"-";"-";"-";"-";"-";"-";"-"
"25 Mar 2024 15:08:47";" Zamknięcie Transakcji";"O2-CR-8Y9FSC";"T2-CR-5D0ESH";"O2-CR-8Y9EV7";"Solana (USD)";"20 Jednost.";"191,325";"-";"-";"-";"-";"3,95859";"15 299,80";"7,13";"13 887,50";"-";"-";"-";"-";"-";"-";"-";"-";"-";"-";"-";"-";"-";"-";"-";"-";"-";"-";"-";"-";"-";"-";"-";"-"
"25 Mar 2024 15:01:05";" Transakcja Kupna";"O2-CR-8Y9EV7";"T2-CR-5D0DYH";"-";"Solana (USD)";"20 Jednost.";"191,235";"-";"-";"-";"-";"3,99824";"15 292,06";"0,00";"-";"-";"-";"-";"-";"-";"-";"-";"-";"-";"-";"-";"-";"-";"-";"-";"-";"-";"-";"-";"-";"-";"-";"-";"-"
"25 Mar 2024 13:31:27";" Zamknięcie Transakcji";"O2-CR-8Y96VQ";"T2-CR-5D06KP";"O2-CR-8Y92BV";"Solana (USD)";"20 Jednost.";"187,861";"-";"-";"-";"-";"3,95711";"15 017,14";"129,32";"13 880,37";"-";"-";"-";"-";"-";"-";"-";"-";"-";"-";"-";"-";"-";"-";"-";"-";"-";"-";"-";"-";"-";"-";"-";"-"
"25 Mar 2024 13:31:18";" Zamknięcie Transakcji";"O2-CR-8Y96VF";"T2-CR-5D06KJ";"O2-CR-8Y94TP";"Solana (USD)";"15 Jednost.";"187,855";"-";"-";"-";"-";"3,95712";"11 262,52";"3,98";"13 751,05";"-";"-";"-";"-";"-";"-";"-";"-";"-";"-";"-";"-";"-";"-";"-";"-";"-";"-";"-";"-";"-";"-";"-";"-"
"25 Mar 2024 12:52:32";"Transakcja Sprzedaży";"O2-CR-8Y94TP";"T2-CR-5D04TY";"-";"Solana (USD)";"15 Jednost.";"187,922";"-";"-";"-";"-";"3,996887";"11 266,54";"0,00";"-";"-";"-";"-";"-";"-";"-";"-";"-";"-";"-";"-";"-";"-";"-";"-";"-";"-";"-";"-";"-";"-";"-";"-";"-"
"25 Mar 2024 11:58:47";"Transakcja Sprzedaży";"O2-CR-8Y92BV";"T2-CR-5D02QG";"-";"Solana (USD)";"20 Jednost.";"189,495";"-";"-";"-";"-";"4,000875";"15 162,91";"0,00";"-";"-";"-";"-";"-";"-";"-";"-";"-";"-";"-";"-";"-";"-";"-";"-";"-";"-";"-";"-";"-";"-";"-";"-";"-"
"25 Mar 2024 11:46:12";" Zamknięcie Transakcji";"O2-CR-8Y91PW";"T2-CR-5D02FS";"O2-CR-8Y91N7";"Solana (USD)";"20 Jednost.";"189,850";"-";"-";"-";"-";"3,96371";"15 201,44";"42,97";"13 747,07";"-";"-";"-";"-";"-";"-";"-";"-";"-";"-";"-";"-";"-";"-";"-";"-";"-";"-";"-";"-";"-";"-";"-";"-"
"25 Mar 2024 11:43:09";"Transakcja Sprzedaży";"O2-CR-8Y91N7";"T2-CR-5D02EM";"-";"Solana (USD)";"20 Jednost.";"190,392";"-";"-";"-";"-";"4,003941";"15 246,36";"0,00";"-";"-";"-";"-";"-";"-";"-";"-";"-";"-";"-";"-";"-";"-";"-";"-";"-";"-";"-";"-";"-";"-";"-";"-";"-"
"25 Mar 2024 11:22:10";"Take Profit";"O2-CR-8Y33HM";"T2-CR-5D01X3";"-";"Solana (USD)";"36 Jednost.";"191,500";"-";"-";"-";"-";"3,95945";"27 570,77";"42,76";"13 704,10";"-";"-";"-";"-";"-";"-";"-";"-";"-";"-";"-";"-";"-";"-";"-";"-";"-";"-";"-";"-";"-";"-";"-";"-"
"22 Mar 2024 22:01:07";"Koszty Utrzymania Pozycji";"1320060314";"-";"-";"Rachunek";"-";"-";"-";"-";"-";"-";"-";"-";"-55,95";"13 661,34";"-";"-";"-";"-";"-";"-55,95";"-";"-";"-";"-";"-";"-";"-";"-";"-";"-";"-";"-";"-";"-";"-";"-";"-";"-"
"22 Mar 2024 22:01:07";"Koszty Utrzymania Pozycji";"O2-CR-8Y33HM";"-";"-";"Solana (USD)";"-";"-";"-";"-";"-";"-";"-";"-";"-";"-";"-";"-";"6 160,86";"-27,50000%";"-55,95";"-55,95";"-";"-";"-";"-";"-";"-";"-";"-";"-";"-";"-";"-";"-";"-";"-";"-";"-";"-"
"21 Mar 2024 22:01:13";"Koszty Utrzymania Pozycji";"1319647635";"-";"-";"Rachunek";"-";"-";"-";"-";"-";"-";"-";"-";"-19,42";"13 717,29";"-";"-";"-";"-";"-";"-19,42";"-";"-";"-";"-";"-";"-";"-";"-";"-";"-";"-";"-";"-";"-";"-";"-";"-";"-"
"21 Mar 2024 22:01:13";"Koszty Utrzymania Pozycji";"O2-CR-8Y33HM";"-";"-";"Solana (USD)";"-";"-";"-";"-";"-";"-";"-";"-";"-";"-";"-";"-";"6 464,70";"-27,50000%";"-19,42";"-19,42";"-";"-";"-";"-";"-";"-";"-";"-";"-";"-";"-";"-";"-";"-";"-";"-";"-";"-"
"21 Mar 2024 14:31:09";"Zmodyfikowano Take Profit";"O2-CR-8Y33HM";"-";"O2-CR-8Y34VM";"Solana (USD)";"36 Jednost.";"191,200";"-";"-";"191,500";"-";"-";"-";"-";"-";"-";"-";"-";"-";"-";"-";"-";"-";"-";"-";"-";"-";"-";"-";"-";"-";"-";"-";"-";"-";"-";"-";"-";"-"
"21 Mar 2024 00:11:04";" Zmodyfikowano Transakcję Kupna";"O2-CR-8Y33HM";"T2-CR-5CTVGX";"-";"Solana (USD)";"36 Jednost.";"191,200";"-";"-";"198,000";"-";"-";"-";"0,00";"-";"-";"-";"-";"-";"-";"-";"-";"-";"-";"-";"-";"-";"-";"-";"-";"-";"-";"-";"-";"-";"-";"-";"-";"-"
"20 Mar 2024 23:42:06";" Transakcja Kupna";"O2-CR-8Y33HM";"T2-CR-5CTVGX";"-";"Solana (USD)";"36 Jednost.";"191,200";"-";"-";"-";"-";"3,963541";"27 281,84";"0,00";"-";"-";"-";"-";"-";"-";"-";"-";"-";"-";"-";"-";"-";"-";"-";"-";"-";"-";"-";"-";"-";"-";"-";"-";"-"
"20 Mar 2024 23:03:54";" Zamknięcie Transakcji";"O2-CR-8Y314J";"T2-CR-5CTSCD";"O2-CR-8Y30XE";"Solana (USD)";"36 Jednost.";"191,260";"-";"-";"-";"-";"3,92759";"27 314,62";"203,61";"13 736,71";"-";"-";"-";"-";"-";"-";"-";"-";"-";"-";"-";"-";"-";"-";"-";"-";"-";"-";"-";"-";"-";"-";"-";"-"
"20 Mar 2024 22:55:42";" Transakcja Kupna";"O2-CR-8Y30XE";"T2-CR-5CTS5T";"-";"Solana (USD)";"36 Jednost.";"189,820";"-";"-";"-";"-";"3,965956";"27 101,43";"0,00";"-";"-";"-";"-";"-";"-";"-";"-";"-";"-";"-";"-";"-";"-";"-";"-";"-";"-";"-";"-";"-";"-";"-";"-";"-"
"20 Mar 2024 22:26:40";" Zamknięcie Transakcji";"O2-CR-8Y30MM";"T2-CR-5CTS0S";"O2-CR-8Y2ZT3";"Solana (USD)";"36 Jednost.";"188,295";"-";"-";"-";"-";"3,92938";"26 903,47";"45,27";"13 533,10";"-";"-";"-";"-";"-";"-";"-";"-";"-";"-";"-";"-";"-";"-";"-";"-";"-";"-";"-";"-";"-";"-";"-";"-"
"20 Mar 2024 22:00:59";"Koszty Utrzymania Pozycji";"1319109873";"-";"-";"Rachunek";"-";"-";"-";"-";"-";"-";"-";"-";"-20,07";"13 487,83";"-";"-";"-";"-";"-";"-20,07";"-";"-";"-";"-";"-";"-";"-";"-";"-";"-";"-";"-";"-";"-";"-";"-";"-";"-"
"20 Mar 2024 22:00:59";"Koszty Utrzymania Pozycji";"O2-CR-8Y2ZT3";"-";"-";"Solana (USD)";"-";"-";"-";"-";"-";"-";"-";"-";"-";"-";"-";"-";"6 718,32";"-27,50000%";"-20,07";"-20,07";"-";"-";"-";"-";"-";"-";"-";"-";"-";"-";"-";"-";"-";"-";"-";"-";"-";"-"
"20 Mar 2024 21:38:54";" Transakcja Kupna";"O2-CR-8Y2ZT3";"T2-CR-5CTRD6";"-";"Solana (USD)";"36 Jednost.";"187,975";"-";"-";"-";"-";"3,96821";"26 853,27";"0,00";"-";"-";"-";"-";"-";"-";"-";"-";"-";"-";"-";"-";"-";"-";"-";"-";"-";"-";"-";"-";"-";"-";"-";"-";"-"
"20 Mar 2024 21:14:53";" Zamknięcie Transakcji";"O2-CR-8Y2YQC";"T2-CR-5CTQF1";"O2-CR-8Y2YHV";"Solana (USD)";"35 Jednost.";"184,070";"-";"-";"-";"-";"3,92873";"25 565,05";"20,63";"13 507,90";"-";"-";"-";"-";"-";"-";"-";"-";"-";"-";"-";"-";"-";"-";"-";"-";"-";"-";"-";"-";"-";"-";"-";"-"
"20 Mar 2024 21:12:24";"Transakcja Sprzedaży";"O2-CR-8Y2YHV";"T2-CR-5CTQ7M";"-";"Solana (USD)";"35 Jednost.";"184,220";"-";"-";"-";"-";"3,96827";"25 586,21";"0,00";"-";"-";"-";"-";"-";"-";"-";"-";"-";"-";"-";"-";"-";"-";"-";"-";"-";"-";"-";"-";"-";"-";"-";"-";"-"
"20 Mar 2024 20:36:50";"Take Profit";"O2-CR-8Y2Q4F";"T2-CR-5CTLH2";"-";"Solana (USD)";"30 Jednost.";"182,237";"-";"-";"-";"-";"3,92913";"21 696,83";"49,86";"13 487,27";"-";"-";"-";"-";"-";"-";"-";"-";"-";"-";"-";"-";"-";"-";"-";"-";"-";"-";"-";"-";"-";"-";"-";"-"
"20 Mar 2024 20:34:01";"Zmodyfikowano Transakcję Sprzedaży";"O2-CR-8Y2Q4F";"T2-CR-5CTH73";"-";"Solana (USD)";"30 Jednost.";"182,660";"-";"-";"182,237";"-";"-";"-";"0,00";"-";"-";"-";"-";"-";"-";"-";"-";"-";"-";"-";"-";"-";"-";"-";"-";"-";"-";"-";"-";"-";"-";"-";"-";"-"
"20 Mar 2024 20:18:55";"Transakcja Sprzedaży";"O2-CR-8Y2Q4F";"T2-CR-5CTH73";"-";"Solana (USD)";"30 Jednost.";"182,660";"-";"-";"-";"-";"3,974342";"21 778,59";"0,00";"-";"-";"-";"-";"-";"-";"-";"-";"-";"-";"-";"-";"-";"-";"-";"-";"-";"-";"-";"-";"-";"-";"-";"-";"-"
"20 Mar 2024 19:55:34";"Take Profit";"O2-CR-8Y0LXK";"T2-CR-5CTCKE";"-";"Solana (USD)";"15 Jednost.";"183,000";"-";"-";"-";"-";"3,93322";"10 905,16";"288,50";"13 437,41";"-";"-";"-";"-";"-";"-";"-";"-";"-";"-";"-";"-";"-";"-";"-";"-";"-";"-";"-";"-";"-";"-";"-";"-"
"20 Mar 2024 19:55:34";"Take Profit";"O2-CR-8Y0LSL";"T2-CR-5CTCKD";"-";"Solana (USD)";"20 Jednost.";"183,000";"-";"-";"-";"-";"3,93322";"14 540,22";"370,90";"13 148,91";"-";"-";"-";"-";"-";"-";"-";"-";"-";"-";"-";"-";"-";"-";"-";"-";"-";"-";"-";"-";"-";"-";"-";"-"
"19 Mar 2024 22:01:05";"Koszty Utrzymania Pozycji";"1318656317";"-";"-";"Rachunek";"-";"-";"-";"-";"-";"-";"-";"-";"-18,41";"12 778,01";"-";"-";"-";"-";"-";"-18,41";"-";"-";"-";"-";"-";"-";"-";"-";"-";"-";"-";"-";"-";"-";"-";"-";"-";"-"
"19 Mar 2024 22:01:05";"Koszty Utrzymania Pozycji";"O2-CR-8Y0LSL";"-";"-";"Solana (USD)";"-";"-";"-";"-";"-";"-";"-";"-";"-";"-";"-";"-";"3 500,30";"-27,50000%";"-10,52";"-10,52";"-";"-";"-";"-";"-";"-";"-";"-";"-";"-";"-";"-";"-";"-";"-";"-";"-";"-"
"19 Mar 2024 22:01:05";"Koszty Utrzymania Pozycji";"O2-CR-8Y0LXK";"-";"-";"Solana (USD)";"-";"-";"-";"-";"-";"-";"-";"-";"-";"-";"-";"-";"2 625,22";"-27,50000%";"-7,89";"-7,89";"-";"-";"-";"-";"-";"-";"-";"-";"-";"-";"-";"-";"-";"-";"-";"-";"-";"-"
"19 Mar 2024 21:52:02";" Zmodyfikowano Transakcję Kupna";"O2-CR-8Y0LXK";"T2-CR-5CRPSW";"-";"Solana (USD)";"15 Jednost.";"178,110";"-";"-";"183,000";"-";"-";"-";"0,00";"-";"-";"-";"-";"-";"-";"-";"-";"-";"-";"-";"-";"-";"-";"-";"-";"-";"-";"-";"-";"-";"-";"-";"-";"-"
"19 Mar 2024 21:51:41";" Zmodyfikowano Transakcję Kupna";"O2-CR-8Y0LSL";"T2-CR-5CRPQD";"-";"Solana (USD)";"20 Jednost.";"178,285";"-";"-";"183,000";"-";"-";"-";"0,00";"-";"-";"-";"-";"-";"-";"-";"-";"-";"-";"-";"-";"-";"-";"-";"-";"-";"-";"-";"-";"-";"-";"-";"-";"-"
"19 Mar 2024 21:39:04";" Transakcja Kupna";"O2-CR-8Y0LXK";"T2-CR-5CRPSW";"-";"Solana (USD)";"15 Jednost.";"178,110";"-";"-";"-";"-";"3,989723";"10 659,14";"0,00";"-";"-";"-";"-";"-";"-";"-";"-";"-";"-";"-";"-";"-";"-";"-";"-";"-";"-";"-";"-";"-";"-";"-";"-";"-"
"19 Mar 2024 21:33:37";" Transakcja Kupna";"O2-CR-8Y0LSL";"T2-CR-5CRPQD";"-";"Solana (USD)";"20 Jednost.";"178,285";"-";"-";"-";"-";"3,989723";"14 226,15";"0,00";"-";"-";"-";"-";"-";"-";"-";"-";"-";"-";"-";"-";"-";"-";"-";"-";"-";"-";"-";"-";"-";"-";"-";"-";"-"
"19 Mar 2024 21:32:39";" Zamknięcie Transakcji";"O2-CR-8Y0LRV";"T2-CR-5CRPPY";"O2-CR-8XZEBK";"Solana (USD)";"40 Jednost.";"178,155";"-";"-";"-";"-";"3,989773";"28 431,92";"-1 020,11";"12 796,42";"-";"-";"-";"-";"-";"-";"-";"-";"-";"-";"-";"-";"-";"-";"-";"-";"-";"-";"-";"-";"-";"-";"-";"-"
"19 Mar 2024 12:30:03";"Transakcja Sprzedaży";"O2-CR-8XZEBK";"T2-CR-5CQMX8";"-";"Solana (USD)";"40 Jednost.";"171,763";"-";"-";"-";"-";"4,007008";"27 530,22";"0,00";"-";"-";"-";"-";"-";"-";"-";"-";"-";"-";"-";"-";"-";"-";"-";"-";"-";"-";"-";"-";"-";"-";"-";"-";"-"
"19 Mar 2024 12:28:13";" Zamknięcie Transakcji";"O2-CR-8XZE4G";"T2-CR-5CQMQN";"O2-CR-8XZDBK";"Solana (USD)";"35 Jednost.";"171,075";"-";"-";"-";"-";"3,96685";"23 990,71";"136,06";"13 816,53";"-";"-";"-";"-";"-";"-";"-";"-";"-";"-";"-";"-";"-";"-";"-";"-";"-";"-";"-";"-";"-";"-";"-";"-"
"19 Mar 2024 12:13:59";"Transakcja Sprzedaży";"O2-CR-8XZDBK";"T2-CR-5CQM25";"-";"Solana (USD)";"35 Jednost.";"172,055";"-";"-";"-";"-";"4,007358";"24 132,00";"0,00";"-";"-";"-";"-";"-";"-";"-";"-";"-";"-";"-";"-";"-";"-";"-";"-";"-";"-";"-";"-";"-";"-";"-";"-";"-"
"19 Mar 2024 12:10:44";" Zamknięcie Transakcji";"O2-CR-8XZD5M";"T2-CR-5CQLX6";"O2-CR-8XZ4JN";"Solana (USD)";"9 Jednost.";"172,395";"-";"-";"-";"-";"3,96646";"6 216,03";"6,43";"13 680,47";"-";"-";"-";"-";"-";"-";"-";"-";"-";"-";"-";"-";"-";"-";"-";"-";"-";"-";"-";"-";"-";"-";"-";"-"
"19 Mar 2024 12:07:34";" Zamknięcie Transakcji";"O2-CR-8XZD08";"T2-CR-5CQLRW";"O2-CR-8XZCGG";"Solana (USD)";"28 Jednost.";"174,010";"-";"-";"-";"-";"3,96644";"19 519,84";"121,06";"13 674,04";"-";"-";"-";"-";"-";"-";"-";"-";"-";"-";"-";"-";"-";"-";"-";"-";"-";"-";"-";"-";"-";"-";"-";"-"
"19 Mar 2024 11:59:23";"Transakcja Sprzedaży";"O2-CR-8XZCGG";"T2-CR-5CQLBG";"-";"Solana (USD)";"28 Jednost.";"175,100";"-";"-";"-";"-";"4,006046";"19 640,84";"0,00";"-";"-";"-";"-";"-";"-";"-";"-";"-";"-";"-";"-";"-";"-";"-";"-";"-";"-";"-";"-";"-";"-";"-";"-";"-"
"19 Mar 2024 11:58:33";"Odrzucono Zlecenie: brak wystarczających środków";"O2-CR-8XZCFT";"-";"-";"Solana (USD)";"30 Jednost.";"-";"-";"-";"-";"-";"-";"-";"-";"-";"-";"-";"-";"-";"-";"-";"-";"-";"-";"-";"-";"-";"-";"-";"-";"-";"-";"-";"-";"-";"-";"-";"-";"-"
"19 Mar 2024 11:32:35";" Zamknięcie Transakcji";"O2-CR-8XZB20";"T2-CR-5CQK45";"O2-CR-8XZ4JN";"Solana (USD)";"15 Jednost.";"173,715";"-";"-";"-";"-";"4,006356";"10 439,46";"-68,51";"13 552,98";"-";"-";"-";"-";"-";"-";"-";"-";"-";"-";"-";"-";"-";"-";"-";"-";"-";"-";"-";"-";"-";"-";"-";"-"
"19 Mar 2024 11:29:58";"Take Profit";"O2-CR-8XZ98N";"T2-CR-5CQK0T";"-";"Solana (USD)";"13 Jednost.";"173,600";"-";"-";"-";"-";"3,96709";"9 042,90";"50,54";"13 621,49";"-";"-";"-";"-";"-";"-";"-";"-";"-";"-";"-";"-";"-";"-";"-";"-";"-";"-";"-";"-";"-";"-";"-";"-"
"19 Mar 2024 11:23:11";"Zmodyfikowano Transakcję Sprzedaży";"O2-CR-8XZ98N";"T2-CR-5CQJEP";"-";"Solana (USD)";"13 Jednost.";"174,580";"-";"-";"173,600";"-";"-";"-";"0,00";"-";"-";"-";"-";"-";"-";"-";"-";"-";"-";"-";"-";"-";"-";"-";"-";"-";"-";"-";"-";"-";"-";"-";"-";"-"
"19 Mar 2024 11:16:50";"Transakcja Sprzedaży";"O2-CR-8XZ98N";"T2-CR-5CQJEP";"-";"Solana (USD)";"13 Jednost.";"174,580";"-";"-";"-";"-";"4,006306";"9 092,47";"0,00";"-";"-";"-";"-";"-";"-";"-";"-";"-";"-";"-";"-";"-";"-";"-";"-";"-";"-";"-";"-";"-";"-";"-";"-";"-"
"19 Mar 2024 11:14:15";" Zamknięcie Transakcji";"O2-CR-8XZ941";"T2-CR-5CQJ9H";"O2-CR-8XZ8EQ";"Solana (USD)";"12 Jednost.";"176,130";"-";"-";"-";"-";"3,96749";"8 469,79";"53,80";"13 570,95";"-";"-";"-";"-";"-";"-";"-";"-";"-";"-";"-";"-";"-";"-";"-";"-";"-";"-";"-";"-";"-";"-";"-";"-"
"19 Mar 2024 11:06:00";"Transakcja Sprzedaży";"O2-CR-8XZ8EQ";"T2-CR-5CQHWK";"-";"Solana (USD)";"12 Jednost.";"177,260";"-";"-";"-";"-";"4,005785";"8 520,78";"0,00";"-";"-";"-";"-";"-";"-";"-";"-";"-";"-";"-";"-";"-";"-";"-";"-";"-";"-";"-";"-";"-";"-";"-";"-";"-"
"19 Mar 2024 11:05:18";" Zamknięcie Transakcji";"O2-CR-8XZ8E2";"T2-CR-5CQHVZ";"O2-CR-8XZ86M";"Solana (USD)";"6 Jednost.";"177,675";"-";"-";"-";"-";"3,96569";"4 270,12";"8,45";"13 517,15";"-";"-";"-";"-";"-";"-";"-";"-";"-";"-";"-";"-";"-";"-";"-";"-";"-";"-";"-";"-";"-";"-";"-";"-"
"19 Mar 2024 11:01:27";"Transakcja Sprzedaży";"O2-CR-8XZ86M";"T2-CR-5CQHQ6";"-";"Solana (USD)";"6 Jednost.";"178,030";"-";"-";"-";"-";"4,006757";"4 279,93";"0,00";"-";"-";"-";"-";"-";"-";"-";"-";"-";"-";"-";"-";"-";"-";"-";"-";"-";"-";"-";"-";"-";"-";"-";"-";"-"
"19 Mar 2024 10:59:53";" Zamknięcie Transakcji";"O2-CR-8XZ7ZR";"T2-CR-5CQHGL";"O2-CR-8XZ4JN";"Solana (USD)";"6 Jednost.";"179,430";"-";"-";"-";"-";"4,006467";"4 313,28";"-164,79";"13 508,70";"-";"-";"-";"-";"-";"-";"-";"-";"-";"-";"-";"-";"-";"-";"-";"-";"-";"-";"-";"-";"-";"-";"-";"-"
"19 Mar 2024 10:29:00";"Zmodyfikowano Transakcję Sprzedaży";"O2-CR-8XZ4JN";"T2-CR-5CQEKG";"-";"Solana (USD)";"30 Jednost.";"172,575";"-";"-";"-";"-";"-";"-";"0,00";"-";"-";"-";"-";"-";"-";"-";"-";"-";"-";"-";"-";"-";"-";"-";"-";"-";"-";"-";"-";"-";"-";"-";"-";"-"
"19 Mar 2024 10:15:05";"Zmodyfikowano Transakcję Sprzedaży";"O2-CR-8XZ4JN";"T2-CR-5CQEKG";"-";"Solana (USD)";"30 Jednost.";"172,575";"-";"-";"171,800";"-";"-";"-";"0,00";"-";"-";"-";"-";"-";"-";"-";"-";"-";"-";"-";"-";"-";"-";"-";"-";"-";"-";"-";"-";"-";"-";"-";"-";"-"
"19 Mar 2024 10:08:58";"Transakcja Sprzedaży";"O2-CR-8XZ4JN";"T2-CR-5CQEKG";"-";"Solana (USD)";"30 Jednost.";"172,575";"-";"-";"-";"-";"4,000324";"20 710,67";"0,00";"-";"-";"-";"-";"-";"-";"-";"-";"-";"-";"-";"-";"-";"-";"-";"-";"-";"-";"-";"-";"-";"-";"-";"-";"-"
"19 Mar 2024 10:06:53";" Zamknięcie Transakcji";"O2-CR-8XZ4EL";"T2-CR-5CQEEQ";"O2-CR-8XXCF4";"Solana (USD)";"0,8 Jednost.";"173,545";"-";"-";"-";"-";"3,999974";"555,34";"-96,98";"13 673,49";"-";"-";"-";"-";"-";"-";"-";"-";"-";"-";"-";"-";"-";"-";"-";"-";"-";"-";"-";"-";"-";"-";"-";"-"
"19 Mar 2024 10:06:47";" Zamknięcie Transakcji";"O2-CR-8XZ4EB";"T2-CR-5CQEEG";"O2-CQ-8XWP88";"Solana (USD)";"17 Jednost.";"173,450";"-";"-";"-";"-";"3,999974";"11 794,52";"-2 272,21";"13 770,47";"-";"-";"-";"-";"-";"-";"-";"-";"-";"-";"-";"-";"-";"-";"-";"-";"-";"-";"-";"-";"-";"-";"-";"-"
"19 Mar 2024 10:06:39";" Zamknięcie Transakcji";"O2-CR-8XZ4DL";"T2-CR-5CQEDP";"O2-CQ-8XWF2S";"Solana (USD)";"30 Jednost.";"173,980";"-";"-";"-";"-";"3,999974";"20 877,46";"-4 202,37";"16 042,68";"-";"-";"-";"-";"-";"-";"-";"-";"-";"-";"-";"-";"-";"-";"-";"-";"-";"-";"-";"-";"-";"-";"-";"-"
"18 Mar 2024 22:00:59";"Koszty Utrzymania Pozycji";"1318179627";"-";"-";"Rachunek";"-";"-";"-";"-";"-";"-";"-";"-";"-28,80";"20 245,05";"-";"-";"-";"-";"-";"-28,80";"-";"-";"-";"-";"-";"-";"-";"-";"-";"-";"-";"-";"-";"-";"-";"-";"-";"-"
"18 Mar 2024 22:00:59";"Koszty Utrzymania Pozycji";"O2-CR-8XXCF4";"-";"-";"Solana (USD)";"-";"-";"-";"-";"-";"-";"-";"-";"-";"-";"-";"-";"160,15";"-27,50000%";"-0,48";"-0,48";"-";"-";"-";"-";"-";"-";"-";"-";"-";"-";"-";"-";"-";"-";"-";"-";"-";"-"
"18 Mar 2024 22:00:59";"Koszty Utrzymania Pozycji";"O2-CQ-8XWP88";"-";"-";"Solana (USD)";"-";"-";"-";"-";"-";"-";"-";"-";"-";"-";"-";"-";"3 403,31";"-27,50000%";"-10,24";"-10,24";"-";"-";"-";"-";"-";"-";"-";"-";"-";"-";"-";"-";"-";"-";"-";"-";"-";"-"
"18 Mar 2024 22:00:59";"Koszty Utrzymania Pozycji";"O2-CQ-8XWF2S";"-";"-";"Solana (USD)";"-";"-";"-";"-";"-";"-";"-";"-";"-";"-";"-";"-";"6 005,85";"-27,50000%";"-18,08";"-18,08";"-";"-";"-";"-";"-";"-";"-";"-";"-";"-";"-";"-";"-";"-";"-";"-";"-";"-"
"18 Mar 2024 21:26:12";" Zmodyfikowano Transakcję Kupna";"O2-CR-8XXCF4";"T2-CR-5CNWR9";"-";"Solana (USD)";"0,8 Jednost.";"203,850";"-";"-";"215,000";"-";"-";"-";"0,00";"-";"-";"-";"-";"-";"-";"-";"-";"-";"-";"-";"-";"-";"-";"-";"-";"-";"-";"-";"-";"-";"-";"-";"-";"-"
"18 Mar 2024 21:25:41";"Zmodyfikowano Take Profit";"O2-CQ-8XWP88";"-";"O2-CR-8XWWDN";"Solana (USD)";"17 Jednost.";"206,865";"-";"-";"215,000";"-";"-";"-";"-";"-";"-";"-";"-";"-";"-";"-";"-";"-";"-";"-";"-";"-";"-";"-";"-";"-";"-";"-";"-";"-";"-";"-";"-";"-"
"18 Mar 2024 21:25:20";"Zmodyfikowano Take Profit";"O2-CQ-8XWF2S";"-";"O2-CR-8XWWC2";"Solana (USD)";"30 Jednost.";"209,000";"-";"-";"215,000";"-";"-";"-";"-";"-";"-";"-";"-";"-";"-";"-";"-";"-";"-";"-";"-";"-";"-";"-";"-";"-";"-";"-";"-";"-";"-";"-";"-";"-"
"18 Mar 2024 16:59:24";" Transakcja Kupna";"O2-CR-8XXCF4";"T2-CR-5CNWR9";"-";"Solana (USD)";"0,8 Jednost.";"203,850";"-";"-";"-";"-";"3,987859";"650,34";"0,00";"-";"-";"-";"-";"-";"-";"-";"-";"-";"-";"-";"-";"-";"-";"-";"-";"-";"-";"-";"-";"-";"-";"-";"-";"-"
"18 Mar 2024 14:37:32";" Zmodyfikowano Transakcję Kupna";"O2-CQ-8XWP88";"T2-CQ-5CNCLB";"-";"Solana (USD)";"17 Jednost.";"206,865";"-";"-";"209,100";"-";"-";"-";"0,00";"-";"-";"-";"-";"-";"-";"-";"-";"-";"-";"-";"-";"-";"-";"-";"-";"-";"-";"-";"-";"-";"-";"-";"-";"-"
"18 Mar 2024 14:37:13";" Zmodyfikowano Transakcję Kupna";"O2-CQ-8XWF2S";"T2-CQ-5CN543";"-";"Solana (USD)";"30 Jednost.";"209,000";"-";"-";"209,100";"-";"-";"-";"0,00";"-";"-";"-";"-";"-";"-";"-";"-";"-";"-";"-";"-";"-";"-";"-";"-";"-";"-";"-";"-";"-";"-";"-";"-";"-"
"18 Mar 2024 13:25:38";" Transakcja Kupna";"O2-CQ-8XWP88";"T2-CQ-5CNCLB";"-";"Solana (USD)";"17 Jednost.";"206,865";"-";"-";"-";"-";"3,974503";"13 977,15";"0,00";"-";"-";"-";"-";"-";"-";"-";"-";"-";"-";"-";"-";"-";"-";"-";"-";"-";"-";"-";"-";"-";"-";"-";"-";"-"
"18 Mar 2024 13:23:47";" Wpłata";"1318026037";"BD.24448231";"-";"Rachunek";"-";"-";"-";"-";"-";"-";"-";"-";"6 000,00";"20 273,85";"6 000,00";"0,00";"-";"-";"-";"-";"-";"-";"-";"-";"-";"-";"-";"-";"-";"-";"-";"-";"-";"-";"-";"-";"-";"-"
"18 Mar 2024 11:09:36";" Transakcja Kupna";"O2-CQ-8XWF2S";"T2-CQ-5CN543";"-";"Solana (USD)";"30 Jednost.";"209,000";"-";"-";"-";"-";"3,976256";"24 931,12";"0,00";"-";"-";"-";"-";"-";"-";"-";"-";"-";"-";"-";"-";"-";"-";"-";"-";"-";"-";"-";"-";"-";"-";"-";"-";"-"
"18 Mar 2024 11:08:13";" Zamknięcie Transakcji";"O2-CQ-8XWF11";"T2-CQ-5CN533";"O2-CQ-8XWDLV";"Solana (USD)";"13 Jednost.";"209,108";"-";"-";"-";"-";"3,976707";"10 810,29";"-270,79";"14 273,85";"-";"-";"-";"-";"-";"-";"-";"-";"-";"-";"-";"-";"-";"-";"-";"-";"-";"-";"-";"-";"-";"-";"-";"-"
"18 Mar 2024 10:42:21";"Transakcja Sprzedaży";"O2-CQ-8XWDLV";"T2-CQ-5CN3ZS";"-";"Solana (USD)";"13 Jednost.";"203,870";"-";"-";"-";"-";"3,975665";"10 536,74";"0,00";"-";"-";"-";"-";"-";"-";"-";"-";"-";"-";"-";"-";"-";"-";"-";"-";"-";"-";"-";"-";"-";"-";"-";"-";"-"
"18 Mar 2024 10:41:19";" Zamknięcie Transakcji";"O2-CQ-8XWDJN";"T2-CQ-5CN3YT";"O2-CQ-8XWD8F";"Solana (USD)";"13 Jednost.";"203,675";"-";"-";"-";"-";"3,93411";"10 521,30";"25,83";"14 544,64";"-";"-";"-";"-";"-";"-";"-";"-";"-";"-";"-";"-";"-";"-";"-";"-";"-";"-";"-";"-";"-";"-";"-";"-"
"18 Mar 2024 10:36:22";"Transakcja Sprzedaży";"O2-CQ-8XWD8F";"T2-CQ-5CN3SC";"-";"Solana (USD)";"13 Jednost.";"204,180";"-";"-";"-";"-";"3,971968";"10 542,95";"0,00";"-";"-";"-";"-";"-";"-";"-";"-";"-";"-";"-";"-";"-";"-";"-";"-";"-";"-";"-";"-";"-";"-";"-";"-";"-"
"18 Mar 2024 10:25:30";" Zamknięcie Transakcji";"O2-CQ-8XWCPS";"T2-CQ-5CN366";"O2-CQ-8XWCEK";"Solana (USD)";"14 Jednost.";"203,075";"-";"-";"-";"-";"3,93241";"11 292,41";"8,53";"14 518,81";"-";"-";"-";"-";"-";"-";"-";"-";"-";"-";"-";"-";"-";"-";"-";"-";"-";"-";"-";"-";"-";"-";"-";"-"
"18 Mar 2024 10:20:51";" Transakcja Kupna";"O2-CQ-8XWCEK";"T2-CQ-5CN2XT";"-";"Solana (USD)";"14 Jednost.";"202,920";"-";"-";"-";"-";"3,972539";"11 285,50";"0,00";"-";"-";"-";"-";"-";"-";"-";"-";"-";"-";"-";"-";"-";"-";"-";"-";"-";"-";"-";"-";"-";"-";"-";"-";"-"
"15 Mar 2024 21:52:22";"Take Profit";"O2-CP-8XT23V";"T2-CP-5CMG3V";"-";"Solana (USD)";"45 Jednost.";"175,549";"-";"-";"-";"-";"3,969252";"31 355,91";"-918,80";"14 510,28";"-";"-";"-";"-";"-";"-";"-";"-";"-";"-";"-";"-";"-";"-";"-";"-";"-";"-";"-";"-";"-";"-";"-";"-"
"15 Mar 2024 21:51:31";"Zmodyfikowano Take Profit";"O2-CP-8XT23V";"-";"O2-CP-8XT28V";"Solana (USD)";"45 Jednost.";"170,405";"-";"-";"175,549";"-";"-";"-";"-";"-";"-";"-";"-";"-";"-";"-";"-";"-";"-";"-";"-";"-";"-";"-";"-";"-";"-";"-";"-";"-";"-";"-";"-";"-"
"15 Mar 2024 13:28:58";"Zmodyfikowano Transakcję Sprzedaży";"O2-CP-8XT23V";"T2-CP-5CLB6C";"-";"Solana (USD)";"45 Jednost.";"170,405";"-";"-";"168,701";"-";"-";"-";"0,00";"-";"-";"-";"-";"-";"-";"-";"-";"-";"-";"-";"-";"-";"-";"-";"-";"-";"-";"-";"-";"-";"-";"-";"-";"-"
"15 Mar 2024 13:26:39";"Transakcja Sprzedaży";"O2-CP-8XT23V";"T2-CP-5CLB6C";"-";"Solana (USD)";"45 Jednost.";"170,405";"-";"-";"-";"-";"3,962008";"30 381,56";"0,00";"-";"-";"-";"-";"-";"-";"-";"-";"-";"-";"-";"-";"-";"-";"-";"-";"-";"-";"-";"-";"-";"-";"-";"-";"-"
"15 Mar 2024 13:21:41";" Zamknięcie Transakcji";"O2-CP-8XT1W7";"T2-CP-5CLB0Z";"O2-CP-8XT135";"Solana (USD)";"45 Jednost.";"169,055";"-";"-";"-";"-";"3,92197";"30 136,07";"61,77";"15 429,08";"-";"-";"-";"-";"-";"-";"-";"-";"-";"-";"-";"-";"-";"-";"-";"-";"-";"-";"-";"-";"-";"-";"-";"-"
"15 Mar 2024 13:15:48";" Zmodyfikowano Transakcję Kupna";"O2-CP-8XT135";"T2-CP-5CL99W";"-";"Solana (USD)";"45 Jednost.";"168,705";"-";"-";"170,300";"-";"-";"-";"0,00";"-";"-";"-";"-";"-";"-";"-";"-";"-";"-";"-";"-";"-";"-";"-";"-";"-";"-";"-";"-";"-";"-";"-";"-";"-"
"15 Mar 2024 13:11:06";" Transakcja Kupna";"O2-CP-8XT135";"T2-CP-5CL99W";"-";"Solana (USD)";"45 Jednost.";"168,705";"-";"-";"-";"-";"3,963841";"30 092,39";"0,00";"-";"-";"-";"-";"-";"-";"-";"-";"-";"-";"-";"-";"-";"-";"-";"-";"-";"-";"-";"-";"-";"-";"-";"-";"-"
"15 Mar 2024 13:00:48";" Zamknięcie Transakcji";"O2-CP-8XT0BZ";"T2-CP-5CL8J4";"O2-CP-8XSZYE";"Solana (USD)";"45 Jednost.";"169,285";"-";"-";"-";"-";"3,91997";"30 161,81";"43,22";"15 367,31";"-";"-";"-";"-";"-";"-";"-";"-";"-";"-";"-";"-";"-";"-";"-";"-";"-";"-";"-";"-";"-";"-";"-";"-"
"15 Mar 2024 12:55:10";"Zmodyfikowano Transakcję Sprzedaży";"O2-CP-8XSZYE";"T2-CP-5CL85V";"-";"Solana (USD)";"45 Jednost.";"169,530";"-";"-";"168,500";"-";"-";"-";"0,00";"-";"-";"-";"-";"-";"-";"-";"-";"-";"-";"-";"-";"-";"-";"-";"-";"-";"-";"-";"-";"-";"-";"-";"-";"-"
"15 Mar 2024 12:54:33";"Transakcja Sprzedaży";"O2-CP-8XSZYE";"T2-CP-5CL85V";"-";"Solana (USD)";"45 Jednost.";"169,530";"-";"-";"-";"-";"3,960274";"30 212,33";"0,00";"-";"-";"-";"-";"-";"-";"-";"-";"-";"-";"-";"-";"-";"-";"-";"-";"-";"-";"-";"-";"-";"-";"-";"-";"-"
"15 Mar 2024 12:49:16";" Zamknięcie Transakcji";"O2-CP-8XSZNQ";"T2-CP-5CL7Z5";"O2-CP-8XSZL0";"Solana (USD)";"45 Jednost.";"169,525";"-";"-";"-";"-";"3,91872";"30 194,93";"63,48";"15 324,09";"-";"-";"-";"-";"-";"-";"-";"-";"-";"-";"-";"-";"-";"-";"-";"-";"-";"-";"-";"-";"-";"-";"-";"-"
"15 Mar 2024 12:48:15";"Zmodyfikowano Transakcję Sprzedaży";"O2-CP-8XSZL0";"T2-CP-5CL7X6";"-";"Solana (USD)";"45 Jednost.";"169,885";"-";"-";"168,400";"-";"-";"-";"0,00";"-";"-";"-";"-";"-";"-";"-";"-";"-";"-";"-";"-";"-";"-";"-";"-";"-";"-";"-";"-";"-";"-";"-";"-";"-"
"15 Mar 2024 12:47:25";"Transakcja Sprzedaży";"O2-CP-8XSZL0";"T2-CP-5CL7X6";"-";"Solana (USD)";"45 Jednost.";"169,885";"-";"-";"-";"-";"3,959974";"30 273,30";"0,00";"-";"-";"-";"-";"-";"-";"-";"-";"-";"-";"-";"-";"-";"-";"-";"-";"-";"-";"-";"-";"-";"-";"-";"-";"-"
"15 Mar 2024 12:44:21";" Zamknięcie Transakcji";"O2-CP-8XSZD5";"T2-CP-5CL7QV";"O2-CP-8XSZ1R";"Solana (USD)";"45 Jednost.";"169,225";"-";"-";"-";"-";"3,9214";"30 162,02";"52,76";"15 260,61";"-";"-";"-";"-";"-";"-";"-";"-";"-";"-";"-";"-";"-";"-";"-";"-";"-";"-";"-";"-";"-";"-";"-";"-"
"15 Mar 2024 12:39:46";"Zmodyfikowano Transakcję Sprzedaży";"O2-CP-8XSZ1R";"T2-CP-5CL7H9";"-";"Solana (USD)";"45 Jednost.";"169,524";"-";"-";"168,600";"-";"-";"-";"0,00";"-";"-";"-";"-";"-";"-";"-";"-";"-";"-";"-";"-";"-";"-";"-";"-";"-";"-";"-";"-";"-";"-";"-";"-";"-"
"15 Mar 2024 12:39:05";"Transakcja Sprzedaży";"O2-CP-8XSZ1R";"T2-CP-5CL7H9";"-";"Solana (USD)";"45 Jednost.";"169,524";"-";"-";"-";"-";"3,961837";"30 223,19";"0,00";"-";"-";"-";"-";"-";"-";"-";"-";"-";"-";"-";"-";"-";"-";"-";"-";"-";"-";"-";"-";"-";"-";"-";"-";"-"
"14 Mar 2024 23:31:14";" Zamknięcie Transakcji";"O2-CP-8XRYEM";"T2-CP-5CKD0T";"O2-CP-8XQ3TN";"Solana (USD)";"44 Jednost.";"173,311";"-";"-";"-";"-";"3,92361";"30 220,89";"151,23";"15 207,85";"-";"-";"-";"-";"-";"-";"-";"-";"-";"-";"-";"-";"-";"-";"-";"-";"-";"-";"-";"-";"-";"-";"-";"-"
"14 Mar 2024 23:28:17";" Zmodyfikowano Transakcję Kupna";"O2-CP-8XQ3TN";"T2-CP-5CHN7T";"-";"Solana (USD)";"44 Jednost.";"172,435";"-";"-";"-";"-";"-";"-";"0,00";"-";"-";"-";"-";"-";"-";"-";"-";"-";"-";"-";"-";"-";"-";"-";"-";"-";"-";"-";"-";"-";"-";"-";"-";"-"
"14 Mar 2024 23:27:25";" Zmodyfikowano Transakcję Kupna";"O2-CP-8XQ3TN";"T2-CP-5CHN7T";"-";"Solana (USD)";"44 Jednost.";"172,435";"-";"-";"173,600";"-";"-";"-";"0,00";"-";"-";"-";"-";"-";"-";"-";"-";"-";"-";"-";"-";"-";"-";"-";"-";"-";"-";"-";"-";"-";"-";"-";"-";"-"
"14 Mar 2024 22:01:24";"Koszty Utrzymania Pozycji";"1317211739";"-";"-";"Rachunek";"-";"-";"-";"-";"-";"-";"-";"-";"-22,10";"15 056,62";"-";"-";"-";"-";"-";"-22,10";"-";"-";"-";"-";"-";"-";"-";"-";"-";"-";"-";"-";"-";"-";"-";"-";"-";"-"
"14 Mar 2024 22:01:24";"Koszty Utrzymania Pozycji";"O2-CP-8XQ3TN";"-";"-";"Solana (USD)";"-";"-";"-";"-";"-";"-";"-";"-";"-";"-";"-";"-";"7 399,92";"-27,50000%";"-22,10";"-22,10";"-";"-";"-";"-";"-";"-";"-";"-";"-";"-";"-";"-";"-";"-";"-";"-";"-";"-"
"14 Mar 2024 13:16:04";" Transakcja Kupna";"O2-CP-8XQ3TN";"T2-CP-5CHN7T";"-";"Solana (USD)";"44 Jednost.";"172,435";"-";"-";"-";"-";"3,943741";"29 921,71";"0,00";"-";"-";"-";"-";"-";"-";"-";"-";"-";"-";"-";"-";"-";"-";"-";"-";"-";"-";"-";"-";"-";"-";"-";"-";"-"
"14 Mar 2024 12:19:25";" Wpłata";"1316909247";"BD.35250634";"-";"Rachunek";"-";"-";"-";"-";"-";"-";"-";"-";"7 000,00";"15 078,72";"7 000,00";"0,00";"-";"-";"-";"-";"-";"-";"-";"-";"-";"-";"-";"-";"-";"-";"-";"-";"-";"-";"-";"-";"-";"-"
"14 Mar 2024 11:42:05";" Zamknięcie Transakcji";"O2-CP-8XPZDD";"T2-CP-5CHJCF";"O2-CP-8XPYDS";"Solana (USD)";"23 Jednost.";"173,305";"-";"-";"-";"-";"3,90002";"15 701,79";"43,50";"8 078,72";"-";"-";"-";"-";"-";"-";"-";"-";"-";"-";"-";"-";"-";"-";"-";"-";"-";"-";"-";"-";"-";"-";"-";"-"
"14 Mar 2024 11:23:09";" Transakcja Kupna";"O2-CP-8XPYDS";"T2-CP-5CHHLX";"-";"Solana (USD)";"23 Jednost.";"172,820";"-";"-";"-";"-";"3,940074";"15 661,24";"0,00";"-";"-";"-";"-";"-";"-";"-";"-";"-";"-";"-";"-";"-";"-";"-";"-";"-";"-";"-";"-";"-";"-";"-";"-";"-"
"14 Mar 2024 11:13:01";" Zamknięcie Transakcji";"O2-CP-8XPXPM";"T2-CP-5CHH46";"O2-CP-8XPWV9";"Solana (USD)";"23 Jednost.";"173,272";"-";"-";"-";"-";"3,89769";"15 689,38";"48,14";"8 035,22";"-";"-";"-";"-";"-";"-";"-";"-";"-";"-";"-";"-";"-";"-";"-";"-";"-";"-";"-";"-";"-";"-";"-";"-"
"14 Mar 2024 11:10:09";" Zmodyfikowano Transakcję Kupna";"O2-CP-8XPWV9";"T2-CP-5CHGDR";"-";"Solana (USD)";"23 Jednost.";"172,735";"-";"-";"174,000";"-";"-";"-";"0,00";"-";"-";"-";"-";"-";"-";"-";"-";"-";"-";"-";"-";"-";"-";"-";"-";"-";"-";"-";"-";"-";"-";"-";"-";"-"
"14 Mar 2024 10:53:36";" Transakcja Kupna";"O2-CP-8XPWV9";"T2-CP-5CHGDR";"-";"Solana (USD)";"23 Jednost.";"172,735";"-";"-";"-";"-";"3,937459";"15 643,15";"0,00";"-";"-";"-";"-";"-";"-";"-";"-";"-";"-";"-";"-";"-";"-";"-";"-";"-";"-";"-";"-";"-";"-";"-";"-";"-"
"14 Mar 2024 10:49:55";" Zamknięcie Transakcji";"O2-CP-8XPWKJ";"T2-CP-5CHG4X";"O2-CP-8XPTTZ";"Solana (USD)";"24 Jednost.";"171,545";"-";"-";"-";"-";"3,937158";"16 209,59";"-81,74";"7 987,08";"-";"-";"-";"-";"-";"-";"-";"-";"-";"-";"-";"-";"-";"-";"-";"-";"-";"-";"-";"-";"-";"-";"-";"-"
"14 Mar 2024 10:10:55";"Zmodyfikowano Transakcję Sprzedaży";"O2-CP-8XPTTZ";"T2-CP-5CHEP7";"-";"Solana (USD)";"24 Jednost.";"170,680";"-";"-";"170,000";"-";"-";"-";"0,00";"-";"-";"-";"-";"-";"-";"-";"-";"-";"-";"-";"-";"-";"-";"-";"-";"-";"-";"-";"-";"-";"-";"-";"-";"-"
"14 Mar 2024 10:10:11";"Transakcja Sprzedaży";"O2-CP-8XPTTZ";"T2-CP-5CHEP7";"-";"Solana (USD)";"24 Jednost.";"170,680";"-";"-";"-";"-";"3,935605";"16 121,49";"0,00";"-";"-";"-";"-";"-";"-";"-";"-";"-";"-";"-";"-";"-";"-";"-";"-";"-";"-";"-";"-";"-";"-";"-";"-";"-"
"14 Mar 2024 07:53:16";"Stop Loss";"O2-CP-8X6Q79";"T2-CP-5CH5TS";"-";"Solana (USD)";"45 Jednost.";"170,025";"-";"-";"-";"-";"3,935856";"30 113,72";"-7 497,22";"8 068,82";"-";"-";"-";"-";"-";"-";"-";"-";"-";"-";"-";"-";"-";"-";"-";"-";"-";"-";"-";"-";"-";"-";"-";"-"
"13 Mar 2024 23:46:36";"Zmodyfikowano Transakcję Sprzedaży";"O2-CP-8X6Q79";"T2-CP-5C2JS3";"-";"Solana (USD)";"45 Jednost.";"127,695";"-";"170,000";"115,000";"-";"-";"-";"0,00";"-";"-";"-";"-";"-";"-";"-";"-";"-";"-";"-";"-";"-";"-";"-";"-";"-";"-";"-";"-";"-";"-";"-";"-";"-"
"13 Mar 2024 22:01:16";"Koszty Utrzymania Pozycji";"1316721044";"-";"-";"Rachunek";"-";"-";"-";"-";"-";"-";"-";"-";"7,68";"15 566,04";"-";"-";"-";"-";"-";"7,68";"-";"-";"-";"-";"-";"-";"-";"-";"-";"-";"-";"-";"-";"-";"-";"-";"-";"-"
"13 Mar 2024 22:01:16";"Koszty Utrzymania Pozycji";"O2-CP-8X6Q79";"-";"-";"Solana (USD)";"-";"-";"-";"-";"-";"-";"-";"-";"-";"-";"-";"-";"7 205,62";"-10,00000%";"7,68";"7,68";"-";"-";"-";"-";"-";"-";"-";"-";"-";"-";"-";"-";"-";"-";"-";"-";"-";"-"
"13 Mar 2024 20:05:15";"Zmodyfikowano Take Profit";"O2-CP-8X6Q79";"-";"O2-CP-8X6QBM";"Solana (USD)";"45 Jednost.";"127,695";"-";"-";"115,000";"-";"-";"-";"-";"-";"-";"-";"-";"-";"-";"-";"-";"-";"-";"-";"-";"-";"-";"-";"-";"-";"-";"-";"-";"-";"-";"-";"-";"-"
"13 Mar 2024 12:27:38";"Zmodyfikowano Take Profit";"O2-CP-8X6Q79";"-";"O2-CP-8X6QBM";"Solana (USD)";"45 Jednost.";"127,695";"-";"-";"120,000";"-";"-";"-";"-";"-";"-";"-";"-";"-";"-";"-";"-";"-";"-";"-";"-";"-";"-";"-";"-";"-";"-";"-";"-";"-";"-";"-";"-";"-"
"12 Mar 2024 22:01:12";"Koszty Utrzymania Pozycji";"1316289519";"-";"-";"Rachunek";"-";"-";"-";"-";"-";"-";"-";"-";"7,14";"15 558,36";"-";"-";"-";"-";"-";"7,14";"-";"-";"-";"-";"-";"-";"-";"-";"-";"-";"-";"-";"-";"-";"-";"-";"-";"-"
"12 Mar 2024 22:01:12";"Koszty Utrzymania Pozycji";"O2-CP-8X6Q79";"-";"-";"Solana (USD)";"-";"-";"-";"-";"-";"-";"-";"-";"-";"-";"-";"-";"6 676,87";"-10,00000%";"7,14";"7,14";"-";"-";"-";"-";"-";"-";"-";"-";"-";"-";"-";"-";"-";"-";"-";"-";"-";"-"
"11 Mar 2024 22:01:06";"Koszty Utrzymania Pozycji";"1315787020";"-";"-";"Rachunek";"-";"-";"-";"-";"-";"-";"-";"-";"7,08";"15 551,22";"-";"-";"-";"-";"-";"7,08";"-";"-";"-";"-";"-";"-";"-";"-";"-";"-";"-";"-";"-";"-";"-";"-";"-";"-"
"11 Mar 2024 22:01:06";"Koszty Utrzymania Pozycji";"O2-CP-8X6Q79";"-";"-";"Solana (USD)";"-";"-";"-";"-";"-";"-";"-";"-";"-";"-";"-";"-";"6 630,75";"-10,00000%";"7,08";"7,08";"-";"-";"-";"-";"-";"-";"-";"-";"-";"-";"-";"-";"-";"-";"-";"-";"-";"-"
"11 Mar 2024 21:25:50";"Zmodyfikowano Take Profit";"O2-CP-8X6Q79";"-";"O2-CP-8X6QBM";"Solana (USD)";"45 Jednost.";"127,695";"-";"-";"137,700";"-";"-";"-";"-";"-";"-";"-";"-";"-";"-";"-";"-";"-";"-";"-";"-";"-";"-";"-";"-";"-";"-";"-";"-";"-";"-";"-";"-";"-"
"11 Mar 2024 16:28:13";" Wpłata";"1315681816";"BD.26265195";"-";"Rachunek";"-";"-";"-";"-";"-";"-";"-";"-";"4 000,00";"15 544,14";"4 000,00";"0,00";"-";"-";"-";"-";"-";"-";"-";"-";"-";"-";"-";"-";"-";"-";"-";"-";"-";"-";"-";"-";"-";"-"
"08 Mar 2024 23:01:13";"Koszty Utrzymania Pozycji";"1315359149";"-";"-";"Rachunek";"-";"-";"-";"-";"-";"-";"-";"-";"21,25";"11 544,14";"-";"-";"-";"-";"-";"21,25";"-";"-";"-";"-";"-";"-";"-";"-";"-";"-";"-";"-";"-";"-";"-";"-";"-";"-"
"08 Mar 2024 23:01:13";"Koszty Utrzymania Pozycji";"O2-CP-8X6Q79";"-";"-";"Solana (USD)";"-";"-";"-";"-";"-";"-";"-";"-";"-";"-";"-";"-";"6 611,26";"-10,00000%";"21,25";"21,25";"-";"-";"-";"-";"-";"-";"-";"-";"-";"-";"-";"-";"-";"-";"-";"-";"-";"-"
"07 Mar 2024 23:01:05";"Koszty Utrzymania Pozycji";"1314852444";"-";"-";"Rachunek";"-";"-";"-";"-";"-";"-";"-";"-";"7,01";"11 522,89";"-";"-";"-";"-";"-";"7,01";"-";"-";"-";"-";"-";"-";"-";"-";"-";"-";"-";"-";"-";"-";"-";"-";"-";"-"
"07 Mar 2024 23:01:05";"Koszty Utrzymania Pozycji";"O2-CP-8X6Q79";"-";"-";"Solana (USD)";"-";"-";"-";"-";"-";"-";"-";"-";"-";"-";"-";"-";"6 548,35";"-10,00000%";"7,01";"7,01";"-";"-";"-";"-";"-";"-";"-";"-";"-";"-";"-";"-";"-";"-";"-";"-";"-";"-"
"07 Mar 2024 09:42:27";"Zmodyfikowano Take Profit";"O2-CP-8X6Q79";"-";"O2-CP-8X6QBM";"Solana (USD)";"45 Jednost.";"127,695";"-";"-";"126,500";"-";"-";"-";"-";"-";"-";"-";"-";"-";"-";"-";"-";"-";"-";"-";"-";"-";"-";"-";"-";"-";"-";"-";"-";"-";"-";"-";"-";"-"
"06 Mar 2024 23:01:05";"Koszty Utrzymania Pozycji";"1314336266";"-";"-";"Rachunek";"-";"-";"-";"-";"-";"-";"-";"-";"6,41";"11 515,88";"-";"-";"-";"-";"-";"6,41";"-";"-";"-";"-";"-";"-";"-";"-";"-";"-";"-";"-";"-";"-";"-";"-";"-";"-"
"06 Mar 2024 23:01:05";"Koszty Utrzymania Pozycji";"O2-CP-8X6Q79";"-";"-";"Solana (USD)";"-";"-";"-";"-";"-";"-";"-";"-";"-";"-";"-";"-";"5 954,40";"-10,00000%";"6,41";"6,41";"-";"-";"-";"-";"-";"-";"-";"-";"-";"-";"-";"-";"-";"-";"-";"-";"-";"-"
"06 Mar 2024 16:50:03";"Zmodyfikowano Transakcję Sprzedaży";"O2-CP-8X6Q79";"T2-CP-5C2JS3";"-";"Solana (USD)";"45 Jednost.";"127,695";"-";"-";"126,900";"-";"-";"-";"0,00";"-";"-";"-";"-";"-";"-";"-";"-";"-";"-";"-";"-";"-";"-";"-";"-";"-";"-";"-";"-";"-";"-";"-";"-";"-"
"06 Mar 2024 16:49:17";"Transakcja Sprzedaży";"O2-CP-8X6Q79";"T2-CP-5C2JS3";"-";"Solana (USD)";"45 Jednost.";"127,695";"-";"-";"-";"-";"3,969924";"22 812,27";"0,00";"-";"-";"-";"-";"-";"-";"-";"-";"-";"-";"-";"-";"-";"-";"-";"-";"-";"-";"-";"-";"-";"-";"-";"-";"-"
"06 Mar 2024 16:07:27";"Take Profit";"O2-CP-8X6DME";"T2-CP-5C2D0X";"-";"Solana (USD)";"45 Jednost.";"126,100";"-";"-";"-";"-";"3,93286";"22 541,32";"81,59";"11 509,47";"-";"-";"-";"-";"-";"-";"-";"-";"-";"-";"-";"-";"-";"-";"-";"-";"-";"-";"-";"-";"-";"-";"-";"-"
"06 Mar 2024 15:54:21";"Zmodyfikowano Transakcję Sprzedaży";"O2-CP-8X6DME";"T2-CP-5C27ZT";"-";"Solana (USD)";"45 Jednost.";"126,561";"-";"-";"126,100";"-";"-";"-";"0,00";"-";"-";"-";"-";"-";"-";"-";"-";"-";"-";"-";"-";"-";"-";"-";"-";"-";"-";"-";"-";"-";"-";"-";"-";"-"
"06 Mar 2024 15:45:56";"Transakcja Sprzedaży";"O2-CP-8X6DME";"T2-CP-5C27ZT";"-";"Solana (USD)";"45 Jednost.";"126,561";"-";"-";"-";"-";"3,968591";"22 602,09";"0,00";"-";"-";"-";"-";"-";"-";"-";"-";"-";"-";"-";"-";"-";"-";"-";"-";"-";"-";"-";"-";"-";"-";"-";"-";"-"
"06 Mar 2024 15:24:10";" Zamknięcie Transakcji";"O2-CP-8X693N";"T2-CP-5C24K4";"O2-CP-8X68YS";"Solana (USD)";"44,5 Jednost.";"128,715";"-";"-";"-";"-";"3,92935";"22 732,73";"41,09";"11 427,88";"-";"-";"-";"-";"-";"-";"-";"-";"-";"-";"-";"-";"-";"-";"-";"-";"-";"-";"-";"-";"-";"-";"-";"-"
"06 Mar 2024 15:22:11";"Transakcja Sprzedaży";"O2-CP-8X68YS";"T2-CP-5C24EQ";"-";"Solana (USD)";"44,5 Jednost.";"128,950";"-";"-";"-";"-";"3,969573";"22 778,50";"0,00";"-";"-";"-";"-";"-";"-";"-";"-";"-";"-";"-";"-";"-";"-";"-";"-";"-";"-";"-";"-";"-";"-";"-";"-";"-"
"06 Mar 2024 15:20:57";" Zamknięcie Transakcji";"O2-CP-8X68VD";"T2-CP-5C24BK";"O2-CP-8X5ZMM";"Solana (USD)";"44 Jednost.";"129,255";"-";"-";"-";"-";"3,9295";"22 572,53";"9,86";"11 386,79";"-";"-";"-";"-";"-";"-";"-";"-";"-";"-";"-";"-";"-";"-";"-";"-";"-";"-";"-";"-";"-";"-";"-";"-"
"06 Mar 2024 13:54:43";" Transakcja Kupna";"O2-CP-8X5ZMM";"T2-CP-5C1VRL";"-";"Solana (USD)";"44 Jednost.";"129,198";"-";"-";"-";"-";"3,974302";"22 592,76";"0,00";"-";"-";"-";"-";"-";"-";"-";"-";"-";"-";"-";"-";"-";"-";"-";"-";"-";"-";"-";"-";"-";"-";"-";"-";"-"
"06 Mar 2024 13:52:38";" Zamknięcie Transakcji";"O2-CP-8X5ZCW";"T2-CP-5C1VHH";"O2-CP-8X5Z9J";"Solana (USD)";"44 Jednost.";"129,410";"-";"-";"-";"-";"3,93583";"22 636,05";"28,57";"11 376,93";"-";"-";"-";"-";"-";"-";"-";"-";"-";"-";"-";"-";"-";"-";"-";"-";"-";"-";"-";"-";"-";"-";"-";"-"
"06 Mar 2024 13:51:35";" Transakcja Kupna";"O2-CP-8X5Z9J";"T2-CP-5C1VFC";"-";"Solana (USD)";"44 Jednost.";"129,245";"-";"-";"-";"-";"3,975104";"22 605,54";"0,00";"-";"-";"-";"-";"-";"-";"-";"-";"-";"-";"-";"-";"-";"-";"-";"-";"-";"-";"-";"-";"-";"-";"-";"-";"-"
"06 Mar 2024 13:48:51";" Zamknięcie Transakcji";"O2-CP-8X5Z5G";"T2-CP-5C1VC7";"O2-CP-8X5Z2W";"Solana (USD)";"44 Jednost.";"128,815";"-";"-";"-";"-";"3,93606";"22 533,28";"57,15";"11 348,36";"-";"-";"-";"-";"-";"-";"-";"-";"-";"-";"-";"-";"-";"-";"-";"-";"-";"-";"-";"-";"-";"-";"-";"-"
"06 Mar 2024 13:48:00";" Transakcja Kupna";"O2-CP-8X5Z2W";"T2-CP-5C1V90";"-";"Solana (USD)";"44 Jednost.";"128,485";"-";"-";"-";"-";"3,975936";"22 477,31";"0,00";"-";"-";"-";"-";"-";"-";"-";"-";"-";"-";"-";"-";"-";"-";"-";"-";"-";"-";"-";"-";"-";"-";"-";"-";"-"
"06 Mar 2024 13:44:29";" Zamknięcie Transakcji";"O2-CP-8X5YWT";"T2-CP-5C1V3T";"O2-CP-8X5PPS";"Solana (USD)";"43 Jednost.";"129,240";"-";"-";"-";"-";"3,93656";"22 096,60";"41,47";"11 291,21";"-";"-";"-";"-";"-";"-";"-";"-";"-";"-";"-";"-";"-";"-";"-";"-";"-";"-";"-";"-";"-";"-";"-";"-"
"06 Mar 2024 10:58:16";"Transakcja Sprzedaży";"O2-CP-8X5PPS";"T2-CP-5C1MG6";"-";"Solana (USD)";"43 Jednost.";"129,485";"-";"-";"-";"-";"3,98337";"22 178,82";"0,00";"-";"-";"-";"-";"-";"-";"-";"-";"-";"-";"-";"-";"-";"-";"-";"-";"-";"-";"-";"-";"-";"-";"-";"-";"-"
"06 Mar 2024 10:53:30";" Zamknięcie Transakcji";"O2-CP-8X5PH5";"T2-CP-5C1M8Z";"O2-CP-8X5PGP";"Solana (USD)";"42 Jednost.";"130,295";"-";"-";"-";"-";"3,94309";"21 794,99";"30,14";"11 249,74";"-";"-";"-";"-";"-";"-";"-";"-";"-";"-";"-";"-";"-";"-";"-";"-";"-";"-";"-";"-";"-";"-";"-";"-"
"06 Mar 2024 10:53:04";"Transakcja Sprzedaży";"O2-CP-8X5PGP";"T2-CP-5C1M8K";"-";"Solana (USD)";"42 Jednost.";"130,477";"-";"-";"-";"-";"3,982689";"21 825,27";"0,00";"-";"-";"-";"-";"-";"-";"-";"-";"-";"-";"-";"-";"-";"-";"-";"-";"-";"-";"-";"-";"-";"-";"-";"-";"-"
"06 Mar 2024 10:50:26";" Zamknięcie Transakcji";"O2-CP-8X5PD1";"T2-CP-5C1M5G";"O2-CP-8X5P9R";"Solana (USD)";"42 Jednost.";"130,680";"-";"-";"-";"-";"3,94326";"21 860,32";"71,22";"11 219,60";"-";"-";"-";"-";"-";"-";"-";"-";"-";"-";"-";"-";"-";"-";"-";"-";"-";"-";"-";"-";"-";"-";"-";"-"
"06 Mar 2024 10:48:32";"Transakcja Sprzedaży";"O2-CP-8X5P9R";"T2-CP-5C1M3H";"-";"Solana (USD)";"42 Jednost.";"131,110";"-";"-";"-";"-";"3,982789";"21 931,70";"0,00";"-";"-";"-";"-";"-";"-";"-";"-";"-";"-";"-";"-";"-";"-";"-";"-";"-";"-";"-";"-";"-";"-";"-";"-";"-"
"06 Mar 2024 10:47:36";" Zamknięcie Transakcji";"O2-CP-8X5P7R";"T2-CP-5C1M1T";"O2-CP-8X5P5X";"Solana (USD)";"40 Jednost.";"131,135";"-";"-";"-";"-";"3,94446";"20 898,15";"54,43";"11 148,38";"-";"-";"-";"-";"-";"-";"-";"-";"-";"-";"-";"-";"-";"-";"-";"-";"-";"-";"-";"-";"-";"-";"-";"-"
"06 Mar 2024 10:46:25";" Transakcja Kupna";"O2-CP-8X5P5X";"T2-CP-5C1M0B";"-";"Solana (USD)";"40 Jednost.";"130,790";"-";"-";"-";"-";"3,984142";"20 843,43";"0,00";"-";"-";"-";"-";"-";"-";"-";"-";"-";"-";"-";"-";"-";"-";"-";"-";"-";"-";"-";"-";"-";"-";"-";"-";"-"
"05 Mar 2024 23:57:42";" Zamknięcie Transakcji";"O2-CP-8X4VZ9";"T2-CP-5C0Y8R";"O2-CP-8X4QE7";"Solana (USD)";"50 Jednost.";"121,942";"-";"-";"-";"-";"3,992038";"24 339,85";"-751,50";"11 093,95";"-";"-";"-";"-";"-";"-";"-";"-";"-";"-";"-";"-";"-";"-";"-";"-";"-";"-";"-";"-";"-";"-";"-";"-"
"05 Mar 2024 23:01:14";"Koszty Utrzymania Pozycji";"1313902230";"-";"-";"Rachunek";"-";"-";"-";"-";"-";"-";"-";"-";"6,57";"11 845,45";"-";"-";"-";"-";"-";"6,57";"-";"-";"-";"-";"-";"-";"-";"-";"-";"-";"-";"-";"-";"-";"-";"-";"-";"-"
"05 Mar 2024 23:01:14";"Koszty Utrzymania Pozycji";"O2-CP-8X4QE7";"-";"-";"Solana (USD)";"-";"-";"-";"-";"-";"-";"-";"-";"-";"-";"-";"-";"6 070,50";"-10,00000%";"6,57";"6,57";"-";"-";"-";"-";"-";"-";"-";"-";"-";"-";"-";"-";"-";"-";"-";"-";"-";"-"
"05 Mar 2024 21:44:40";"Zmodyfikowano Transakcję Sprzedaży";"O2-CP-8X4QE7";"T2-CP-5C0T9R";"-";"Solana (USD)";"50 Jednost.";"118,177";"-";"-";"114,800";"-";"-";"-";"0,00";"-";"-";"-";"-";"-";"-";"-";"-";"-";"-";"-";"-";"-";"-";"-";"-";"-";"-";"-";"-";"-";"-";"-";"-";"-"
"05 Mar 2024 21:42:27";"Transakcja Sprzedaży";"O2-CP-8X4QE7";"T2-CP-5C0T9R";"-";"Solana (USD)";"50 Jednost.";"118,177";"-";"-";"-";"-";"3,99301";"23 594,09";"0,00";"-";"-";"-";"-";"-";"-";"-";"-";"-";"-";"-";"-";"-";"-";"-";"-";"-";"-";"-";"-";"-";"-";"-";"-";"-"
"05 Mar 2024 21:40:52";" Zamknięcie Transakcji";"O2-CP-8X4Q9Z";"T2-CP-5C0T6B";"O2-CP-8X4Q7M";"Solana (USD)";"45 Jednost.";"118,488";"-";"-";"-";"-";"3,95309";"21 289,49";"92,86";"11 838,88";"-";"-";"-";"-";"-";"-";"-";"-";"-";"-";"-";"-";"-";"-";"-";"-";"-";"-";"-";"-";"-";"-";"-";"-"
"05 Mar 2024 21:40:15";"Zmodyfikowano Transakcję Sprzedaży";"O2-CP-8X4Q7M";"T2-CP-5C0T4J";"-";"Solana (USD)";"45 Jednost.";"119,010";"-";"-";"117,820";"-";"-";"-";"0,00";"-";"-";"-";"-";"-";"-";"-";"-";"-";"-";"-";"-";"-";"-";"-";"-";"-";"-";"-";"-";"-";"-";"-";"-";"-"
"05 Mar 2024 21:39:38";"Transakcja Sprzedaży";"O2-CP-8X4Q7M";"T2-CP-5C0T4J";"-";"Solana (USD)";"45 Jednost.";"119,010";"-";"-";"-";"-";"3,99307";"21 384,68";"0,00";"-";"-";"-";"-";"-";"-";"-";"-";"-";"-";"-";"-";"-";"-";"-";"-";"-";"-";"-";"-";"-";"-";"-";"-";"-"
"05 Mar 2024 15:49:03";"Take Profit";"O2-CP-8X1F1P";"T2-CP-5BZP0H";"-";"Solana (USD)";"41,6 Jednost.";"136,900";"-";"-";"-";"-";"3,96311";"22 796,89";"787,23";"11 746,02";"-";"-";"-";"-";"-";"-";"-";"-";"-";"-";"-";"-";"-";"-";"-";"-";"-";"-";"-";"-";"-";"-";"-";"-"
"04 Mar 2024 23:01:08";"Koszty Utrzymania Pozycji";"1313409683";"-";"-";"Rachunek";"-";"-";"-";"-";"-";"-";"-";"-";"-16,37";"10 958,79";"-";"-";"-";"-";"-";"-16,37";"-";"-";"-";"-";"-";"-";"-";"-";"-";"-";"-";"-";"-";"-";"-";"-";"-";"-"
"04 Mar 2024 23:01:08";"Koszty Utrzymania Pozycji";"O2-CP-8X1F1P";"-";"-";"Solana (USD)";"-";"-";"-";"-";"-";"-";"-";"-";"-";"-";"-";"-";"5 431,29";"-27,50000%";"-16,37";"-16,37";"-";"-";"-";"-";"-";"-";"-";"-";"-";"-";"-";"-";"-";"-";"-";"-";"-";"-"
"04 Mar 2024 15:59:28";" Zmodyfikowano Transakcję Kupna";"O2-CP-8X1F1P";"T2-CP-5BXY5B";"-";"Solana (USD)";"41,6 Jednost.";"132,125";"-";"-";"136,900";"-";"-";"-";"0,00";"-";"-";"-";"-";"-";"-";"-";"-";"-";"-";"-";"-";"-";"-";"-";"-";"-";"-";"-";"-";"-";"-";"-";"-";"-"
"04 Mar 2024 15:58:19";" Transakcja Kupna";"O2-CP-8X1F1P";"T2-CP-5BXY5B";"-";"Solana (USD)";"41,6 Jednost.";"132,125";"-";"-";"-";"-";"3,99806";"21 974,93";"0,00";"-";"-";"-";"-";"-";"-";"-";"-";"-";"-";"-";"-";"-";"-";"-";"-";"-";"-";"-";"-";"-";"-";"-";"-";"-"
"04 Mar 2024 15:47:27";"Stop Loss";"O2-CP-8X1CF6";"T2-CP-5BXWZ5";"-";"Solana (USD)";"41 Jednost.";"131,675";"-";"-";"-";"-";"3,96129";"21 600,61";"50,35";"10 975,16";"-";"-";"-";"-";"-";"-";"-";"-";"-";"-";"-";"-";"-";"-";"-";"-";"-";"-";"-";"-";"-";"-";"-";"-"
"04 Mar 2024 15:45:00";" Zmodyfikowano Transakcję Kupna";"O2-CP-8X1CF6";"T2-CP-5BXVZH";"-";"Solana (USD)";"41 Jednost.";"131,365";"-";"131,700";"135,800";"-";"-";"-";"0,00";"-";"-";"-";"-";"-";"-";"-";"-";"-";"-";"-";"-";"-";"-";"-";"-";"-";"-";"-";"-";"-";"-";"-";"-";"-"
"04 Mar 2024 15:38:35";" Zmodyfikowano Transakcję Kupna";"O2-CP-8X1CF6";"T2-CP-5BXVZH";"-";"Solana (USD)";"41 Jednost.";"131,365";"-";"-";"135,800";"-";"-";"-";"0,00";"-";"-";"-";"-";"-";"-";"-";"-";"-";"-";"-";"-";"-";"-";"-";"-";"-";"-";"-";"-";"-";"-";"-";"-";"-"
"04 Mar 2024 15:37:44";" Transakcja Kupna";"O2-CP-8X1CF6";"T2-CP-5BXVZH";"-";"Solana (USD)";"41 Jednost.";"131,365";"-";"-";"-";"-";"4,000495";"21 546,52";"0,00";"-";"-";"-";"-";"-";"-";"-";"-";"-";"-";"-";"-";"-";"-";"-";"-";"-";"-";"-";"-";"-";"-";"-";"-";"-"
"04 Mar 2024 15:36:40";"Odrzucono Zlecenie: brak wystarczających środków";"O2-CP-8X1C98";"-";"-";"Solana (USD)";"42 Jednost.";"-";"-";"-";"-";"-";"-";"-";"-";"-";"-";"-";"-";"-";"-";"-";"-";"-";"-";"-";"-";"-";"-";"-";"-";"-";"-";"-";"-";"-";"-";"-";"-";"-"
"04 Mar 2024 15:05:57";" Zamknięcie Transakcji";"O2-CP-8X1882";"T2-CP-5BXS3N";"O2-CP-8X1846";"Solana (USD)";"42 Jednost.";"130,230";"-";"-";"-";"-";"3,96241";"21 890,88";"6,66";"10 924,81";"-";"-";"-";"-";"-";"-";"-";"-";"-";"-";"-";"-";"-";"-";"-";"-";"-";"-";"-";"-";"-";"-";"-";"-"
"04 Mar 2024 15:05:14";" Zmodyfikowano Transakcję Kupna";"O2-CP-8X1846";"T2-CP-5BXS0M";"-";"Solana (USD)";"42 Jednost.";"130,190";"-";"-";"135,000";"-";"-";"-";"0,00";"-";"-";"-";"-";"-";"-";"-";"-";"-";"-";"-";"-";"-";"-";"-";"-";"-";"-";"-";"-";"-";"-";"-";"-";"-"
"04 Mar 2024 15:04:05";" Transakcja Kupna";"O2-CP-8X1846";"T2-CP-5BXS0M";"-";"Solana (USD)";"42 Jednost.";"130,190";"-";"-";"-";"-";"4,002689";"21 886,62";"0,00";"-";"-";"-";"-";"-";"-";"-";"-";"-";"-";"-";"-";"-";"-";"-";"-";"-";"-";"-";"-";"-";"-";"-";"-";"-"
"04 Mar 2024 14:58:56";"Take Profit";"O2-CP-8X0Q15";"T2-CP-5BXRKL";"-";"Solana (USD)";"41 Jednost.";"130,800";"-";"-";"-";"-";"3,963";"21 466,31";"21,29";"10 918,15";"-";"-";"-";"-";"-";"-";"-";"-";"-";"-";"-";"-";"-";"-";"-";"-";"-";"-";"-";"-";"-";"-";"-";"-"
"04 Mar 2024 11:44:37";"Zmodyfikowano Take Profit";"O2-CP-8X0Q15";"-";"O2-CP-8X0Q4G";"Solana (USD)";"41 Jednost.";"130,931";"-";"-";"130,800";"-";"-";"-";"-";"-";"-";"-";"-";"-";"-";"-";"-";"-";"-";"-";"-";"-";"-";"-";"-";"-";"-";"-";"-";"-";"-";"-";"-";"-"
"04 Mar 2024 10:14:06";"Zmodyfikowano Transakcję Sprzedaży";"O2-CP-8X0Q15";"T2-CP-5BXD7L";"-";"Solana (USD)";"41 Jednost.";"130,931";"-";"-";"129,900";"-";"-";"-";"0,00";"-";"-";"-";"-";"-";"-";"-";"-";"-";"-";"-";"-";"-";"-";"-";"-";"-";"-";"-";"-";"-";"-";"-";"-";"-"
"04 Mar 2024 10:11:42";"Transakcja Sprzedaży";"O2-CP-8X0Q15";"T2-CP-5BXD7L";"-";"Solana (USD)";"41 Jednost.";"130,931";"-";"-";"-";"-";"4,004693";"21 497,87";"0,00";"-";"-";"-";"-";"-";"-";"-";"-";"-";"-";"-";"-";"-";"-";"-";"-";"-";"-";"-";"-";"-";"-";"-";"-";"-"
"01 Mar 2024 18:46:14";" Zamknięcie Transakcji";"O2-CP-8WZLTB";"T2-CP-5BWH83";"O2-CP-8WZ6EF";"Solana (USD)";"40 Jednost.";"132,090";"-";"-";"-";"-";"3,96483";"21 159,09";"19,82";"10 896,86";"-";"-";"-";"-";"-";"-";"-";"-";"-";"-";"-";"-";"-";"-";"-";"-";"-";"-";"-";"-";"-";"-";"-";"-"
"01 Mar 2024 16:37:39";" Transakcja Kupna";"O2-CP-8WZ6EF";"T2-CP-5BW3C5";"-";"Solana (USD)";"40 Jednost.";"131,965";"-";"-";"-";"-";"4,00301";"21 130,28";"0,00";"-";"-";"-";"-";"-";"-";"-";"-";"-";"-";"-";"-";"-";"-";"-";"-";"-";"-";"-";"-";"-";"-";"-";"-";"-"
"01 Mar 2024 16:14:32";" Zamknięcie Transakcji";"O2-CP-8WZ1ZT";"T2-CP-5BVZCD";"O2-CP-8WYZTR";"Solana (USD)";"40 Jednost.";"133,025";"-";"-";"-";"-";"3,97261";"21 350,72";"126,49";"10 877,04";"-";"-";"-";"-";"-";"-";"-";"-";"-";"-";"-";"-";"-";"-";"-";"-";"-";"-";"-";"-";"-";"-";"-";"-"
"01 Mar 2024 16:05:52";" Transakcja Kupna";"O2-CP-8WYZTR";"T2-CP-5BVXE2";"-";"Solana (USD)";"40 Jednost.";"132,229";"-";"-";"-";"-";"4,014713";"21 234,45";"0,00";"-";"-";"-";"-";"-";"-";"-";"-";"-";"-";"-";"-";"-";"-";"-";"-";"-";"-";"-";"-";"-";"-";"-";"-";"-"
"01 Mar 2024 16:02:00";"Stop Loss";"O2-CP-8WYX48";"T2-CP-5BVWJD";"-";"Solana (USD)";"39 Jednost.";"133,040";"-";"-";"-";"-";"3,97296";"20 821,11";"195,23";"10 750,55";"-";"-";"-";"-";"-";"-";"-";"-";"-";"-";"-";"-";"-";"-";"-";"-";"-";"-";"-";"-";"-";"-";"-";"-"
"01 Mar 2024 16:01:55";"Zmodyfikowano Stop Loss";"O2-CP-8WYX48";"-";"O2-CP-8WYY3E";"Solana (USD)";"39 Jednost.";"131,780";"-";"133,100";"-";"-";"-";"-";"-";"-";"-";"-";"-";"-";"-";"-";"-";"-";"-";"-";"-";"-";"-";"-";"-";"-";"-";"-";"-";"-";"-";"-";"-";"-"
"01 Mar 2024 16:01:23";"Zmodyfikowano Stop Loss";"O2-CP-8WYX48";"-";"O2-CP-8WYY3E";"Solana (USD)";"39 Jednost.";"131,780";"-";"132,800";"-";"-";"-";"-";"-";"-";"-";"-";"-";"-";"-";"-";"-";"-";"-";"-";"-";"-";"-";"-";"-";"-";"-";"-";"-";"-";"-";"-";"-";"-"
"01 Mar 2024 16:00:52";"Zmodyfikowano Stop Loss";"O2-CP-8WYX48";"-";"O2-CP-8WYY3E";"Solana (USD)";"39 Jednost.";"131,780";"-";"132,600";"-";"-";"-";"-";"-";"-";"-";"-";"-";"-";"-";"-";"-";"-";"-";"-";"-";"-";"-";"-";"-";"-";"-";"-";"-";"-";"-";"-";"-";"-"
"01 Mar 2024 16:00:06";" Zmodyfikowano Transakcję Kupna";"O2-CP-8WYX48";"T2-CP-5BVTSS";"-";"Solana (USD)";"39 Jednost.";"131,780";"-";"132,300";"-";"-";"-";"-";"0,00";"-";"-";"-";"-";"-";"-";"-";"-";"-";"-";"-";"-";"-";"-";"-";"-";"-";"-";"-";"-";"-";"-";"-";"-";"-"
"01 Mar 2024 15:54:33";" Transakcja Kupna";"O2-CP-8WYX48";"T2-CP-5BVTSS";"-";"Solana (USD)";"39 Jednost.";"131,780";"-";"-";"-";"-";"4,021436";"20 667,84";"0,00";"-";"-";"-";"-";"-";"-";"-";"-";"-";"-";"-";"-";"-";"-";"-";"-";"-";"-";"-";"-";"-";"-";"-";"-";"-"
"01 Mar 2024 15:53:26";" Zamknięcie Transakcji";"O2-CP-8WYWZD";"T2-CP-5BVTNB";"O2-CP-8WYVBP";"Solana (USD)";"39 Jednost.";"131,872";"-";"-";"-";"-";"3,98158";"20 683,05";"26,09";"10 555,32";"-";"-";"-";"-";"-";"-";"-";"-";"-";"-";"-";"-";"-";"-";"-";"-";"-";"-";"-";"-";"-";"-";"-";"-"
"01 Mar 2024 15:44:11";"Transakcja Sprzedaży";"O2-CP-8WYVBP";"T2-CP-5BVS1H";"-";"Solana (USD)";"39 Jednost.";"132,040";"-";"-";"-";"-";"4,015314";"20 677,10";"0,00";"-";"-";"-";"-";"-";"-";"-";"-";"-";"-";"-";"-";"-";"-";"-";"-";"-";"-";"-";"-";"-";"-";"-";"-";"-"
"01 Mar 2024 15:41:07";" Zamknięcie Transakcji";"O2-CP-8WYTJR";"T2-CP-5BVRCP";"O2-CP-8WY315";"Solana (USD)";"38 Jednost.";"132,320";"-";"-";"-";"-";"3,97441";"20 184,80";"107,98";"10 529,23";"-";"-";"-";"-";"-";"-";"-";"-";"-";"-";"-";"-";"-";"-";"-";"-";"-";"-";"-";"-";"-";"-";"-";"-"
"01 Mar 2024 10:54:21";"Zmodyfikowano Transakcję Sprzedaży";"O2-CP-8WY315";"T2-CP-5BV4RZ";"-";"Solana (USD)";"38 Jednost.";"133,035";"-";"-";"128,800";"-";"-";"-";"0,00";"-";"-";"-";"-";"-";"-";"-";"-";"-";"-";"-";"-";"-";"-";"-";"-";"-";"-";"-";"-";"-";"-";"-";"-";"-"
"01 Mar 2024 10:12:17";"Transakcja Sprzedaży";"O2-CP-8WY315";"T2-CP-5BV4RZ";"-";"Solana (USD)";"38 Jednost.";"133,035";"-";"-";"-";"-";"4,016306";"20 303,75";"0,00";"-";"-";"-";"-";"-";"-";"-";"-";"-";"-";"-";"-";"-";"-";"-";"-";"-";"-";"-";"-";"-";"-";"-";"-";"-"
"01 Mar 2024 02:03:02";"Take Profit";"O2-CP-8WWX66";"T2-CP-5BTNZR";"-";"Solana (USD)";"38 Jednost.";"133,500";"-";"-";"-";"-";"3,97109";"20 347,78";"339,53";"10 421,25";"-";"-";"-";"-";"-";"-";"-";"-";"-";"-";"-";"-";"-";"-";"-";"-";"-";"-";"-";"-";"-";"-";"-";"-"
"01 Mar 2024 00:12:49";"Zmodyfikowano Take Profit";"O2-CP-8WWX66";"-";"O2-CP-8WX2DK";"Solana (USD)";"38 Jednost.";"131,250";"-";"-";"133,500";"-";"-";"-";"-";"-";"-";"-";"-";"-";"-";"-";"-";"-";"-";"-";"-";"-";"-";"-";"-";"-";"-";"-";"-";"-";"-";"-";"-";"-"
"29 Luty 2024 23:42:10";"Zmodyfikowano Take Profit";"O2-CP-8WWX66";"-";"O2-CP-8WX2DK";"Solana (USD)";"38 Jednost.";"131,250";"-";"-";"132,500";"-";"-";"-";"-";"-";"-";"-";"-";"-";"-";"-";"-";"-";"-";"-";"-";"-";"-";"-";"-";"-";"-";"-";"-";"-";"-";"-";"-";"-"
"29 Luty 2024 23:26:53";"Zmodyfikowano Take Profit";"O2-CP-8WWX66";"-";"O2-CP-8WX2DK";"Solana (USD)";"38 Jednost.";"131,250";"-";"-";"131,400";"-";"-";"-";"-";"-";"-";"-";"-";"-";"-";"-";"-";"-";"-";"-";"-";"-";"-";"-";"-";"-";"-";"-";"-";"-";"-";"-";"-";"-"
"29 Luty 2024 23:01:12";"Koszty Utrzymania Pozycji";"1312378003";"-";"-";"Rachunek";"-";"-";"-";"-";"-";"-";"-";"-";"-14,70";"10 081,72";"-";"-";"-";"-";"-";"-14,70";"-";"-";"-";"-";"-";"-";"-";"-";"-";"-";"-";"-";"-";"-";"-";"-";"-";"-"
"29 Luty 2024 23:01:12";"Koszty Utrzymania Pozycji";"O2-CP-8WWX66";"-";"-";"Solana (USD)";"-";"-";"-";"-";"-";"-";"-";"-";"-";"-";"-";"-";"4 859,55";"-27,50000%";"-14,70";"-14,70";"-";"-";"-";"-";"-";"-";"-";"-";"-";"-";"-";"-";"-";"-";"-";"-";"-";"-"
"29 Luty 2024 19:36:13";" Zmodyfikowano Transakcję Kupna";"O2-CP-8WWX66";"T2-CP-5BT4Y8";"-";"Solana (USD)";"38 Jednost.";"131,250";"-";"-";"133,400";"-";"-";"-";"0,00";"-";"-";"-";"-";"-";"-";"-";"-";"-";"-";"-";"-";"-";"-";"-";"-";"-";"-";"-";"-";"-";"-";"-";"-";"-"
"29 Luty 2024 18:07:03";" Transakcja Kupna";"O2-CP-8WWX66";"T2-CP-5BT4Y8";"-";"Solana (USD)";"38 Jednost.";"131,250";"-";"-";"-";"-";"4,015475";"20 027,18";"0,00";"-";"-";"-";"-";"-";"-";"-";"-";"-";"-";"-";"-";"-";"-";"-";"-";"-";"-";"-";"-";"-";"-";"-";"-";"-"
"29 Luty 2024 17:27:03";"Stop Loss";"O2-CP-8WTPW1";"T2-CP-5BT0NZ";"-";"Solana (USD)";"53 Jednost.";"129,202";"-";"-";"-";"-";"4,013751";"27 484,98";"-2 866,95";"10 096,42";"-";"-";"-";"-";"-";"-";"-";"-";"-";"-";"-";"-";"-";"-";"-";"-";"-";"-";"-";"-";"-";"-";"-";"-"
"29 Luty 2024 17:26:57";"Zmodyfikowano Transakcję Sprzedaży";"O2-CP-8WTPW1";"T2-CP-5BR91D";"-";"Solana (USD)";"53 Jednost.";"115,725";"-";"129,200";"-";"-";"-";"-";"0,00";"-";"-";"-";"-";"-";"-";"-";"-";"-";"-";"-";"-";"-";"-";"-";"-";"-";"-";"-";"-";"-";"-";"-";"-";"-"
"29 Luty 2024 16:17:55";"Zmodyfikowano Transakcję Sprzedaży";"O2-CP-8WTPW1";"T2-CP-5BR91D";"-";"Solana (USD)";"53 Jednost.";"115,725";"-";"-";"-";"-";"-";"-";"0,00";"-";"-";"-";"-";"-";"-";"-";"-";"-";"-";"-";"-";"-";"-";"-";"-";"-";"-";"-";"-";"-";"-";"-";"-";"-"
"28 Luty 2024 23:51:33";"Zmodyfikowano Transakcję Sprzedaży";"O2-CP-8WTPW1";"T2-CP-5BR91D";"-";"Solana (USD)";"53 Jednost.";"115,725";"-";"-";"114,000";"-";"-";"-";"0,00";"-";"-";"-";"-";"-";"-";"-";"-";"-";"-";"-";"-";"-";"-";"-";"-";"-";"-";"-";"-";"-";"-";"-";"-";"-"
"28 Luty 2024 23:50:53";"Transakcja Sprzedaży";"O2-CP-8WTPW1";"T2-CP-5BR91D";"-";"Solana (USD)";"53 Jednost.";"115,725";"-";"-";"-";"-";"4,003891";"24 557,56";"0,00";"-";"-";"-";"-";"-";"-";"-";"-";"-";"-";"-";"-";"-";"-";"-";"-";"-";"-";"-";"-";"-";"-";"-";"-";"-"
"28 Luty 2024 23:43:31";"Stop Loss";"O2-CP-8WTPSG";"T2-CP-5BR90F";"-";"Solana (USD)";"53 Jednost.";"115,900";"-";"-";"-";"-";"3,96519";"24 601,84";"111,38";"12 963,37";"-";"-";"-";"-";"-";"-";"-";"-";"-";"-";"-";"-";"-";"-";"-";"-";"-";"-";"-";"-";"-";"-";"-";"-"
"28 Luty 2024 23:42:30";"Zmodyfikowano Stop Loss";"O2-CP-8WTPSG";"-";"O2-CP-8WTPT7";"Solana (USD)";"53 Jednost.";"116,430";"-";"115,900";"-";"-";"-";"-";"-";"-";"-";"-";"-";"-";"-";"-";"-";"-";"-";"-";"-";"-";"-";"-";"-";"-";"-";"-";"-";"-";"-";"-";"-";"-"
"28 Luty 2024 23:41:37";"Zmodyfikowano Transakcję Sprzedaży";"O2-CP-8WTPSG";"T2-CP-5BR8ZX";"-";"Solana (USD)";"53 Jednost.";"116,430";"-";"116,100";"113,500";"-";"-";"-";"0,00";"-";"-";"-";"-";"-";"-";"-";"-";"-";"-";"-";"-";"-";"-";"-";"-";"-";"-";"-";"-";"-";"-";"-";"-";"-"
"28 Luty 2024 23:39:26";"Zmodyfikowano Transakcję Sprzedaży";"O2-CP-8WTPSG";"T2-CP-5BR8ZX";"-";"Solana (USD)";"53 Jednost.";"116,430";"-";"-";"113,500";"-";"-";"-";"0,00";"-";"-";"-";"-";"-";"-";"-";"-";"-";"-";"-";"-";"-";"-";"-";"-";"-";"-";"-";"-";"-";"-";"-";"-";"-"
"28 Luty 2024 23:38:11";"Transakcja Sprzedaży";"O2-CP-8WTPSG";"T2-CP-5BR8ZX";"-";"Solana (USD)";"53 Jednost.";"116,430";"-";"-";"-";"-";"4,004843";"24 713,04";"0,00";"-";"-";"-";"-";"-";"-";"-";"-";"-";"-";"-";"-";"-";"-";"-";"-";"-";"-";"-";"-";"-";"-";"-";"-";"-"
"28 Luty 2024 23:35:32";" Zamknięcie Transakcji";"O2-CP-8WTPRL";"T2-CP-5BR8Z0";"O2-CP-8WTPQ6";"Solana (USD)";"55 Jednost.";"115,856";"-";"-";"-";"-";"3,96446";"25 515,66";"52,55";"12 851,99";"-";"-";"-";"-";"-";"-";"-";"-";"-";"-";"-";"-";"-";"-";"-";"-";"-";"-";"-";"-";"-";"-";"-";"-"
"28 Luty 2024 23:33:59";"Zmodyfikowano Transakcję Sprzedaży";"O2-CP-8WTPQ6";"T2-CP-5BR8XP";"-";"Solana (USD)";"55 Jednost.";"116,097";"-";"-";"113,500";"-";"-";"-";"0,00";"-";"-";"-";"-";"-";"-";"-";"-";"-";"-";"-";"-";"-";"-";"-";"-";"-";"-";"-";"-";"-";"-";"-";"-";"-"
"28 Luty 2024 23:32:59";"Transakcja Sprzedaży";"O2-CP-8WTPQ6";"T2-CP-5BR8XP";"-";"Solana (USD)";"55 Jednost.";"116,097";"-";"-";"-";"-";"4,005354";"25 575,52";"0,00";"-";"-";"-";"-";"-";"-";"-";"-";"-";"-";"-";"-";"-";"-";"-";"-";"-";"-";"-";"-";"-";"-";"-";"-";"-"
"28 Luty 2024 19:53:07";" Zamknięcie Transakcji";"O2-CP-8WTF1J";"T2-CP-5BR1K6";"O2-CP-8WTD5H";"Solana (USD)";"50 Jednost.";"112,345";"-";"-";"-";"-";"3,96844";"22 515,73";"7,94";"12 799,44";"-";"-";"-";"-";"-";"-";"-";"-";"-";"-";"-";"-";"-";"-";"-";"-";"-";"-";"-";"-";"-";"-";"-";"-"
"28 Luty 2024 19:06:54";" Zmodyfikowano Transakcję Kupna";"O2-CP-8WTD5H";"T2-CP-5BQZVY";"-";"Solana (USD)";"50 Jednost.";"112,305";"-";"-";"114,000";"-";"-";"-";"0,00";"-";"-";"-";"-";"-";"-";"-";"-";"-";"-";"-";"-";"-";"-";"-";"-";"-";"-";"-";"-";"-";"-";"-";"-";"-"
"28 Luty 2024 19:06:09";" Transakcja Kupna";"O2-CP-8WTD5H";"T2-CP-5BQZVY";"-";"Solana (USD)";"50 Jednost.";"112,305";"-";"-";"-";"-";"4,005925";"22 494,27";"0,00";"-";"-";"-";"-";"-";"-";"-";"-";"-";"-";"-";"-";"-";"-";"-";"-";"-";"-";"-";"-";"-";"-";"-";"-";"-"
"28 Luty 2024 19:05:12";"Take Profit";"O2-CP-8WTCZG";"T2-CP-5BQZTR";"-";"Solana (USD)";"50 Jednost.";"112,600";"-";"-";"-";"-";"3,96614";"22 553,81";"231,03";"12 791,50";"-";"-";"-";"-";"-";"-";"-";"-";"-";"-";"-";"-";"-";"-";"-";"-";"-";"-";"-";"-";"-";"-";"-";"-"
"28 Luty 2024 19:04:56";"Zmodyfikowano Transakcję Sprzedaży";"O2-CP-8WTCZG";"T2-CP-5BQZPK";"-";"Solana (USD)";"50 Jednost.";"113,765";"-";"113,200";"112,600";"-";"-";"-";"0,00";"-";"-";"-";"-";"-";"-";"-";"-";"-";"-";"-";"-";"-";"-";"-";"-";"-";"-";"-";"-";"-";"-";"-";"-";"-"
"28 Luty 2024 19:02:03";"Zmodyfikowano Transakcję Sprzedaży";"O2-CP-8WTCZG";"T2-CP-5BQZPK";"-";"Solana (USD)";"50 Jednost.";"113,765";"-";"-";"112,600";"-";"-";"-";"0,00";"-";"-";"-";"-";"-";"-";"-";"-";"-";"-";"-";"-";"-";"-";"-";"-";"-";"-";"-";"-";"-";"-";"-";"-";"-"
"28 Luty 2024 19:01:16";"Transakcja Sprzedaży";"O2-CP-8WTCZG";"T2-CP-5BQZPK";"-";"Solana (USD)";"50 Jednost.";"113,765";"-";"-";"-";"-";"4,006356";"22 789,15";"0,00";"-";"-";"-";"-";"-";"-";"-";"-";"-";"-";"-";"-";"-";"-";"-";"-";"-";"-";"-";"-";"-";"-";"-";"-";"-"
"28 Luty 2024 19:00:53";" Zamknięcie Transakcji";"O2-CP-8WTCYY";"T2-CP-5BQZP2";"O2-CP-8WTCWQ";"Solana (USD)";"50 Jednost.";"114,090";"-";"-";"-";"-";"4,005946";"22 851,91";"-84,33";"12 560,47";"-";"-";"-";"-";"-";"-";"-";"-";"-";"-";"-";"-";"-";"-";"-";"-";"-";"-";"-";"-";"-";"-";"-";"-"
"28 Luty 2024 18:58:54";" Transakcja Kupna";"O2-CP-8WTCWQ";"T2-CP-5BQZM4";"-";"Solana (USD)";"50 Jednost.";"114,511";"-";"-";"-";"-";"4,005214";"22 932,05";"0,00";"-";"-";"-";"-";"-";"-";"-";"-";"-";"-";"-";"-";"-";"-";"-";"-";"-";"-";"-";"-";"-";"-";"-";"-";"-"
"28 Luty 2024 18:57:49";"Stop Loss";"O2-CP-8WTCSB";"T2-CP-5BQZL4";"-";"Solana (USD)";"50 Jednost.";"113,580";"-";"-";"-";"-";"3,96531";"22 745,32";"146,72";"12 644,80";"-";"-";"-";"-";"-";"-";"-";"-";"-";"-";"-";"-";"-";"-";"-";"-";"-";"-";"-";"-";"-";"-";"-";"-"
"28 Luty 2024 18:57:47";" Zmodyfikowano Transakcję Kupna";"O2-CP-8WTCSB";"T2-CP-5BQZJK";"-";"Solana (USD)";"50 Jednost.";"112,840";"-";"113,600";"115,000";"-";"-";"-";"0,00";"-";"-";"-";"-";"-";"-";"-";"-";"-";"-";"-";"-";"-";"-";"-";"-";"-";"-";"-";"-";"-";"-";"-";"-";"-"
"28 Luty 2024 18:56:32";" Zmodyfikowano Transakcję Kupna";"O2-CP-8WTCSB";"T2-CP-5BQZJK";"-";"Solana (USD)";"50 Jednost.";"112,840";"-";"-";"115,000";"-";"-";"-";"0,00";"-";"-";"-";"-";"-";"-";"-";"-";"-";"-";"-";"-";"-";"-";"-";"-";"-";"-";"-";"-";"-";"-";"-";"-";"-"
"28 Luty 2024 18:55:48";" Transakcja Kupna";"O2-CP-8WTCSB";"T2-CP-5BQZJK";"-";"Solana (USD)";"50 Jednost.";"112,840";"-";"-";"-";"-";"4,005294";"22 597,86";"0,00";"-";"-";"-";"-";"-";"-";"-";"-";"-";"-";"-";"-";"-";"-";"-";"-";"-";"-";"-";"-";"-";"-";"-";"-";"-"
"28 Luty 2024 18:50:33";" Zamknięcie Transakcji";"O2-CP-8WTCLH";"T2-CP-5BQZEK";"O2-CP-8WTC98";"Solana (USD)";"50 Jednost.";"111,550";"-";"-";"-";"-";"3,96488";"22 336,39";"86,43";"12 498,08";"-";"-";"-";"-";"-";"-";"-";"-";"-";"-";"-";"-";"-";"-";"-";"-";"-";"-";"-";"-";"-";"-";"-";"-"
"28 Luty 2024 18:44:46";" Transakcja Kupna";"O2-CP-8WTC98";"T2-CP-5BQZ3T";"-";"Solana (USD)";"50 Jednost.";"111,114";"-";"-";"-";"-";"4,005956";"22 255,88";"0,00";"-";"-";"-";"-";"-";"-";"-";"-";"-";"-";"-";"-";"-";"-";"-";"-";"-";"-";"-";"-";"-";"-";"-";"-";"-"
"28 Luty 2024 18:41:42";"Stop Loss";"O2-CP-8WTBW6";"T2-CP-5BQZ0C";"-";"Solana (USD)";"50 Jednost.";"109,910";"-";"-";"-";"-";"3,96667";"22 017,86";"41,65";"12 411,65";"-";"-";"-";"-";"-";"-";"-";"-";"-";"-";"-";"-";"-";"-";"-";"-";"-";"-";"-";"-";"-";"-";"-";"-"
"28 Luty 2024 18:41:41";"Zmodyfikowano Transakcję Sprzedaży";"O2-CP-8WTBW6";"T2-CP-5BQYSF";"-";"Solana (USD)";"50 Jednost.";"110,120";"-";"109,900";"108,700";"-";"-";"-";"0,00";"-";"-";"-";"-";"-";"-";"-";"-";"-";"-";"-";"-";"-";"-";"-";"-";"-";"-";"-";"-";"-";"-";"-";"-";"-"
"28 Luty 2024 18:37:53";"Zmodyfikowano Transakcję Sprzedaży";"O2-CP-8WTBW6";"T2-CP-5BQYSF";"-";"Solana (USD)";"50 Jednost.";"110,120";"-";"-";"108,700";"-";"-";"-";"0,00";"-";"-";"-";"-";"-";"-";"-";"-";"-";"-";"-";"-";"-";"-";"-";"-";"-";"-";"-";"-";"-";"-";"-";"-";"-"
"28 Luty 2024 18:36:54";"Transakcja Sprzedaży";"O2-CP-8WTBW6";"T2-CP-5BQYSF";"-";"Solana (USD)";"50 Jednost.";"110,120";"-";"-";"-";"-";"4,005445";"22 053,98";"0,00";"-";"-";"-";"-";"-";"-";"-";"-";"-";"-";"-";"-";"-";"-";"-";"-";"-";"-";"-";"-";"-";"-";"-";"-";"-"
"28 Luty 2024 18:32:05";" Zamknięcie Transakcji";"O2-CP-8WTBKP";"T2-CP-5BQYH5";"O2-CP-8WT3PH";"Solana (USD)";"50 Jednost.";"109,560";"-";"-";"-";"-";"3,96341";"21 929,74";"580,84";"12 370,00";"-";"-";"-";"-";"-";"-";"-";"-";"-";"-";"-";"-";"-";"-";"-";"-";"-";"-";"-";"-";"-";"-";"-";"-"
"28 Luty 2024 18:31:38";"Zmodyfikowano Transakcję Sprzedaży";"O2-CP-8WT3PH";"T2-CP-5BQRDH";"-";"Solana (USD)";"50 Jednost.";"112,491";"-";"111,200";"-";"-";"-";"-";"0,00";"-";"-";"-";"-";"-";"-";"-";"-";"-";"-";"-";"-";"-";"-";"-";"-";"-";"-";"-";"-";"-";"-";"-";"-";"-"
"28 Luty 2024 16:45:15";"Transakcja Sprzedaży";"O2-CP-8WT3PH";"T2-CP-5BQRDH";"-";"Solana (USD)";"50 Jednost.";"112,491";"-";"-";"-";"-";"4,00842";"22 545,55";"0,00";"-";"-";"-";"-";"-";"-";"-";"-";"-";"-";"-";"-";"-";"-";"-";"-";"-";"-";"-";"-";"-";"-";"-";"-";"-"
"28 Luty 2024 16:40:52";" Zamknięcie Transakcji";"O2-CP-8WT3D6";"T2-CP-5BQR3X";"O2-CP-8WSTXW";"Solana (USD)";"52 Jednost.";"112,552";"-";"-";"-";"-";"3,96656";"23 448,36";"0,41";"11 789,16";"-";"-";"-";"-";"-";"-";"-";"-";"-";"-";"-";"-";"-";"-";"-";"-";"-";"-";"-";"-";"-";"-";"-";"-"
"28 Luty 2024 15:12:12";" Transakcja Kupna";"O2-CP-8WSTXW";"T2-CP-5BQHEW";"-";"Solana (USD)";"52 Jednost.";"112,550";"-";"-";"-";"-";"4,001817";"23 421,03";"0,00";"-";"-";"-";"-";"-";"-";"-";"-";"-";"-";"-";"-";"-";"-";"-";"-";"-";"-";"-";"-";"-";"-";"-";"-";"-"
"28 Luty 2024 15:07:44";" Zamknięcie Transakcji";"O2-CP-8WSTNM";"T2-CP-5BQH7M";"O2-CP-8WSSWJ";"Solana (USD)";"51 Jednost.";"112,367";"-";"-";"-";"-";"3,96097";"22 927,30";"98,58";"11 788,75";"-";"-";"-";"-";"-";"-";"-";"-";"-";"-";"-";"-";"-";"-";"-";"-";"-";"-";"-";"-";"-";"-";"-";"-"
"28 Luty 2024 14:59:27";"Zmodyfikowano Transakcję Sprzedaży";"O2-CP-8WSSWJ";"T2-CP-5BQGJZ";"-";"Solana (USD)";"51 Jednost.";"112,855";"-";"-";"112,000";"-";"-";"-";"0,00";"-";"-";"-";"-";"-";"-";"-";"-";"-";"-";"-";"-";"-";"-";"-";"-";"-";"-";"-";"-";"-";"-";"-";"-";"-"
"28 Luty 2024 14:57:46";"Transakcja Sprzedaży";"O2-CP-8WSSWJ";"T2-CP-5BQGJZ";"-";"Solana (USD)";"51 Jednost.";"112,855";"-";"-";"-";"-";"4,003751";"23 044,00";"0,00";"-";"-";"-";"-";"-";"-";"-";"-";"-";"-";"-";"-";"-";"-";"-";"-";"-";"-";"-";"-";"-";"-";"-";"-";"-"
"28 Luty 2024 14:57:31";"Odrzucono Zlecenie: brak wystarczających środków";"O2-CP-8WSSVW";"-";"-";"Solana (USD)";"52 Jednost.";"-";"-";"-";"-";"-";"-";"-";"-";"-";"-";"-";"-";"-";"-";"-";"-";"-";"-";"-";"-";"-";"-";"-";"-";"-";"-";"-";"-";"-";"-";"-";"-";"-"
"28 Luty 2024 14:56:39";"Take Profit";"O2-CP-8WSR7X";"T2-CP-5BQGH5";"-";"Solana (USD)";"52 Jednost.";"112,710";"-";"-";"-";"-";"3,96441";"23 468,54";"7,63";"11 690,17";"-";"-";"-";"-";"-";"-";"-";"-";"-";"-";"-";"-";"-";"-";"-";"-";"-";"-";"-";"-";"-";"-";"-";"-"
"28 Luty 2024 14:53:58";"Zmodyfikowano Take Profit";"O2-CP-8WSR7X";"-";"O2-CP-8WSRPY";"Solana (USD)";"52 Jednost.";"112,673";"-";"-";"112,710";"-";"-";"-";"-";"-";"-";"-";"-";"-";"-";"-";"-";"-";"-";"-";"-";"-";"-";"-";"-";"-";"-";"-";"-";"-";"-";"-";"-";"-"
"28 Luty 2024 14:43:01";" Zmodyfikowano Transakcję Kupna";"O2-CP-8WSR7X";"T2-CP-5BQF5J";"-";"Solana (USD)";"52 Jednost.";"112,673";"-";"-";"112,800";"-";"-";"-";"0,00";"-";"-";"-";"-";"-";"-";"-";"-";"-";"-";"-";"-";"-";"-";"-";"-";"-";"-";"-";"-";"-";"-";"-";"-";"-"
"28 Luty 2024 14:36:59";" Transakcja Kupna";"O2-CP-8WSR7X";"T2-CP-5BQF5J";"-";"Solana (USD)";"52 Jednost.";"112,673";"-";"-";"-";"-";"3,997408";"23 420,79";"0,00";"-";"-";"-";"-";"-";"-";"-";"-";"-";"-";"-";"-";"-";"-";"-";"-";"-";"-";"-";"-";"-";"-";"-";"-";"-"
"28 Luty 2024 14:36:51";"Odrzucono Zlecenie: brak wystarczających środków";"O2-CP-8WSR7N";"-";"-";"Solana (USD)";"53 Jednost.";"-";"-";"-";"-";"-";"-";"-";"-";"-";"-";"-";"-";"-";"-";"-";"-";"-";"-";"-";"-";"-";"-";"-";"-";"-";"-";"-";"-";"-";"-";"-";"-";"-"
"28 Luty 2024 10:24:16";" Zamknięcie Transakcji";"O2-CP-8WSC2P";"T2-CP-5BQ3QW";"O2-CP-8WQXZS";"Solana (USD)";"50 Jednost.";"110,520";"-";"-";"-";"-";"3,96744";"22 144,38";"43,64";"11 682,54";"-";"-";"-";"-";"-";"-";"-";"-";"-";"-";"-";"-";"-";"-";"-";"-";"-";"-";"-";"-";"-";"-";"-";"-"
"27 Luty 2024 23:01:03";"Koszty Utrzymania Pozycji";"1311375612";"-";"-";"Rachunek";"-";"-";"-";"-";"-";"-";"-";"-";"-16,39";"11 638,90";"-";"-";"-";"-";"-";"-16,39";"-";"-";"-";"-";"-";"-";"-";"-";"-";"-";"-";"-";"-";"-";"-";"-";"-";"-"
"27 Luty 2024 23:01:03";"Koszty Utrzymania Pozycji";"O2-CP-8WQXZS";"-";"-";"Solana (USD)";"-";"-";"-";"-";"-";"-";"-";"-";"-";"-";"-";"-";"5 450,00";"-27,50000%";"-16,39";"-16,39";"-";"-";"-";"-";"-";"-";"-";"-";"-";"-";"-";"-";"-";"-";"-";"-";"-";"-"
"27 Luty 2024 16:35:13";" Zmodyfikowano Transakcję Kupna";"O2-CP-8WQXZS";"T2-CP-5BNYJT";"-";"Solana (USD)";"50 Jednost.";"110,300";"-";"-";"112,000";"-";"-";"-";"0,00";"-";"-";"-";"-";"-";"-";"-";"-";"-";"-";"-";"-";"-";"-";"-";"-";"-";"-";"-";"-";"-";"-";"-";"-";"-"
"27 Luty 2024 14:58:09";" Transakcja Kupna";"O2-CP-8WQXZS";"T2-CP-5BNYJT";"-";"Solana (USD)";"50 Jednost.";"110,300";"-";"-";"-";"-";"3,99832";"22 050,73";"0,00";"-";"-";"-";"-";"-";"-";"-";"-";"-";"-";"-";"-";"-";"-";"-";"-";"-";"-";"-";"-";"-";"-";"-";"-";"-"
"27 Luty 2024 14:56:54";" Zamknięcie Transakcji";"O2-CP-8WQXXP";"T2-CP-5BNYGL";"O2-CP-8WQWQH";"Solana (USD)";"53 Jednost.";"110,345";"-";"-";"-";"-";"3,99823";"23 382,78";"-208,73";"11 655,29";"-";"-";"-";"-";"-";"-";"-";"-";"-";"-";"-";"-";"-";"-";"-";"-";"-";"-";"-";"-";"-";"-";"-";"-"
"27 Luty 2024 14:34:16";"Transakcja Sprzedaży";"O2-CP-8WQWQH";"T2-CP-5BNXH2";"-";"Solana (USD)";"53 Jednost.";"109,360";"-";"-";"-";"-";"3,996256";"23 162,61";"0,00";"-";"-";"-";"-";"-";"-";"-";"-";"-";"-";"-";"-";"-";"-";"-";"-";"-";"-";"-";"-";"-";"-";"-";"-";"-"
"27 Luty 2024 14:34:01";"Odrzucono Zlecenie: brak wystarczających środków";"O2-CP-8WQWQ6";"-";"-";"Solana (USD)";"55 Jednost.";"-";"-";"-";"-";"-";"-";"-";"-";"-";"-";"-";"-";"-";"-";"-";"-";"-";"-";"-";"-";"-";"-";"-";"-";"-";"-";"-";"-";"-";"-";"-";"-";"-"
"27 Luty 2024 12:22:53";" Zamknięcie Transakcji";"O2-CP-8WQPW4";"T2-CP-5BNRF5";"O2-CP-8WQLR4";"Solana (USD)";"50 Jednost.";"111,135";"-";"-";"-";"-";"3,95386";"22 191,38";"0,99";"11 864,02";"-";"-";"-";"-";"-";"-";"-";"-";"-";"-";"-";"-";"-";"-";"-";"-";"-";"-";"-";"-";"-";"-";"-";"-"
"27 Luty 2024 11:19:27";"Zmodyfikowano Transakcję Sprzedaży";"O2-CP-8WQLR4";"T2-CP-5BNNWL";"-";"Solana (USD)";"50 Jednost.";"111,140";"-";"-";"110,700";"-";"-";"-";"0,00";"-";"-";"-";"-";"-";"-";"-";"-";"-";"-";"-";"-";"-";"-";"-";"-";"-";"-";"-";"-";"-";"-";"-";"-";"-"
"27 Luty 2024 11:06:55";"Transakcja Sprzedaży";"O2-CP-8WQLR4";"T2-CP-5BNNWL";"-";"Solana (USD)";"50 Jednost.";"111,140";"-";"-";"-";"-";"3,990114";"22 173,06";"0,00";"-";"-";"-";"-";"-";"-";"-";"-";"-";"-";"-";"-";"-";"-";"-";"-";"-";"-";"-";"-";"-";"-";"-";"-";"-"
"26 Luty 2024 23:31:16";" Zamknięcie Transakcji";"O2-CP-8WPZW2";"T2-CP-5BN5SD";"O2-CP-8WPZV3";"Solana (USD)";"53 Jednost.";"109,591";"-";"-";"-";"-";"3,95515";"23 203,68";"36,26";"11 863,03";"-";"-";"-";"-";"-";"-";"-";"-";"-";"-";"-";"-";"-";"-";"-";"-";"-";"-";"-";"-";"-";"-";"-";"-"
"26 Luty 2024 23:23:46";" Transakcja Kupna";"O2-CP-8WPZV3";"T2-CP-5BN5RN";"-";"Solana (USD)";"53 Jednost.";"109,418";"-";"-";"-";"-";"3,995154";"23 168,51";"0,00";"-";"-";"-";"-";"-";"-";"-";"-";"-";"-";"-";"-";"-";"-";"-";"-";"-";"-";"-";"-";"-";"-";"-";"-";"-"
"26 Luty 2024 23:12:13";" Zamknięcie Transakcji";"O2-CP-8WPZRQ";"T2-CP-5BN5QE";"O2-CP-8WPZ6V";"Solana (USD)";"53 Jednost.";"109,640";"-";"-";"-";"-";"3,9551";"23 213,71";"143,59";"11 826,77";"-";"-";"-";"-";"-";"-";"-";"-";"-";"-";"-";"-";"-";"-";"-";"-";"-";"-";"-";"-";"-";"-";"-";"-"
"26 Luty 2024 23:01:16";"Koszty Utrzymania Pozycji";"1311023915";"-";"-";"Rachunek";"-";"-";"-";"-";"-";"-";"-";"-";"-17,38";"11 683,18";"-";"-";"-";"-";"-";"-17,38";"-";"-";"-";"-";"-";"-";"-";"-";"-";"-";"-";"-";"-";"-";"-";"-";"-";"-"
"26 Luty 2024 23:01:16";"Koszty Utrzymania Pozycji";"O2-CP-8WPZ6V";"-";"-";"Solana (USD)";"-";"-";"-";"-";"-";"-";"-";"-";"-";"-";"-";"-";"5 778,27";"-27,50000%";"-17,38";"-17,38";"-";"-";"-";"-";"-";"-";"-";"-";"-";"-";"-";"-";"-";"-";"-";"-";"-";"-"
"26 Luty 2024 22:44:10";" Zmodyfikowano Transakcję Kupna";"O2-CP-8WPZ6V";"T2-CP-5BN58Y";"-";"Solana (USD)";"53 Jednost.";"108,955";"-";"-";"110,400";"-";"-";"-";"0,00";"-";"-";"-";"-";"-";"-";"-";"-";"-";"-";"-";"-";"-";"-";"-";"-";"-";"-";"-";"-";"-";"-";"-";"-";"-"
"26 Luty 2024 22:31:54";" Transakcja Kupna";"O2-CP-8WPZ6V";"T2-CP-5BN58Y";"-";"Solana (USD)";"53 Jednost.";"108,955";"-";"-";"-";"-";"3,990525";"23 043,74";"0,00";"-";"-";"-";"-";"-";"-";"-";"-";"-";"-";"-";"-";"-";"-";"-";"-";"-";"-";"-";"-";"-";"-";"-";"-";"-"
"26 Luty 2024 22:31:35";"Odrzucono Zlecenie: brak wystarczających środków";"O2-CP-8WPZ6R";"-";"-";"Solana (USD)";"55 Jednost.";"-";"-";"-";"-";"-";"-";"-";"-";"-";"-";"-";"-";"-";"-";"-";"-";"-";"-";"-";"-";"-";"-";"-";"-";"-";"-";"-";"-";"-";"-";"-";"-";"-"
"26 Luty 2024 22:29:45";" Zamknięcie Transakcji";"O2-CP-8WPZ5S";"T2-CP-5BN58D";"O2-CP-8WPRT8";"Solana (USD)";"50 Jednost.";"108,855";"-";"-";"-";"-";"3,95104";"21 720,68";"1,38";"11 700,56";"-";"-";"-";"-";"-";"-";"-";"-";"-";"-";"-";"-";"-";"-";"-";"-";"-";"-";"-";"-";"-";"-";"-";"-"
"26 Luty 2024 19:39:43";"Zmodyfikowano Transakcję Sprzedaży";"O2-CP-8WPRT8";"T2-CP-5BMZV3";"-";"Solana (USD)";"50 Jednost.";"108,862";"-";"-";"106,900";"-";"-";"-";"0,00";"-";"-";"-";"-";"-";"-";"-";"-";"-";"-";"-";"-";"-";"-";"-";"-";"-";"-";"-";"-";"-";"-";"-";"-";"-"
"26 Luty 2024 19:36:29";"Transakcja Sprzedaży";"O2-CP-8WPRT8";"T2-CP-5BMZV3";"-";"Solana (USD)";"50 Jednost.";"108,862";"-";"-";"-";"-";"3,997549";"21 759,05";"0,00";"-";"-";"-";"-";"-";"-";"-";"-";"-";"-";"-";"-";"-";"-";"-";"-";"-";"-";"-";"-";"-";"-";"-";"-";"-"
"26 Luty 2024 19:36:20";"Odrzucono Zlecenie: brak wystarczających środków";"O2-CP-8WPRSP";"-";"-";"Solana (USD)";"54 Jednost.";"-";"-";"-";"-";"-";"-";"-";"-";"-";"-";"-";"-";"-";"-";"-";"-";"-";"-";"-";"-";"-";"-";"-";"-";"-";"-";"-";"-";"-";"-";"-";"-";"-"
"26 Luty 2024 19:35:48";" Zamknięcie Transakcji";"O2-CP-8WPRRF";"T2-CP-5BMZSK";"O2-CP-8WPRF3";"Solana (USD)";"50 Jednost.";"109,110";"-";"-";"-";"-";"3,997068";"21 806,00";"-154,89";"11 699,18";"-";"-";"-";"-";"-";"-";"-";"-";"-";"-";"-";"-";"-";"-";"-";"-";"-";"-";"-";"-";"-";"-";"-";"-"
"26 Luty 2024 19:30:12";" Transakcja Kupna";"O2-CP-8WPRF3";"T2-CP-5BMZGW";"-";"Solana (USD)";"50 Jednost.";"109,885";"-";"-";"-";"-";"3,996717";"21 958,96";"0,00";"-";"-";"-";"-";"-";"-";"-";"-";"-";"-";"-";"-";"-";"-";"-";"-";"-";"-";"-";"-";"-";"-";"-";"-";"-"
"26 Luty 2024 15:49:31";" Zamknięcie Transakcji";"O2-CP-8WPB79";"T2-CP-5BMKSF";"O2-CP-8WP955";"Solana (USD)";"55 Jednost.";"103,270";"-";"-";"-";"-";"3,95045";"22 663,47";"116,24";"11 854,07";"-";"-";"-";"-";"-";"-";"-";"-";"-";"-";"-";"-";"-";"-";"-";"-";"-";"-";"-";"-";"-";"-";"-";"-"
"26 Luty 2024 15:41:42";" Transakcja Kupna";"O2-CP-8WP955";"T2-CP-5BMJSQ";"-";"Solana (USD)";"55 Jednost.";"102,735";"-";"-";"-";"-";"3,986908";"22 527,72";"0,00";"-";"-";"-";"-";"-";"-";"-";"-";"-";"-";"-";"-";"-";"-";"-";"-";"-";"-";"-";"-";"-";"-";"-";"-";"-"
"26 Luty 2024 15:22:44";" Zamknięcie Transakcji";"O2-CP-8WP6ZB";"T2-CP-5BMGSX";"O2-CP-8WP36F";"Solana (USD)";"50 Jednost.";"102,385";"-";"-";"-";"-";"3,94926";"20 420,44";"91,82";"11 737,83";"-";"-";"-";"-";"-";"-";"-";"-";"-";"-";"-";"-";"-";"-";"-";"-";"-";"-";"-";"-";"-";"-";"-";"-"
"26 Luty 2024 14:15:12";" Transakcja Kupna";"O2-CP-8WP36F";"T2-CP-5BMDFD";"-";"Solana (USD)";"50 Jednost.";"101,920";"-";"-";"-";"-";"3,985054";"20 307,83";"0,00";"-";"-";"-";"-";"-";"-";"-";"-";"-";"-";"-";"-";"-";"-";"-";"-";"-";"-";"-";"-";"-";"-";"-";"-";"-"
"26 Luty 2024 12:40:59";" Zamknięcie Transakcji";"O2-CP-8WNZ9J";"T2-CP-5BM8Z4";"O2-CN-8WMVKE";"Solana (USD)";"50 Jednost.";"100,917";"-";"-";"-";"-";"3,94809";"20 121,63";"19,35";"11 646,01";"-";"-";"-";"-";"-";"-";"-";"-";"-";"-";"-";"-";"-";"-";"-";"-";"-";"-";"-";"-";"-";"-";"-";"-"
"25 Luty 2024 20:20:10";"Zmodyfikowano Transakcję Sprzedaży";"O2-CN-8WMVKE";"T2-CN-5BLEVL";"-";"Solana (USD)";"50 Jednost.";"101,015";"-";"-";"100,100";"-";"-";"-";"0,00";"-";"-";"-";"-";"-";"-";"-";"-";"-";"-";"-";"-";"-";"-";"-";"-";"-";"-";"-";"-";"-";"-";"-";"-";"-"
"23 Luty 2024 23:01:13";"Koszty Utrzymania Pozycji";"1310635100";"-";"-";"Rachunek";"-";"-";"-";"-";"-";"-";"-";"-";"16,52";"11 626,66";"-";"-";"-";"-";"-";"16,52";"-";"-";"-";"-";"-";"-";"-";"-";"-";"-";"-";"-";"-";"-";"-";"-";"-";"-"
"23 Luty 2024 23:01:13";"Koszty Utrzymania Pozycji";"O2-CN-8WMVKE";"-";"-";"Solana (USD)";"-";"-";"-";"-";"-";"-";"-";"-";"-";"-";"-";"-";"5 076,25";"-10,00000%";"16,52";"16,52";"-";"-";"-";"-";"-";"-";"-";"-";"-";"-";"-";"-";"-";"-";"-";"-";"-";"-"
"23 Luty 2024 19:19:37";"Transakcja Sprzedaży";"O2-CN-8WMVKE";"T2-CN-5BLEVL";"-";"Solana (USD)";"50 Jednost.";"101,015";"-";"-";"-";"-";"3,9982";"20 193,90";"0,00";"-";"-";"-";"-";"-";"-";"-";"-";"-";"-";"-";"-";"-";"-";"-";"-";"-";"-";"-";"-";"-";"-";"-";"-";"-"
"23 Luty 2024 18:51:53";" Zamknięcie Transakcji";"O2-CN-8WMT2V";"T2-CN-5BLDGS";"O2-CN-8WMB7B";"Solana (USD)";"50 Jednost.";"101,095";"-";"-";"-";"-";"3,998921";"20 213,54";"-69,58";"11 610,14";"-";"-";"-";"-";"-";"-";"-";"-";"-";"-";"-";"-";"-";"-";"-";"-";"-";"-";"-";"-";"-";"-";"-";"-"
"23 Luty 2024 16:07:51";" Transakcja Kupna";"O2-CN-8WMB7B";"T2-CN-5BKY6K";"-";"Solana (USD)";"50 Jednost.";"101,443";"-";"-";"-";"-";"4,007759";"20 327,95";"0,00";"-";"-";"-";"-";"-";"-";"-";"-";"-";"-";"-";"-";"-";"-";"-";"-";"-";"-";"-";"-";"-";"-";"-";"-";"-"
"23 Luty 2024 16:02:08";" Zamknięcie Transakcji";"O2-CN-8WM9GM";"T2-CN-5BKXL4";"O2-CN-8WM97N";"Solana (USD)";"50 Jednost.";"101,811";"-";"-";"-";"-";"3,96601";"20 392,10";"9,32";"11 679,72";"-";"-";"-";"-";"-";"-";"-";"-";"-";"-";"-";"-";"-";"-";"-";"-";"-";"-";"-";"-";"-";"-";"-";"-"
"23 Luty 2024 16:00:39";"Transakcja Sprzedaży";"O2-CN-8WM97N";"T2-CN-5BKXCY";"-";"Solana (USD)";"50 Jednost.";"101,858";"-";"-";"-";"-";"4,005585";"20 400,04";"0,00";"-";"-";"-";"-";"-";"-";"-";"-";"-";"-";"-";"-";"-";"-";"-";"-";"-";"-";"-";"-";"-";"-";"-";"-";"-"
"23 Luty 2024 15:55:50";" Zamknięcie Transakcji";"O2-CN-8WM8BW";"T2-CN-5BKWHB";"O2-CN-8WM71L";"Solana (USD)";"50 Jednost.";"102,180";"-";"-";"-";"-";"3,96402";"20 455,67";"152,61";"11 670,40";"-";"-";"-";"-";"-";"-";"-";"-";"-";"-";"-";"-";"-";"-";"-";"-";"-";"-";"-";"-";"-";"-";"-";"-"
"23 Luty 2024 15:46:35";" Transakcja Kupna";"O2-CN-8WM71L";"T2-CN-5BKVC5";"-";"Solana (USD)";"50 Jednost.";"101,410";"-";"-";"-";"-";"4,00312";"20 297,81";"0,00";"-";"-";"-";"-";"-";"-";"-";"-";"-";"-";"-";"-";"-";"-";"-";"-";"-";"-";"-";"-";"-";"-";"-";"-";"-"
"23 Luty 2024 15:38:06";" Zamknięcie Transakcji";"O2-CN-8WM5WJ";"T2-CN-5BKTBD";"O2-CN-8WM3PX";"Solana (USD)";"50 Jednost.";"102,002";"-";"-";"-";"-";"3,9621";"20 410,17";"108,56";"11 517,79";"-";"-";"-";"-";"-";"-";"-";"-";"-";"-";"-";"-";"-";"-";"-";"-";"-";"-";"-";"-";"-";"-";"-";"-"
"23 Luty 2024 15:23:25";"Transakcja Sprzedaży";"O2-CN-8WM3PX";"T2-CN-5BKRDB";"-";"Solana (USD)";"50 Jednost.";"102,550";"-";"-";"-";"-";"4,004222";"20 531,64";"0,00";"-";"-";"-";"-";"-";"-";"-";"-";"-";"-";"-";"-";"-";"-";"-";"-";"-";"-";"-";"-";"-";"-";"-";"-";"-"
"23 Luty 2024 15:20:44";"Take Profit";"O2-CN-8WM20W";"T2-CN-5BKR6T";"-";"Solana (USD)";"40 Jednost.";"102,500";"-";"-";"-";"-";"3,96734";"16 429,55";"37,29";"11 409,23";"-";"-";"-";"-";"-";"-";"-";"-";"-";"-";"-";"-";"-";"-";"-";"-";"-";"-";"-";"-";"-";"-";"-";"-"
"23 Luty 2024 15:08:17";" Zmodyfikowano Transakcję Kupna";"O2-CN-8WM20W";"T2-CN-5BKPWD";"-";"Solana (USD)";"40 Jednost.";"102,265";"-";"-";"102,500";"-";"-";"-";"0,00";"-";"-";"-";"-";"-";"-";"-";"-";"-";"-";"-";"-";"-";"-";"-";"-";"-";"-";"-";"-";"-";"-";"-";"-";"-"
"23 Luty 2024 14:58:11";" Transakcja Kupna";"O2-CN-8WM20W";"T2-CN-5BKPWD";"-";"Solana (USD)";"40 Jednost.";"102,265";"-";"-";"-";"-";"4,002038";"16 370,73";"0,00";"-";"-";"-";"-";"-";"-";"-";"-";"-";"-";"-";"-";"-";"-";"-";"-";"-";"-";"-";"-";"-";"-";"-";"-";"-"
"23 Luty 2024 13:51:56";" Zamknięcie Transakcji";"O2-CN-8WLY3J";"T2-CN-5BKLHD";"O2-CN-8WLWSL";"Solana (USD)";"40 Jednost.";"101,550";"-";"-";"-";"-";"3,96184";"16 254,77";"8,72";"11 371,94";"-";"-";"-";"-";"-";"-";"-";"-";"-";"-";"-";"-";"-";"-";"-";"-";"-";"-";"-";"-";"-";"-";"-";"-"
"23 Luty 2024 13:28:54";" Transakcja Kupna";"O2-CN-8WLWSL";"T2-CN-5BKKB9";"-";"Solana (USD)";"40 Jednost.";"101,495";"-";"-";"-";"-";"4,001286";"16 244,42";"0,00";"-";"-";"-";"-";"-";"-";"-";"-";"-";"-";"-";"-";"-";"-";"-";"-";"-";"-";"-";"-";"-";"-";"-";"-";"-"
"23 Luty 2024 13:13:10";" Zamknięcie Transakcji";"O2-CN-8WLW59";"T2-CN-5BKJSW";"O2-CN-8WLTF8";"Solana (USD)";"40 Jednost.";"102,295";"-";"-";"-";"-";"3,9648";"16 386,19";"51,54";"11 363,22";"-";"-";"-";"-";"-";"-";"-";"-";"-";"-";"-";"-";"-";"-";"-";"-";"-";"-";"-";"-";"-";"-";"-";"-"
"23 Luty 2024 12:21:56";"Transakcja Sprzedaży";"O2-CN-8WLTF8";"T2-CN-5BKHGK";"-";"Solana (USD)";"40 Jednost.";"102,620";"-";"-";"-";"-";"4,007438";"16 449,73";"0,00";"-";"-";"-";"-";"-";"-";"-";"-";"-";"-";"-";"-";"-";"-";"-";"-";"-";"-";"-";"-";"-";"-";"-";"-";"-"
"16 Luty 2024 17:49:49";" Zamknięcie Transakcji";"O2-CN-8W9E4H";"T2-CN-5B9J1G";"O2-CN-8W92XE";"Solana (USD)";"42 Jednost.";"109,073";"-";"-";"-";"-";"4,04852";"18 546,53";"-53,22";"11 311,68";"-";"-";"-";"-";"-";"-";"-";"-";"-";"-";"-";"-";"-";"-";"-";"-";"-";"-";"-";"-";"-";"-";"-";"-"
"16 Luty 2024 16:16:41";"Transakcja Sprzedaży";"O2-CN-8W92XE";"T2-CN-5B9840";"-";"Solana (USD)";"42 Jednost.";"108,760";"-";"-";"-";"-";"4,050975";"18 504,52";"0,00";"-";"-";"-";"-";"-";"-";"-";"-";"-";"-";"-";"-";"-";"-";"-";"-";"-";"-";"-";"-";"-";"-";"-";"-";"-"
"16 Luty 2024 16:14:31";" Zamknięcie Transakcji";"O2-CN-8W92KC";"T2-CN-5B97V4";"O2-CN-8W91Q8";"Solana (USD)";"42 Jednost.";"108,245";"-";"-";"-";"-";"4,01027";"18 415,08";"139,46";"11 364,90";"-";"-";"-";"-";"-";"-";"-";"-";"-";"-";"-";"-";"-";"-";"-";"-";"-";"-";"-";"-";"-";"-";"-";"-"
"16 Luty 2024 16:09:51";"Transakcja Sprzedaży";"O2-CN-8W91Q8";"T2-CN-5B971C";"-";"Solana (USD)";"42 Jednost.";"109,073";"-";"-";"-";"-";"4,054292";"18 572,97";"0,00";"-";"-";"-";"-";"-";"-";"-";"-";"-";"-";"-";"-";"-";"-";"-";"-";"-";"-";"-";"-";"-";"-";"-";"-";"-"
"16 Luty 2024 16:02:08";" Zamknięcie Transakcji";"O2-CN-8W907J";"T2-CN-5B95SS";"O2-CN-8W8Y3S";"Solana (USD)";"40 Jednost.";"109,110";"-";"-";"-";"-";"4,01847";"17 714,49";"101,27";"11 225,44";"-";"-";"-";"-";"-";"-";"-";"-";"-";"-";"-";"-";"-";"-";"-";"-";"-";"-";"-";"-";"-";"-";"-";"-"
"16 Luty 2024 15:56:30";"Zmodyfikowano Transakcję Sprzedaży";"O2-CN-8W8Y3S";"T2-CN-5B93QK";"-";"Solana (USD)";"40 Jednost.";"109,740";"-";"-";"108,600";"-";"-";"-";"0,00";"-";"-";"-";"-";"-";"-";"-";"-";"-";"-";"-";"-";"-";"-";"-";"-";"-";"-";"-";"-";"-";"-";"-";"-";"-"
"16 Luty 2024 15:52:36";"Transakcja Sprzedaży";"O2-CN-8W8Y3S";"T2-CN-5B93QK";"-";"Solana (USD)";"40 Jednost.";"109,740";"-";"-";"-";"-";"4,060324";"17 823,19";"0,00";"-";"-";"-";"-";"-";"-";"-";"-";"-";"-";"-";"-";"-";"-";"-";"-";"-";"-";"-";"-";"-";"-";"-";"-";"-"
"16 Luty 2024 14:50:14";"Take Profit";"O2-CN-8W8MDD";"T2-CN-5B8W9T";"-";"Solana (USD)";"40 Jednost.";"111,900";"-";"-";"-";"-";"4,02635";"18 203,07";"39,46";"11 124,17";"-";"-";"-";"-";"-";"-";"-";"-";"-";"-";"-";"-";"-";"-";"-";"-";"-";"-";"-";"-";"-";"-";"-";"-"
"16 Luty 2024 14:41:51";"Zmodyfikowano Transakcję Sprzedaży";"O2-CN-8W8MDD";"T2-CN-5B8TQR";"-";"Solana (USD)";"40 Jednost.";"112,145";"-";"-";"111,900";"-";"-";"-";"0,00";"-";"-";"-";"-";"-";"-";"-";"-";"-";"-";"-";"-";"-";"-";"-";"-";"-";"-";"-";"-";"-";"-";"-";"-";"-"
"16 Luty 2024 14:38:17";"Transakcja Sprzedaży";"O2-CN-8W8MDD";"T2-CN-5B8TQR";"-";"Solana (USD)";"40 Jednost.";"112,145";"-";"-";"-";"-";"4,067278";"18 244,99";"0,00";"-";"-";"-";"-";"-";"-";"-";"-";"-";"-";"-";"-";"-";"-";"-";"-";"-";"-";"-";"-";"-";"-";"-";"-";"-"
"16 Luty 2024 14:36:34";" Zamknięcie Transakcji";"O2-CN-8W8LZE";"T2-CN-5B8TBQ";"O2-CN-8W8JFW";"Solana (USD)";"40 Jednost.";"111,900";"-";"-";"-";"-";"4,02813";"18 211,14";"118,43";"11 084,71";"-";"-";"-";"-";"-";"-";"-";"-";"-";"-";"-";"-";"-";"-";"-";"-";"-";"-";"-";"-";"-";"-";"-";"-"
"16 Luty 2024 14:24:16";"Transakcja Sprzedaży";"O2-CN-8W8JFW";"T2-CN-5B8QK7";"-";"Solana (USD)";"40 Jednost.";"112,635";"-";"-";"-";"-";"4,055745";"18 272,75";"0,00";"-";"-";"-";"-";"-";"-";"-";"-";"-";"-";"-";"-";"-";"-";"-";"-";"-";"-";"-";"-";"-";"-";"-";"-";"-"
"16 Luty 2024 13:38:33";" Zamknięcie Transakcji";"O2-CN-8W8GPS";"T2-CN-5B8NZ8";"O2-CN-8W81RL";"Solana (USD)";"40 Jednost.";"112,765";"-";"-";"-";"-";"4,00828";"18 261,48";"27,10";"10 966,28";"-";"-";"-";"-";"-";"-";"-";"-";"-";"-";"-";"-";"-";"-";"-";"-";"-";"-";"-";"-";"-";"-";"-";"-"
"16 Luty 2024 10:34:58";" Zmodyfikowano Transakcję Kupna";"O2-CN-8W81RL";"T2-CN-5B8B07";"-";"Solana (USD)";"40 Jednost.";"112,596";"-";"-";"113,000";"-";"-";"-";"0,00";"-";"-";"-";"-";"-";"-";"-";"-";"-";"-";"-";"-";"-";"-";"-";"-";"-";"-";"-";"-";"-";"-";"-";"-";"-"
"16 Luty 2024 08:20:35";" Transakcja Kupna";"O2-CN-8W81RL";"T2-CN-5B8B07";"-";"Solana (USD)";"40 Jednost.";"112,596";"-";"-";"-";"-";"4,055474";"18 265,20";"0,00";"-";"-";"-";"-";"-";"-";"-";"-";"-";"-";"-";"-";"-";"-";"-";"-";"-";"-";"-";"-";"-";"-";"-";"-";"-"
"15 Luty 2024 19:08:41";" Zamknięcie Transakcji";"O2-CN-8W7C2F";"T2-CN-5B7PW0";"O2-CN-8W79GM";"Solana (USD)";"40 Jednost.";"113,669";"-";"-";"-";"-";"4,01675";"18 446,74";"7,07";"10 939,18";"-";"-";"-";"-";"-";"-";"-";"-";"-";"-";"-";"-";"-";"-";"-";"-";"-";"-";"-";"-";"-";"-";"-";"-"
"15 Luty 2024 19:03:57";" Zmodyfikowano Transakcję Kupna";"O2-CN-8W79GM";"T2-CN-5B7NJ4";"-";"Solana (USD)";"40 Jednost.";"113,625";"-";"-";"114,200";"-";"-";"-";"0,00";"-";"-";"-";"-";"-";"-";"-";"-";"-";"-";"-";"-";"-";"-";"-";"-";"-";"-";"-";"-";"-";"-";"-";"-";"-"
"15 Luty 2024 18:40:52";" Transakcja Kupna";"O2-CN-8W79GM";"T2-CN-5B7NJ4";"-";"Solana (USD)";"40 Jednost.";"113,625";"-";"-";"-";"-";"4,057348";"18 440,64";"0,00";"-";"-";"-";"-";"-";"-";"-";"-";"-";"-";"-";"-";"-";"-";"-";"-";"-";"-";"-";"-";"-";"-";"-";"-";"-"
"15 Luty 2024 18:07:37";" Zamknięcie Transakcji";"O2-CN-8W77QJ";"T2-CN-5B7M3M";"O2-CN-8W76LN";"Solana (USD)";"40 Jednost.";"114,010";"-";"-";"-";"-";"4,01671";"18 501,89";"36,15";"10 932,11";"-";"-";"-";"-";"-";"-";"-";"-";"-";"-";"-";"-";"-";"-";"-";"-";"-";"-";"-";"-";"-";"-";"-";"-"
"15 Luty 2024 17:51:16";"Transakcja Sprzedaży";"O2-CN-8W76LN";"T2-CN-5B7L5L";"-";"Solana (USD)";"40 Jednost.";"114,235";"-";"-";"-";"-";"4,05841";"18 544,49";"0,00";"-";"-";"-";"-";"-";"-";"-";"-";"-";"-";"-";"-";"-";"-";"-";"-";"-";"-";"-";"-";"-";"-";"-";"-";"-"
"15 Luty 2024 17:41:00";" Zamknięcie Transakcji";"O2-CN-8W75SG";"T2-CN-5B7KHN";"O2-CN-8W75D8";"Solana (USD)";"40 Jednost.";"114,862";"-";"-";"-";"-";"4,01789";"18 645,59";"26,04";"10 895,96";"-";"-";"-";"-";"-";"-";"-";"-";"-";"-";"-";"-";"-";"-";"-";"-";"-";"-";"-";"-";"-";"-";"-";"-"
"15 Luty 2024 17:34:43";" Transakcja Kupna";"O2-CN-8W75D8";"T2-CN-5B7K3Q";"-";"Solana (USD)";"40 Jednost.";"114,700";"-";"-";"-";"-";"4,058891";"18 622,19";"0,00";"-";"-";"-";"-";"-";"-";"-";"-";"-";"-";"-";"-";"-";"-";"-";"-";"-";"-";"-";"-";"-";"-";"-";"-";"-"
"15 Luty 2024 13:06:37";" Zamknięcie Transakcji";"O2-CN-8W6995";"T2-CN-5B6SG5";"O2-CN-8W62PJ";"Solana (USD)";"40 Jednost.";"116,480";"-";"-";"-";"-";"4,02908";"18 960,94";"44,80";"10 869,92";"-";"-";"-";"-";"-";"-";"-";"-";"-";"-";"-";"-";"-";"-";"-";"-";"-";"-";"-";"-";"-";"-";"-";"-"
"15 Luty 2024 10:18:46";" Transakcja Kupna";"O2-CN-8W62PJ";"T2-CN-5B6MFC";"-";"Solana (USD)";"40 Jednost.";"116,202";"-";"-";"-";"-";"4,067579";"18 906,43";"0,00";"-";"-";"-";"-";"-";"-";"-";"-";"-";"-";"-";"-";"-";"-";"-";"-";"-";"-";"-";"-";"-";"-";"-";"-";"-"
"15 Luty 2024 09:34:27";" Zamknięcie Transakcji";"O2-CN-8W5ZYD";"T2-CN-5B6KCL";"O2-CN-8W5500";"Solana (USD)";"40 Jednost.";"115,545";"-";"-";"-";"-";"4,0245";"18 787,35";"17,06";"10 825,12";"-";"-";"-";"-";"-";"-";"-";"-";"-";"-";"-";"-";"-";"-";"-";"-";"-";"-";"-";"-";"-";"-";"-";"-"
"14 Luty 2024 23:00:57";"Koszty Utrzymania Pozycji";"1307567856";"-";"-";"Rachunek";"-";"-";"-";"-";"-";"-";"-";"-";"5,17";"10 808,06";"-";"-";"-";"-";"-";"5,17";"-";"-";"-";"-";"-";"-";"-";"-";"-";"-";"-";"-";"-";"-";"-";"-";"-";"-"
"14 Luty 2024 23:00:57";"Koszty Utrzymania Pozycji";"O2-CN-8W5500";"-";"-";"Solana (USD)";"-";"-";"-";"-";"-";"-";"-";"-";"-";"-";"-";"-";"4 683,60";"-10,00000%";"5,17";"5,17";"-";"-";"-";"-";"-";"-";"-";"-";"-";"-";"-";"-";"-";"-";"-";"-";"-";"-"
"14 Luty 2024 20:46:05";"Zmodyfikowano Transakcję Sprzedaży";"O2-CN-8W5500";"T2-CN-5B5W42";"-";"Solana (USD)";"40 Jednost.";"115,651";"-";"-";"114,600";"-";"-";"-";"0,00";"-";"-";"-";"-";"-";"-";"-";"-";"-";"-";"-";"-";"-";"-";"-";"-";"-";"-";"-";"-";"-";"-";"-";"-";"-"
"14 Luty 2024 19:32:46";"Transakcja Sprzedaży";"O2-CN-8W5500";"T2-CN-5B5W42";"-";"Solana (USD)";"40 Jednost.";"115,651";"-";"-";"-";"-";"4,065444";"18 806,90";"0,00";"-";"-";"-";"-";"-";"-";"-";"-";"-";"-";"-";"-";"-";"-";"-";"-";"-";"-";"-";"-";"-";"-";"-";"-";"-"
"14 Luty 2024 19:30:36";" Zamknięcie Transakcji";"O2-CN-8W54VE";"T2-CN-5B5VZQ";"O2-CN-8W51YJ";"Solana (USD)";"39 Jednost.";"115,635";"-";"-";"-";"-";"4,066647";"18 339,62";"-77,71";"10 802,89";"-";"-";"-";"-";"-";"-";"-";"-";"-";"-";"-";"-";"-";"-";"-";"-";"-";"-";"-";"-";"-";"-";"-";"-"
"14 Luty 2024 18:43:00";" Zmodyfikowano Transakcję Kupna";"O2-CN-8W51YJ";"T2-CN-5B5SJ9";"-";"Solana (USD)";"39 Jednost.";"116,125";"-";"-";"116,640";"-";"-";"-";"0,00";"-";"-";"-";"-";"-";"-";"-";"-";"-";"-";"-";"-";"-";"-";"-";"-";"-";"-";"-";"-";"-";"-";"-";"-";"-"
"14 Luty 2024 18:39:41";" Transakcja Kupna";"O2-CN-8W51YJ";"T2-CN-5B5SJ9";"-";"Solana (USD)";"39 Jednost.";"116,125";"-";"-";"-";"-";"4,065344";"18 411,43";"0,00";"-";"-";"-";"-";"-";"-";"-";"-";"-";"-";"-";"-";"-";"-";"-";"-";"-";"-";"-";"-";"-";"-";"-";"-";"-"
"14 Luty 2024 18:37:02";"Take Profit";"O2-CN-8W4V8M";"T2-CN-5B5SF1";"-";"Solana (USD)";"38 Jednost.";"116,200";"-";"-";"-";"-";"4,02536";"17 953,01";"5,35";"10 880,60";"-";"-";"-";"-";"-";"-";"-";"-";"-";"-";"-";"-";"-";"-";"-";"-";"-";"-";"-";"-";"-";"-";"-";"-"
"14 Luty 2024 18:31:16";"Zmodyfikowano Take Profit";"O2-CN-8W4V8M";"-";"O2-CN-8W4YYW";"Solana (USD)";"38 Jednost.";"116,235";"-";"-";"116,200";"-";"-";"-";"-";"-";"-";"-";"-";"-";"-";"-";"-";"-";"-";"-";"-";"-";"-";"-";"-";"-";"-";"-";"-";"-";"-";"-";"-";"-"
"14 Luty 2024 17:59:39";"Zmodyfikowano Transakcję Sprzedaży";"O2-CN-8W4V8M";"T2-CN-5B5M3W";"-";"Solana (USD)";"38 Jednost.";"116,235";"-";"-";"115,300";"-";"-";"-";"0,00";"-";"-";"-";"-";"-";"-";"-";"-";"-";"-";"-";"-";"-";"-";"-";"-";"-";"-";"-";"-";"-";"-";"-";"-";"-"
"14 Luty 2024 17:19:07";"Transakcja Sprzedaży";"O2-CN-8W4V8M";"T2-CN-5B5M3W";"-";"Solana (USD)";"38 Jednost.";"116,235";"-";"-";"-";"-";"4,06822";"17 969,04";"0,00";"-";"-";"-";"-";"-";"-";"-";"-";"-";"-";"-";"-";"-";"-";"-";"-";"-";"-";"-";"-";"-";"-";"-";"-";"-"
"14 Luty 2024 17:15:17";" Zamknięcie Transakcji";"O2-CN-8W4TWY";"T2-CN-5B5LTD";"O2-CN-8W4SM1";"Solana (USD)";"38 Jednost.";"116,515";"-";"-";"-";"-";"4,02672";"18 007,75";"29,84";"10 875,25";"-";"-";"-";"-";"-";"-";"-";"-";"-";"-";"-";"-";"-";"-";"-";"-";"-";"-";"-";"-";"-";"-";"-";"-"
"14 Luty 2024 17:02:37";"Transakcja Sprzedaży";"O2-CN-8W4SM1";"T2-CN-5B5KQF";"-";"Solana (USD)";"38 Jednost.";"116,710";"-";"-";"-";"-";"4,070995";"18 054,78";"0,00";"-";"-";"-";"-";"-";"-";"-";"-";"-";"-";"-";"-";"-";"-";"-";"-";"-";"-";"-";"-";"-";"-";"-";"-";"-"
"14 Luty 2024 16:22:56";" Zamknięcie Transakcji";"O2-CN-8W4MZT";"T2-CN-5B5FGS";"O2-CN-8W47M4";"Solana (USD)";"38 Jednost.";"117,180";"-";"-";"-";"-";"4,03079";"18 128,82";"53,61";"10 845,41";"-";"-";"-";"-";"-";"-";"-";"-";"-";"-";"-";"-";"-";"-";"-";"-";"-";"-";"-";"-";"-";"-";"-";"-"
"14 Luty 2024 14:52:43";"Transakcja Sprzedaży";"O2-CN-8W47M4";"T2-CN-5B55MY";"-";"Solana (USD)";"38 Jednost.";"117,530";"-";"-";"-";"-";"4,076907";"18 208,03";"0,00";"-";"-";"-";"-";"-";"-";"-";"-";"-";"-";"-";"-";"-";"-";"-";"-";"-";"-";"-";"-";"-";"-";"-";"-";"-"
"14 Luty 2024 12:07:39";" Wpłata";"1307401754";"BD.54728905";"-";"Rachunek";"-";"-";"-";"-";"-";"-";"-";"-";"3 000,00";"10 791,80";"3 000,00";"0,00";"-";"-";"-";"-";"-";"-";"-";"-";"-";"-";"-";"-";"-";"-";"-";"-";"-";"-";"-";"-";"-";"-"
"13 Luty 2024 11:12:31";" Zamknięcie Transakcji";"O2-CN-8W0D4H";"T2-CN-5B2D3C";"O2-CN-8VYYLL";"Solana (USD)";"38,5 Jednost.";"114,480";"-";"-";"-";"-";"4,032068";"17 771,25";"-756,77";"7 791,80";"-";"-";"-";"-";"-";"-";"-";"-";"-";"-";"-";"-";"-";"-";"-";"-";"-";"-";"-";"-";"-";"-";"-";"-"
"12 Luty 2024 23:03:58";"Zmodyfikowano Transakcję Sprzedaży";"O2-CN-8VYYLL";"T2-CN-5B1RBL";"-";"Solana (USD)";"38,5 Jednost.";"109,605";"-";"-";"108,800";"-";"-";"-";"0,00";"-";"-";"-";"-";"-";"-";"-";"-";"-";"-";"-";"-";"-";"-";"-";"-";"-";"-";"-";"-";"-";"-";"-";"-";"-"
"12 Luty 2024 23:01:08";"Koszty Utrzymania Pozycji";"1306717078";"-";"-";"Rachunek";"-";"-";"-";"-";"-";"-";"-";"-";"4,63";"8 548,57";"-";"-";"-";"-";"-";"4,63";"-";"-";"-";"-";"-";"-";"-";"-";"-";"-";"-";"-";"-";"-";"-";"-";"-";"-"
"12 Luty 2024 23:01:08";"Koszty Utrzymania Pozycji";"O2-CN-8VYYLL";"-";"-";"Solana (USD)";"-";"-";"-";"-";"-";"-";"-";"-";"-";"-";"-";"-";"4 245,58";"-10,00000%";"4,63";"4,63";"-";"-";"-";"-";"-";"-";"-";"-";"-";"-";"-";"-";"-";"-";"-";"-";"-";"-"
"12 Luty 2024 20:54:50";"Transakcja Sprzedaży";"O2-CN-8VYYLL";"T2-CN-5B1RBL";"-";"Solana (USD)";"38,5 Jednost.";"109,605";"-";"-";"-";"-";"4,022138";"16 972,58";"0,00";"-";"-";"-";"-";"-";"-";"-";"-";"-";"-";"-";"-";"-";"-";"-";"-";"-";"-";"-";"-";"-";"-";"-";"-";"-"
"12 Luty 2024 16:42:20";" Zamknięcie Transakcji";"O2-CN-8VY0PS";"T2-CN-5B18X6";"O2-CN-8VXYKE";"Solana (USD)";"38,5 Jednost.";"108,429";"-";"-";"-";"-";"3,99337";"16 837,95";"207,40";"8 543,94";"-";"-";"-";"-";"-";"-";"-";"-";"-";"-";"-";"-";"-";"-";"-";"-";"-";"-";"-";"-";"-";"-";"-";"-"
"12 Luty 2024 16:17:51";" Transakcja Kupna";"O2-CN-8VXYKE";"T2-CN-5B170B";"-";"Solana (USD)";"38,5 Jednost.";"107,080";"-";"-";"-";"-";"4,03304";"16 626,53";"0,00";"-";"-";"-";"-";"-";"-";"-";"-";"-";"-";"-";"-";"-";"-";"-";"-";"-";"-";"-";"-";"-";"-";"-";"-";"-"
"12 Luty 2024 16:09:47";" Zamknięcie Transakcji";"O2-CN-8VXXSR";"T2-CN-5B16B6";"O2-CN-8VXWLN";"Solana (USD)";"38,5 Jednost.";"107,245";"-";"-";"-";"-";"3,99107";"16 644,45";"86,82";"8 336,54";"-";"-";"-";"-";"-";"-";"-";"-";"-";"-";"-";"-";"-";"-";"-";"-";"-";"-";"-";"-";"-";"-";"-";"-"
"12 Luty 2024 15:58:19";" Transakcja Kupna";"O2-CN-8VXWLN";"T2-CN-5B15EF";"-";"Solana (USD)";"38,5 Jednost.";"106,680";"-";"-";"-";"-";"4,02809";"16 544,09";"0,00";"-";"-";"-";"-";"-";"-";"-";"-";"-";"-";"-";"-";"-";"-";"-";"-";"-";"-";"-";"-";"-";"-";"-";"-";"-"
"12 Luty 2024 15:52:02";" Zamknięcie Transakcji";"O2-CN-8VXVCJ";"T2-CN-5B14XX";"O2-CN-8VXKL4";"Solana (USD)";"38 Jednost.";"106,229";"-";"-";"-";"-";"3,98785";"16 259,50";"230,19";"8 249,72";"-";"-";"-";"-";"-";"-";"-";"-";"-";"-";"-";"-";"-";"-";"-";"-";"-";"-";"-";"-";"-";"-";"-";"-"
"12 Luty 2024 14:47:27";" Transakcja Kupna";"O2-CN-8VXKL4";"T2-CN-5B10GC";"-";"Solana (USD)";"38 Jednost.";"104,710";"-";"-";"-";"-";"4,034022";"16 051,29";"0,00";"-";"-";"-";"-";"-";"-";"-";"-";"-";"-";"-";"-";"-";"-";"-";"-";"-";"-";"-";"-";"-";"-";"-";"-";"-"
"09 Luty 2024 21:23:34";" Zamknięcie Transakcji";"O2-CM-8VWEY5";"T2-CM-5B0BRG";"O2-CM-8VQDCP";"Solana (USD)";"40 Jednost.";"105,155";"-";"-";"-";"-";"4,032148";"16 960,02";"-933,04";"8 019,53";"-";"-";"-";"-";"-";"-";"-";"-";"-";"-";"-";"-";"-";"-";"-";"-";"-";"-";"-";"-";"-";"-";"-";"-"
"08 Luty 2024 23:01:16";"Koszty Utrzymania Pozycji";"1305882518";"-";"-";"Rachunek";"-";"-";"-";"-";"-";"-";"-";"-";"4,50";"8 952,57";"-";"-";"-";"-";"-";"4,50";"-";"-";"-";"-";"-";"-";"-";"-";"-";"-";"-";"-";"-";"-";"-";"-";"-";"-"
"08 Luty 2024 23:01:16";"Koszty Utrzymania Pozycji";"O2-CM-8VQDCP";"-";"-";"Solana (USD)";"-";"-";"-";"-";"-";"-";"-";"-";"-";"-";"-";"-";"4 110,00";"-10,00000%";"4,50";"4,50";"-";"-";"-";"-";"-";"-";"-";"-";"-";"-";"-";"-";"-";"-";"-";"-";"-";"-"
"07 Luty 2024 23:05:15";"Zmodyfikowano Take Profit";"O2-CM-8VQDCP";"-";"O2-CM-8VQE7J";"Solana (USD)";"40 Jednost.";"99,370";"-";"-";"97,100";"-";"-";"-";"-";"-";"-";"-";"-";"-";"-";"-";"-";"-";"-";"-";"-";"-";"-";"-";"-";"-";"-";"-";"-";"-";"-";"-";"-";"-"
"07 Luty 2024 23:01:25";"Koszty Utrzymania Pozycji";"1305306423";"-";"-";"Rachunek";"-";"-";"-";"-";"-";"-";"-";"-";"4,42";"8 948,07";"-";"-";"-";"-";"-";"4,42";"-";"-";"-";"-";"-";"-";"-";"-";"-";"-";"-";"-";"-";"-";"-";"-";"-";"-"
"07 Luty 2024 23:01:25";"Koszty Utrzymania Pozycji";"O2-CM-8VQDCP";"-";"-";"Solana (USD)";"-";"-";"-";"-";"-";"-";"-";"-";"-";"-";"-";"-";"4 023,20";"-10,00000%";"4,42";"4,42";"-";"-";"-";"-";"-";"-";"-";"-";"-";"-";"-";"-";"-";"-";"-";"-";"-";"-"
"07 Luty 2024 22:57:28";"Zmodyfikowano Transakcję Sprzedaży";"O2-CM-8VQDCP";"T2-CM-59W79T";"-";"Solana (USD)";"40 Jednost.";"99,370";"-";"-";"98,300";"-";"-";"-";"0,00";"-";"-";"-";"-";"-";"-";"-";"-";"-";"-";"-";"-";"-";"-";"-";"-";"-";"-";"-";"-";"-";"-";"-";"-";"-"
"07 Luty 2024 22:24:26";"Transakcja Sprzedaży";"O2-CM-8VQDCP";"T2-CM-59W79T";"-";"Solana (USD)";"40 Jednost.";"99,370";"-";"-";"-";"-";"4,050875";"16 101,41";"0,00";"-";"-";"-";"-";"-";"-";"-";"-";"-";"-";"-";"-";"-";"-";"-";"-";"-";"-";"-";"-";"-";"-";"-";"-";"-"
"07 Luty 2024 22:23:55";"Odrzucono Zlecenie: brak wystarczających środków";"O2-CM-8VQDCH";"-";"-";"Solana (USD)";"45 Jednost.";"-";"-";"-";"-";"-";"-";"-";"-";"-";"-";"-";"-";"-";"-";"-";"-";"-";"-";"-";"-";"-";"-";"-";"-";"-";"-";"-";"-";"-";"-";"-";"-";"-"
"07 Luty 2024 21:43:51";" Zamknięcie Transakcji";"O2-CM-8VQC67";"T2-CM-59W69S";"O2-CM-8VH85Z";"Solana (USD)";"40 Jednost.";"98,290";"-";"-";"-";"-";"4,052388";"15 932,36";"-34,85";"8 943,65";"-";"-";"-";"-";"-";"-";"-";"-";"-";"-";"-";"-";"-";"-";"-";"-";"-";"-";"-";"-";"-";"-";"-";"-"
"07 Luty 2024 00:20:33";"Zmodyfikowano Take Profit";"O2-CM-8VH85Z";"-";"O2-CM-8VJSF9";"Solana (USD)";"40 Jednost.";"98,505";"-";"-";"98,800";"-";"-";"-";"-";"-";"-";"-";"-";"-";"-";"-";"-";"-";"-";"-";"-";"-";"-";"-";"-";"-";"-";"-";"-";"-";"-";"-";"-";"-"
"06 Luty 2024 23:01:39";"Koszty Utrzymania Pozycji";"1304911839";"-";"-";"Rachunek";"-";"-";"-";"-";"-";"-";"-";"-";"-11,88";"8 978,50";"-";"-";"-";"-";"-";"-11,88";"-";"-";"-";"-";"-";"-";"-";"-";"-";"-";"-";"-";"-";"-";"-";"-";"-";"-"
"06 Luty 2024 23:01:39";"Koszty Utrzymania Pozycji";"O2-CM-8VH85Z";"-";"-";"Solana (USD)";"-";"-";"-";"-";"-";"-";"-";"-";"-";"-";"-";"-";"3 880,00";"-27,50000%";"-11,88";"-11,88";"-";"-";"-";"-";"-";"-";"-";"-";"-";"-";"-";"-";"-";"-";"-";"-";"-";"-"
"05 Luty 2024 23:01:43";"Koszty Utrzymania Pozycji";"1304406210";"-";"-";"Rachunek";"-";"-";"-";"-";"-";"-";"-";"-";"-11,61";"8 990,38";"-";"-";"-";"-";"-";"-11,61";"-";"-";"-";"-";"-";"-";"-";"-";"-";"-";"-";"-";"-";"-";"-";"-";"-";"-"
"05 Luty 2024 23:01:43";"Koszty Utrzymania Pozycji";"O2-CM-8VH85Z";"-";"-";"Solana (USD)";"-";"-";"-";"-";"-";"-";"-";"-";"-";"-";"-";"-";"3 793,20";"-27,50000%";"-11,61";"-11,61";"-";"-";"-";"-";"-";"-";"-";"-";"-";"-";"-";"-";"-";"-";"-";"-";"-";"-"
"05 Luty 2024 21:24:44";" Zmodyfikowano Transakcję Kupna";"O2-CM-8VH85Z";"T2-CM-59QF79";"-";"Solana (USD)";"40 Jednost.";"98,505";"-";"-";"100,800";"-";"-";"-";"0,00";"-";"-";"-";"-";"-";"-";"-";"-";"-";"-";"-";"-";"-";"-";"-";"-";"-";"-";"-";"-";"-";"-";"-";"-";"-"
"05 Luty 2024 14:38:41";" Transakcja Kupna";"O2-CM-8VH85Z";"T2-CM-59QF79";"-";"Solana (USD)";"40 Jednost.";"98,505";"-";"-";"-";"-";"4,055454";"15 979,29";"0,00";"-";"-";"-";"-";"-";"-";"-";"-";"-";"-";"-";"-";"-";"-";"-";"-";"-";"-";"-";"-";"-";"-";"-";"-";"-"
"05 Luty 2024 14:25:19";" Zamknięcie Transakcji";"O2-CM-8VH79F";"T2-CM-59QEGH";"O2-CM-8VGV9W";"Solana (USD)";"40 Jednost.";"97,880";"-";"-";"-";"-";"4,01224";"15 866,61";"10,43";"9 001,99";"-";"-";"-";"-";"-";"-";"-";"-";"-";"-";"-";"-";"-";"-";"-";"-";"-";"-";"-";"-";"-";"-";"-";"-"
"05 Luty 2024 11:20:50";" Zmodyfikowano Transakcję Kupna";"O2-CM-8VGV9W";"T2-CM-59Q4WW";"-";"Solana (USD)";"40 Jednost.";"97,815";"-";"-";"100,000";"-";"-";"-";"0,00";"-";"-";"-";"-";"-";"-";"-";"-";"-";"-";"-";"-";"-";"-";"-";"-";"-";"-";"-";"-";"-";"-";"-";"-";"-"
"05 Luty 2024 11:05:51";" Transakcja Kupna";"O2-CM-8VGV9W";"T2-CM-59Q4WW";"-";"Solana (USD)";"40 Jednost.";"97,815";"-";"-";"-";"-";"4,043751";"15 821,58";"0,00";"-";"-";"-";"-";"-";"-";"-";"-";"-";"-";"-";"-";"-";"-";"-";"-";"-";"-";"-";"-";"-";"-";"-";"-";"-"
"05 Luty 2024 00:01:36";"Stop Loss";"O2-CM-8VCC7J";"T2-CM-59PGLB";"-";"Solana (USD)";"40 Jednost.";"96,000";"-";"-";"-";"-";"3,98406";"15 452,51";"190,44";"8 991,56";"-";"-";"-";"-";"-";"-";"-";"-";"-";"-";"-";"-";"-";"-";"-";"-";"-";"-";"-";"-";"-";"-";"-";"-"
"05 Luty 2024 00:01:12";"Zmodyfikowano Transakcję Sprzedaży";"O2-CM-8VCC7J";"T2-CM-59LKB8";"-";"Solana (USD)";"40 Jednost.";"97,195";"-";"96,000";"94,000";"-";"-";"-";"0,00";"-";"-";"-";"-";"-";"-";"-";"-";"-";"-";"-";"-";"-";"-";"-";"-";"-";"-";"-";"-";"-";"-";"-";"-";"-"
"02 Luty 2024 23:01:40";"Koszty Utrzymania Pozycji";"1303881690";"-";"-";"Rachunek";"-";"-";"-";"-";"-";"-";"-";"-";"12,97";"8 801,12";"-";"-";"-";"-";"-";"12,97";"-";"-";"-";"-";"-";"-";"-";"-";"-";"-";"-";"-";"-";"-";"-";"-";"-";"-"
"02 Luty 2024 23:01:40";"Koszty Utrzymania Pozycji";"O2-CM-8VCC7J";"-";"-";"Solana (USD)";"-";"-";"-";"-";"-";"-";"-";"-";"-";"-";"-";"-";"3 963,36";"-10,00000%";"12,97";"12,97";"-";"-";"-";"-";"-";"-";"-";"-";"-";"-";"-";"-";"-";"-";"-";"-";"-";"-"
"01 Luty 2024 23:01:46";"Koszty Utrzymania Pozycji";"1303338081";"-";"-";"Rachunek";"-";"-";"-";"-";"-";"-";"-";"-";"4,24";"8 788,15";"-";"-";"-";"-";"-";"4,24";"-";"-";"-";"-";"-";"-";"-";"-";"-";"-";"-";"-";"-";"-";"-";"-";"-";"-"
"01 Luty 2024 23:01:46";"Koszty Utrzymania Pozycji";"O2-CM-8VCC7J";"-";"-";"Solana (USD)";"-";"-";"-";"-";"-";"-";"-";"-";"-";"-";"-";"-";"3 916,60";"-10,00000%";"4,24";"4,24";"-";"-";"-";"-";"-";"-";"-";"-";"-";"-";"-";"-";"-";"-";"-";"-";"-";"-"
"01 Luty 2024 19:22:50";"Zmodyfikowano Transakcję Sprzedaży";"O2-CM-8VCC7J";"T2-CM-59LKB8";"-";"Solana (USD)";"40 Jednost.";"97,195";"-";"-";"94,000";"-";"-";"-";"0,00";"-";"-";"-";"-";"-";"-";"-";"-";"-";"-";"-";"-";"-";"-";"-";"-";"-";"-";"-";"-";"-";"-";"-";"-";"-"
"01 Luty 2024 19:18:13";"Transakcja Sprzedaży";"O2-CM-8VCC7J";"T2-CM-59LKB8";"-";"Solana (USD)";"40 Jednost.";"97,195";"-";"-";"-";"-";"3,992008";"15 520,12";"0,00";"-";"-";"-";"-";"-";"-";"-";"-";"-";"-";"-";"-";"-";"-";"-";"-";"-";"-";"-";"-";"-";"-";"-";"-";"-"
"01 Luty 2024 19:13:35";" Zamknięcie Transakcji";"O2-CM-8VCBL5";"T2-CM-59LJRG";"O2-CM-8VBMWY";"Solana (USD)";"40 Jednost.";"96,960";"-";"-";"-";"-";"3,95119";"15 478,28";"7,90";"8 783,91";"-";"-";"-";"-";"-";"-";"-";"-";"-";"-";"-";"-";"-";"-";"-";"-";"-";"-";"-";"-";"-";"-";"-";"-"
"01 Luty 2024 19:04:53";"Zmodyfikowano Take Profit";"O2-CM-8VBMWY";"-";"O2-CM-8VC35J";"Solana (USD)";"40 Jednost.";"96,910";"-";"-";"97,400";"-";"-";"-";"-";"-";"-";"-";"-";"-";"-";"-";"-";"-";"-";"-";"-";"-";"-";"-";"-";"-";"-";"-";"-";"-";"-";"-";"-";"-"
"01 Luty 2024 18:29:22";" Zmodyfikowano Transakcję Kupna";"O2-CM-8VBMWY";"T2-CM-59KXNV";"-";"Solana (USD)";"40 Jednost.";"96,910";"-";"-";"97,600";"-";"-";"-";"0,00";"-";"-";"-";"-";"-";"-";"-";"-";"-";"-";"-";"-";"-";"-";"-";"-";"-";"-";"-";"-";"-";"-";"-";"-";"-"
"01 Luty 2024 16:36:53";" Transakcja Kupna";"O2-CM-8VBMWY";"T2-CM-59KXNV";"-";"Solana (USD)";"40 Jednost.";"96,910";"-";"-";"-";"-";"4,00324";"15 518,15";"0,00";"-";"-";"-";"-";"-";"-";"-";"-";"-";"-";"-";"-";"-";"-";"-";"-";"-";"-";"-";"-";"-";"-";"-";"-";"-"
"01 Luty 2024 15:45:17";"Stop Loss";"O2-CM-8V9T4F";"T2-CM-59KP6V";"-";"Solana (USD)";"42 Jednost.";"96,900";"-";"-";"-";"-";"3,98161";"16 367,17";"98,66";"8 776,01";"-";"-";"-";"-";"-";"-";"-";"-";"-";"-";"-";"-";"-";"-";"-";"-";"-";"-";"-";"-";"-";"-";"-";"-"
"01 Luty 2024 15:44:32";" Zmodyfikowano Transakcję Kupna";"O2-CM-8V9T4F";"T2-CM-59K5LT";"-";"Solana (USD)";"42 Jednost.";"96,310";"-";"96,900";"-";"-";"-";"-";"0,00";"-";"-";"-";"-";"-";"-";"-";"-";"-";"-";"-";"-";"-";"-";"-";"-";"-";"-";"-";"-";"-";"-";"-";"-";"-"
"01 Luty 2024 15:35:05";" Zmodyfikowano Transakcję Kupna";"O2-CM-8V9T4F";"T2-CM-59K5LT";"-";"Solana (USD)";"42 Jednost.";"96,310";"-";"-";"97,000";"-";"-";"-";"0,00";"-";"-";"-";"-";"-";"-";"-";"-";"-";"-";"-";"-";"-";"-";"-";"-";"-";"-";"-";"-";"-";"-";"-";"-";"-"
"01 Luty 2024 11:15:17";" Transakcja Kupna";"O2-CM-8V9T4F";"T2-CM-59K5LT";"-";"Solana (USD)";"42 Jednost.";"96,310";"-";"-";"-";"-";"4,026657";"16 287,90";"0,00";"-";"-";"-";"-";"-";"-";"-";"-";"-";"-";"-";"-";"-";"-";"-";"-";"-";"-";"-";"-";"-";"-";"-";"-";"-"
"01 Luty 2024 10:19:21";" Zamknięcie Transakcji";"O2-CM-8V9NJH";"T2-CM-59K3LD";"O2-CM-8V9M11";"Solana (USD)";"40 Jednost.";"95,702";"-";"-";"-";"-";"3,98641";"15 413,67";"91,21";"8 677,35";"-";"-";"-";"-";"-";"-";"-";"-";"-";"-";"-";"-";"-";"-";"-";"-";"-";"-";"-";"-";"-";"-";"-";"-"
"01 Luty 2024 10:00:43";" Zmodyfikowano Transakcję Kupna";"O2-CM-8V9M11";"T2-CM-59K29J";"-";"Solana (USD)";"40 Jednost.";"95,130";"-";"-";"97,000";"-";"-";"-";"0,00";"-";"-";"-";"-";"-";"-";"-";"-";"-";"-";"-";"-";"-";"-";"-";"-";"-";"-";"-";"-";"-";"-";"-";"-";"-"
"01 Luty 2024 09:55:17";" Transakcja Kupna";"O2-CM-8V9M11";"T2-CM-59K29J";"-";"Solana (USD)";"40 Jednost.";"95,130";"-";"-";"-";"-";"4,027799";"15 326,58";"0,00";"-";"-";"-";"-";"-";"-";"-";"-";"-";"-";"-";"-";"-";"-";"-";"-";"-";"-";"-";"-";"-";"-";"-";"-";"-"
"01 Luty 2024 06:07:07";"Zablokowano";"-";"-";"-";" Akcja USA Notowania";"-";"-";"-";"-";"-";"-";"-";"-";"-";"-";"-";"-";"-";"-";"-";"-";"-";"-";"-";"-";"-";"-";"-";"-";"-";"-";"-";"-";"-";"-";"-";"-";"-";"-"
"01 Luty 2024 02:12:24";"Take Profit";"O2-CM-8V8NHV";"T2-CM-59JLYE";"-";"Solana (USD)";"40 Jednost.";"96,100";"-";"-";"-";"-";"3,98658";"15 478,43";"91,69";"8 586,14";"-";"-";"-";"-";"-";"-";"-";"-";"-";"-";"-";"-";"-";"-";"-";"-";"-";"-";"-";"-";"-";"-";"-";"-"
"01 Luty 2024 01:57:13";"Zmodyfikowano Take Profit";"O2-CM-8V8NHV";"-";"O2-CM-8V8PHS";"Solana (USD)";"40 Jednost.";"96,675";"-";"-";"96,100";"-";"-";"-";"-";"-";"-";"-";"-";"-";"-";"-";"-";"-";"-";"-";"-";"-";"-";"-";"-";"-";"-";"-";"-";"-";"-";"-";"-";"-"
"01 Luty 2024 00:56:11";"Zmodyfikowano Transakcję Sprzedaży";"O2-CM-8V8NHV";"T2-CM-59JHXW";"-";"Solana (USD)";"40 Jednost.";"96,675";"-";"-";"95,140";"-";"-";"-";"0,00";"-";"-";"-";"-";"-";"-";"-";"-";"-";"-";"-";"-";"-";"-";"-";"-";"-";"-";"-";"-";"-";"-";"-";"-";"-"
"01 Luty 2024 00:11:07";"Transakcja Sprzedaży";"O2-CM-8V8NHV";"T2-CM-59JHXW";"-";"Solana (USD)";"40 Jednost.";"96,675";"-";"-";"-";"-";"4,023491";"15 558,83";"0,00";"-";"-";"-";"-";"-";"-";"-";"-";"-";"-";"-";"-";"-";"-";"-";"-";"-";"-";"-";"-";"-";"-";"-";"-";"-"
"01 Luty 2024 00:09:58";" Zamknięcie Transakcji";"O2-CM-8V8NGP";"T2-CM-59JHX0";"O2-CM-8V8N17";"Solana (USD)";"40 Jednost.";"96,816";"-";"-";"-";"-";"4,02324";"15 580,56";"-127,78";"8 494,45";"-";"-";"-";"-";"-";"-";"-";"-";"-";"-";"-";"-";"-";"-";"-";"-";"-";"-";"-";"-";"-";"-";"-";"-"
"01 Luty 2024 00:03:22";"Zablokowano";"-";"-";"-";" Akcja polska Notowania";"-";"-";"-";"-";"-";"-";"-";"-";"-";"-";"-";"-";"-";"-";"-";"-";"-";"-";"-";"-";"-";"-";"-";"-";"-";"-";"-";"-";"-";"-";"-";"-";"-";"-"
"31 Sty 2024 23:55:56";" Transakcja Kupna";"O2-CM-8V8N17";"T2-CM-59JHK5";"-";"Solana (USD)";"40 Jednost.";"97,610";"-";"-";"-";"-";"4,021887";"15 703,05";"0,00";"-";"-";"-";"-";"-";"-";"-";"-";"-";"-";"-";"-";"-";"-";"-";"-";"-";"-";"-";"-";"-";"-";"-";"-";"-"
"31 Sty 2024 23:55:04";" Zamknięcie Transakcji";"O2-CM-8V8N11";"T2-CM-59JHK0";"O2-CM-8V8MLG";"Solana (USD)";"40 Jednost.";"97,825";"-";"-";"-";"-";"4,022288";"15 739,21";"-136,76";"8 622,23";"-";"-";"-";"-";"-";"-";"-";"-";"-";"-";"-";"-";"-";"-";"-";"-";"-";"-";"-";"-";"-";"-";"-";"-"
"31 Sty 2024 23:00:56";"Transakcja Sprzedaży";"O2-CM-8V8MLG";"T2-CM-59JHC9";"-";"Solana (USD)";"40 Jednost.";"96,975";"-";"-";"-";"-";"4,022028";"15 601,44";"0,00";"-";"-";"-";"-";"-";"-";"-";"-";"-";"-";"-";"-";"-";"-";"-";"-";"-";"-";"-";"-";"-";"-";"-";"-";"-"
"31 Sty 2024 22:26:45";"Stop Loss";"O2-CM-8V8J9Y";"T2-CM-59JGLH";"-";"Solana (USD)";"40 Jednost.";"96,610";"-";"-";"-";"-";"3,98218";"15 543,38";"176,01";"8 758,99";"-";"-";"-";"-";"-";"-";"-";"-";"-";"-";"-";"-";"-";"-";"-";"-";"-";"-";"-";"-";"-";"-";"-";"-"
"31 Sty 2024 22:25:30";"Zmodyfikowano Stop Loss";"O2-CM-8V8J9Y";"-";"O2-CM-8V8LMC";"Solana (USD)";"40 Jednost.";"97,715";"-";"96,600";"-";"-";"-";"-";"-";"-";"-";"-";"-";"-";"-";"-";"-";"-";"-";"-";"-";"-";"-";"-";"-";"-";"-";"-";"-";"-";"-";"-";"-";"-"
"31 Sty 2024 22:25:01";"Zmodyfikowano Transakcję Sprzedaży";"O2-CM-8V8J9Y";"T2-CM-59JEJE";"-";"Solana (USD)";"40 Jednost.";"97,715";"-";"97,200";"-";"-";"-";"-";"0,00";"-";"-";"-";"-";"-";"-";"-";"-";"-";"-";"-";"-";"-";"-";"-";"-";"-";"-";"-";"-";"-";"-";"-";"-";"-"
"31 Sty 2024 21:55:39";"Transakcja Sprzedaży";"O2-CM-8V8J9Y";"T2-CM-59JEJE";"-";"Solana (USD)";"40 Jednost.";"97,715";"-";"-";"-";"-";"4,025855";"15 735,45";"0,00";"-";"-";"-";"-";"-";"-";"-";"-";"-";"-";"-";"-";"-";"-";"-";"-";"-";"-";"-";"-";"-";"-";"-";"-";"-"
"31 Sty 2024 21:45:27";"Stop Loss";"O2-CM-8V8EM0";"T2-CM-59JDJ7";"-";"Solana (USD)";"35 Jednost.";"98,802";"-";"-";"-";"-";"3,98545";"13 920,47";"133,07";"8 582,98";"-";"-";"-";"-";"-";"-";"-";"-";"-";"-";"-";"-";"-";"-";"-";"-";"-";"-";"-";"-";"-";"-";"-";"-"
"31 Sty 2024 21:45:11";"Zmodyfikowano Take Profit";"O2-CM-8V8EM0";"-";"O2-CM-8V8FJG";"Solana (USD)";"35 Jednost.";"99,756";"-";"-";"97,800";"-";"-";"-";"-";"-";"-";"-";"-";"-";"-";"-";"-";"-";"-";"-";"-";"-";"-";"-";"-";"-";"-";"-";"-";"-";"-";"-";"-";"-"
"31 Sty 2024 21:43:10";"Zmodyfikowano Stop Loss";"O2-CM-8V8EM0";"-";"O2-CM-8V8G4W";"Solana (USD)";"35 Jednost.";"99,756";"-";"98,800";"-";"-";"-";"-";"-";"-";"-";"-";"-";"-";"-";"-";"-";"-";"-";"-";"-";"-";"-";"-";"-";"-";"-";"-";"-";"-";"-";"-";"-";"-"
"31 Sty 2024 21:42:32";"Zmodyfikowano Stop Loss";"O2-CM-8V8EM0";"-";"O2-CM-8V8G4W";"Solana (USD)";"35 Jednost.";"99,756";"-";"99,000";"-";"-";"-";"-";"-";"-";"-";"-";"-";"-";"-";"-";"-";"-";"-";"-";"-";"-";"-";"-";"-";"-";"-";"-";"-";"-";"-";"-";"-";"-"
"31 Sty 2024 21:39:49";"Zmodyfikowano Stop Loss";"O2-CM-8V8EM0";"-";"O2-CM-8V8G4W";"Solana (USD)";"35 Jednost.";"99,756";"-";"99,200";"-";"-";"-";"-";"-";"-";"-";"-";"-";"-";"-";"-";"-";"-";"-";"-";"-";"-";"-";"-";"-";"-";"-";"-";"-";"-";"-";"-";"-";"-"
"31 Sty 2024 21:38:26";"Zmodyfikowano Stop Loss";"O2-CM-8V8EM0";"-";"O2-CM-8V8G4W";"Solana (USD)";"35 Jednost.";"99,756";"-";"99,300";"-";"-";"-";"-";"-";"-";"-";"-";"-";"-";"-";"-";"-";"-";"-";"-";"-";"-";"-";"-";"-";"-";"-";"-";"-";"-";"-";"-";"-";"-"
"31 Sty 2024 21:36:42";"Zmodyfikowano Transakcję Sprzedaży";"O2-CM-8V8EM0";"T2-CM-59JB6C";"-";"Solana (USD)";"35 Jednost.";"99,756";"-";"99,400";"98,000";"-";"-";"-";"0,00";"-";"-";"-";"-";"-";"-";"-";"-";"-";"-";"-";"-";"-";"-";"-";"-";"-";"-";"-";"-";"-";"-";"-";"-";"-"
"31 Sty 2024 21:33:17";"Zmodyfikowano Transakcję Sprzedaży";"O2-CM-8V8EM0";"T2-CM-59JB6C";"-";"Solana (USD)";"35 Jednost.";"99,756";"-";"-";"98,000";"-";"-";"-";"0,00";"-";"-";"-";"-";"-";"-";"-";"-";"-";"-";"-";"-";"-";"-";"-";"-";"-";"-";"-";"-";"-";"-";"-";"-";"-"
"31 Sty 2024 21:27:46";"Transakcja Sprzedaży";"O2-CM-8V8EM0";"T2-CM-59JB6C";"-";"Solana (USD)";"35 Jednost.";"99,756";"-";"-";"-";"-";"4,024062";"14 049,85";"0,00";"-";"-";"-";"-";"-";"-";"-";"-";"-";"-";"-";"-";"-";"-";"-";"-";"-";"-";"-";"-";"-";"-";"-";"-";"-"
"31 Sty 2024 20:29:51";" Zamknięcie Transakcji";"O2-CM-8V7YHG";"T2-CM-59HVDX";"O2-CM-8V7X58";"Solana (USD)";"35 Jednost.";"99,990";"-";"-";"-";"-";"3,97739";"14 059,34";"65,43";"8 449,91";"-";"-";"-";"-";"-";"-";"-";"-";"-";"-";"-";"-";"-";"-";"-";"-";"-";"-";"-";"-";"-";"-";"-";"-"
"31 Sty 2024 20:26:19";"Zmodyfikowano Transakcję Sprzedaży";"O2-CM-8V7X58";"T2-CM-59HT75";"-";"Solana (USD)";"35 Jednost.";"100,460";"-";"-";"99,200";"-";"-";"-";"0,00";"-";"-";"-";"-";"-";"-";"-";"-";"-";"-";"-";"-";"-";"-";"-";"-";"-";"-";"-";"-";"-";"-";"-";"-";"-"
"31 Sty 2024 20:17:32";"Transakcja Sprzedaży";"O2-CM-8V7X58";"T2-CM-59HT75";"-";"Solana (USD)";"35 Jednost.";"100,460";"-";"-";"-";"-";"4,015384";"14 118,49";"0,00";"-";"-";"-";"-";"-";"-";"-";"-";"-";"-";"-";"-";"-";"-";"-";"-";"-";"-";"-";"-";"-";"-";"-";"-";"-"
"31 Sty 2024 18:59:28";"Take Profit";"O2-CM-8V7ML2";"T2-CM-59HL69";"-";"Solana (USD)";"40 Jednost.";"102,250";"-";"-";"-";"-";"3,97186";"16 408,20";"23,83";"8 384,48";"-";"-";"-";"-";"-";"-";"-";"-";"-";"-";"-";"-";"-";"-";"-";"-";"-";"-";"-";"-";"-";"-";"-";"-"
"31 Sty 2024 18:52:28";" Zmodyfikowano Transakcję Kupna";"O2-CM-8V7ML2";"T2-CM-59HKLQ";"-";"Solana (USD)";"40 Jednost.";"102,100";"-";"-";"102,250";"-";"-";"-";"0,00";"-";"-";"-";"-";"-";"-";"-";"-";"-";"-";"-";"-";"-";"-";"-";"-";"-";"-";"-";"-";"-";"-";"-";"-";"-"
"31 Sty 2024 18:45:53";" Transakcja Kupna";"O2-CM-8V7ML2";"T2-CM-59HKLQ";"-";"Solana (USD)";"40 Jednost.";"102,100";"-";"-";"-";"-";"4,010775";"16 380,00";"0,00";"-";"-";"-";"-";"-";"-";"-";"-";"-";"-";"-";"-";"-";"-";"-";"-";"-";"-";"-";"-";"-";"-";"-";"-";"-"
"31 Sty 2024 17:38:16";" Zamknięcie Transakcji";"O2-CM-8V7GX8";"T2-CM-59HFJ7";"O2-CM-8V53X2";"Solana (USD)";"40 Jednost.";"100,670";"-";"-";"-";"-";"4,010625";"16 149,98";"-810,63";"8 360,65";"-";"-";"-";"-";"-";"-";"-";"-";"-";"-";"-";"-";"-";"-";"-";"-";"-";"-";"-";"-";"-";"-";"-";"-"
"30 Sty 2024 23:01:27";"Koszty Utrzymania Pozycji";"1302183932";"-";"-";"Rachunek";"-";"-";"-";"-";"-";"-";"-";"-";"-12,67";"9 171,28";"-";"-";"-";"-";"-";"-12,67";"-";"-";"-";"-";"-";"-";"-";"-";"-";"-";"-";"-";"-";"-";"-";"-";"-";"-"
"30 Sty 2024 23:01:27";"Koszty Utrzymania Pozycji";"O2-CM-8V53X2";"-";"-";"Solana (USD)";"-";"-";"-";"-";"-";"-";"-";"-";"-";"-";"-";"-";"4 172,04";"-27,50000%";"-12,67";"-12,67";"-";"-";"-";"-";"-";"-";"-";"-";"-";"-";"-";"-";"-";"-";"-";"-";"-";"-"
"30 Sty 2024 16:46:12";" Transakcja Kupna";"O2-CM-8V53X2";"T2-CM-59FC0S";"-";"Solana (USD)";"40 Jednost.";"105,723";"-";"-";"-";"-";"4,041176";"17 089,81";"0,00";"-";"-";"-";"-";"-";"-";"-";"-";"-";"-";"-";"-";"-";"-";"-";"-";"-";"-";"-";"-";"-";"-";"-";"-";"-"
"30 Sty 2024 16:35:31";" Zamknięcie Transakcji";"O2-CM-8V52TL";"T2-CM-59FB3V";"O2-CM-8V4NFT";"Solana (USD)";"40 Jednost.";"105,773";"-";"-";"-";"-";"4,00201";"17 102,38";"106,13";"9 183,95";"-";"-";"-";"-";"-";"-";"-";"-";"-";"-";"-";"-";"-";"-";"-";"-";"-";"-";"-";"-";"-";"-";"-";"-"
"30 Sty 2024 14:11:04";" Transakcja Kupna";"O2-CM-8V4NFT";"T2-CM-59EY2W";"-";"Solana (USD)";"40 Jednost.";"105,110";"-";"-";"-";"-";"4,042238";"16 995,18";"0,00";"-";"-";"-";"-";"-";"-";"-";"-";"-";"-";"-";"-";"-";"-";"-";"-";"-";"-";"-";"-";"-";"-";"-";"-";"-"
"30 Sty 2024 13:19:05";" Zamknięcie Transakcji";"O2-CM-8V4LCB";"T2-CM-59EW8C";"O2-CM-8V4JTH";"Solana (USD)";"40 Jednost.";"106,048";"-";"-";"-";"-";"4,00427";"17 156,45";"163,53";"9 077,82";"-";"-";"-";"-";"-";"-";"-";"-";"-";"-";"-";"-";"-";"-";"-";"-";"-";"-";"-";"-";"-";"-";"-";"-"
"30 Sty 2024 13:18:15";"Zmodyfikowano Take Profit";"O2-CM-8V4JTH";"-";"O2-CM-8V4L0L";"Solana (USD)";"40 Jednost.";"105,027";"-";"-";"106,600";"-";"-";"-";"-";"-";"-";"-";"-";"-";"-";"-";"-";"-";"-";"-";"-";"-";"-";"-";"-";"-";"-";"-";"-";"-";"-";"-";"-";"-"
"30 Sty 2024 13:13:06";"Zmodyfikowano Take Profit";"O2-CM-8V4JTH";"-";"O2-CM-8V4L0L";"Solana (USD)";"40 Jednost.";"105,027";"-";"-";"106,200";"-";"-";"-";"-";"-";"-";"-";"-";"-";"-";"-";"-";"-";"-";"-";"-";"-";"-";"-";"-";"-";"-";"-";"-";"-";"-";"-";"-";"-"
"30 Sty 2024 13:08:16";"Zmodyfikowano Take Profit";"O2-CM-8V4JTH";"-";"O2-CM-8V4L0L";"Solana (USD)";"40 Jednost.";"105,027";"-";"-";"106,300";"-";"-";"-";"-";"-";"-";"-";"-";"-";"-";"-";"-";"-";"-";"-";"-";"-";"-";"-";"-";"-";"-";"-";"-";"-";"-";"-";"-";"-"
"30 Sty 2024 13:06:26";" Zmodyfikowano Transakcję Kupna";"O2-CM-8V4JTH";"T2-CM-59ETZK";"-";"Solana (USD)";"40 Jednost.";"105,027";"-";"-";"106,350";"-";"-";"-";"0,00";"-";"-";"-";"-";"-";"-";"-";"-";"-";"-";"-";"-";"-";"-";"-";"-";"-";"-";"-";"-";"-";"-";"-";"-";"-"
"30 Sty 2024 12:33:07";" Transakcja Kupna";"O2-CM-8V4JTH";"T2-CM-59ETZK";"-";"Solana (USD)";"40 Jednost.";"105,027";"-";"-";"-";"-";"4,046597";"17 000,07";"0,00";"-";"-";"-";"-";"-";"-";"-";"-";"-";"-";"-";"-";"-";"-";"-";"-";"-";"-";"-";"-";"-";"-";"-";"-";"-"
"30 Sty 2024 11:56:42";" Zamknięcie Transakcji";"O2-CM-8V4HEP";"T2-CM-59ESP3";"O2-CM-8V37MS";"Solana (USD)";"40 Jednost.";"104,389";"-";"-";"-";"-";"4,048881";"16 906,34";"-920,72";"8 914,29";"-";"-";"-";"-";"-";"-";"-";"-";"-";"-";"-";"-";"-";"-";"-";"-";"-";"-";"-";"-";"-";"-";"-";"-"
"30 Sty 2024 09:58:02";"Zmodyfikowano Transakcję Sprzedaży";"O2-CM-8V37MS";"T2-CM-59DPJV";"-";"Solana (USD)";"40 Jednost.";"98,704";"-";"-";"102,600";"-";"-";"-";"0,00";"-";"-";"-";"-";"-";"-";"-";"-";"-";"-";"-";"-";"-";"-";"-";"-";"-";"-";"-";"-";"-";"-";"-";"-";"-"
"29 Sty 2024 23:01:31";"Koszty Utrzymania Pozycji";"1301716819";"-";"-";"Rachunek";"-";"-";"-";"-";"-";"-";"-";"-";"4,45";"9 835,01";"-";"-";"-";"-";"-";"4,45";"-";"-";"-";"-";"-";"-";"-";"-";"-";"-";"-";"-";"-";"-";"-";"-";"-";"-"
"29 Sty 2024 23:01:31";"Koszty Utrzymania Pozycji";"O2-CM-8V37MS";"-";"-";"Solana (USD)";"-";"-";"-";"-";"-";"-";"-";"-";"-";"-";"-";"-";"4 044,56";"-10,00000%";"4,45";"4,45";"-";"-";"-";"-";"-";"-";"-";"-";"-";"-";"-";"-";"-";"-";"-";"-";"-";"-"
"29 Sty 2024 16:53:57";"Transakcja Sprzedaży";"O2-CM-8V37MS";"T2-CM-59DPJV";"-";"Solana (USD)";"40 Jednost.";"98,704";"-";"-";"-";"-";"4,066136";"16 053,75";"0,00";"-";"-";"-";"-";"-";"-";"-";"-";"-";"-";"-";"-";"-";"-";"-";"-";"-";"-";"-";"-";"-";"-";"-";"-";"-"
"29 Sty 2024 16:52:05";" Zamknięcie Transakcji";"O2-CM-8V37FV";"T2-CM-59DPDV";"O2-CM-8V37CP";"Solana (USD)";"40 Jednost.";"98,616";"-";"-";"-";"-";"4,02862";"16 051,18";"11,44";"9 830,56";"-";"-";"-";"-";"-";"-";"-";"-";"-";"-";"-";"-";"-";"-";"-";"-";"-";"-";"-";"-";"-";"-";"-";"-"
"29 Sty 2024 16:51:09";" Transakcja Kupna";"O2-CM-8V37CP";"T2-CM-59DPBN";"-";"Solana (USD)";"40 Jednost.";"98,545";"-";"-";"-";"-";"4,069162";"16 039,82";"0,00";"-";"-";"-";"-";"-";"-";"-";"-";"-";"-";"-";"-";"-";"-";"-";"-";"-";"-";"-";"-";"-";"-";"-";"-";"-"
"29 Sty 2024 16:45:53";"Take Profit";"O2-CM-8V2LTG";"T2-CM-59DNZD";"-";"Solana (USD)";"40 Jednost.";"97,800";"-";"-";"-";"-";"4,02824";"15 916,87";"45,92";"9 819,12";"-";"-";"-";"-";"-";"-";"-";"-";"-";"-";"-";"-";"-";"-";"-";"-";"-";"-";"-";"-";"-";"-";"-";"-"
"29 Sty 2024 16:43:43";"Zmodyfikowano Take Profit";"O2-CM-8V2LTG";"-";"O2-CM-8V2LW4";"Solana (USD)";"40 Jednost.";"97,515";"-";"-";"97,800";"-";"-";"-";"-";"-";"-";"-";"-";"-";"-";"-";"-";"-";"-";"-";"-";"-";"-";"-";"-";"-";"-";"-";"-";"-";"-";"-";"-";"-"
"29 Sty 2024 11:13:47";" Zmodyfikowano Transakcję Kupna";"O2-CM-8V2LTG";"T2-CM-59D5L2";"-";"Solana (USD)";"40 Jednost.";"97,515";"-";"-";"98,650";"-";"-";"-";"0,00";"-";"-";"-";"-";"-";"-";"-";"-";"-";"-";"-";"-";"-";"-";"-";"-";"-";"-";"-";"-";"-";"-";"-";"-";"-"
"29 Sty 2024 11:12:13";" Transakcja Kupna";"O2-CM-8V2LTG";"T2-CM-59D5L2";"-";"Solana (USD)";"40 Jednost.";"97,515";"-";"-";"-";"-";"4,051837";"15 804,59";"0,00";"-";"-";"-";"-";"-";"-";"-";"-";"-";"-";"-";"-";"-";"-";"-";"-";"-";"-";"-";"-";"-";"-";"-";"-";"-"
"26 Sty 2024 15:48:07";"Stop Loss";"O2-CM-8V0RV0";"T2-CM-59BWV9";"-";"Solana (USD)";"45 Jednost.";"91,395";"-";"-";"-";"-";"4,00271";"16 627,69";"35,30";"9 773,20";"-";"-";"-";"-";"-";"-";"-";"-";"-";"-";"-";"-";"-";"-";"-";"-";"-";"-";"-";"-";"-";"-";"-";"-"
"26 Sty 2024 15:47:15";" Zmodyfikowano Transakcję Kupna";"O2-CM-8V0RV0";"T2-CM-59BLPE";"-";"Solana (USD)";"45 Jednost.";"91,199";"-";"91,400";"91,800";"-";"-";"-";"0,00";"-";"-";"-";"-";"-";"-";"-";"-";"-";"-";"-";"-";"-";"-";"-";"-";"-";"-";"-";"-";"-";"-";"-";"-";"-"
"26 Sty 2024 15:45:56";" Zmodyfikowano Transakcję Kupna";"O2-CM-8V0RV0";"T2-CM-59BLPE";"-";"Solana (USD)";"45 Jednost.";"91,199";"-";"91,400";"-";"-";"-";"-";"0,00";"-";"-";"-";"-";"-";"-";"-";"-";"-";"-";"-";"-";"-";"-";"-";"-";"-";"-";"-";"-";"-";"-";"-";"-";"-"
"26 Sty 2024 14:13:44";" Transakcja Kupna";"O2-CM-8V0RV0";"T2-CM-59BLPE";"-";"Solana (USD)";"45 Jednost.";"91,199";"-";"-";"-";"-";"4,045154";"16 601,12";"0,00";"-";"-";"-";"-";"-";"-";"-";"-";"-";"-";"-";"-";"-";"-";"-";"-";"-";"-";"-";"-";"-";"-";"-";"-";"-"
"26 Sty 2024 14:01:51";"Stop Loss";"O2-CM-8V0NM4";"T2-CM-59BL80";"-";"Solana (USD)";"50 Jednost.";"91,000";"-";"-";"-";"-";"4,01016";"18 429,61";"64,16";"9 737,90";"-";"-";"-";"-";"-";"-";"-";"-";"-";"-";"-";"-";"-";"-";"-";"-";"-";"-";"-";"-";"-";"-";"-";"-"
"26 Sty 2024 13:56:08";"Zmodyfikowano Stop Loss";"O2-CM-8V0NM4";"-";"O2-CM-8V0NSS";"Solana (USD)";"50 Jednost.";"91,320";"-";"91,000";"-";"-";"-";"-";"-";"-";"-";"-";"-";"-";"-";"-";"-";"-";"-";"-";"-";"-";"-";"-";"-";"-";"-";"-";"-";"-";"-";"-";"-";"-"
"26 Sty 2024 13:53:32";"Zmodyfikowano Stop Loss";"O2-CM-8V0NM4";"-";"O2-CM-8V0NSS";"Solana (USD)";"50 Jednost.";"91,320";"-";"91,100";"-";"-";"-";"-";"-";"-";"-";"-";"-";"-";"-";"-";"-";"-";"-";"-";"-";"-";"-";"-";"-";"-";"-";"-";"-";"-";"-";"-";"-";"-"
"26 Sty 2024 13:22:20";"Zmodyfikowano Stop Loss";"O2-CM-8V0NM4";"-";"O2-CM-8V0NSS";"Solana (USD)";"50 Jednost.";"91,320";"-";"92,500";"-";"-";"-";"-";"-";"-";"-";"-";"-";"-";"-";"-";"-";"-";"-";"-";"-";"-";"-";"-";"-";"-";"-";"-";"-";"-";"-";"-";"-";"-"
"26 Sty 2024 13:12:52";"Zmodyfikowano Transakcję Sprzedaży";"O2-CM-8V0NM4";"T2-CM-59BJ1M";"-";"Solana (USD)";"50 Jednost.";"91,320";"-";"92,400";"89,600";"-";"-";"-";"0,00";"-";"-";"-";"-";"-";"-";"-";"-";"-";"-";"-";"-";"-";"-";"-";"-";"-";"-";"-";"-";"-";"-";"-";"-";"-"
"26 Sty 2024 13:09:55";"Zmodyfikowano Transakcję Sprzedaży";"O2-CM-8V0NM4";"T2-CM-59BJ1M";"-";"Solana (USD)";"50 Jednost.";"91,320";"-";"92,400";"-";"-";"-";"-";"0,00";"-";"-";"-";"-";"-";"-";"-";"-";"-";"-";"-";"-";"-";"-";"-";"-";"-";"-";"-";"-";"-";"-";"-";"-";"-"
"26 Sty 2024 13:06:57";"Transakcja Sprzedaży";"O2-CM-8V0NM4";"T2-CM-59BJ1M";"-";"Solana (USD)";"50 Jednost.";"91,320";"-";"-";"-";"-";"4,04304";"18 460,52";"0,00";"-";"-";"-";"-";"-";"-";"-";"-";"-";"-";"-";"-";"-";"-";"-";"-";"-";"-";"-";"-";"-";"-";"-";"-";"-"
"26 Sty 2024 13:05:12";" Zamknięcie Transakcji";"O2-CM-8V0NHN";"T2-CM-59BHYS";"O2-CM-8V0MQ6";"Solana (USD)";"45 Jednost.";"91,480";"-";"-";"-";"-";"4,04322";"16 644,31";"-113,72";"9 673,74";"-";"-";"-";"-";"-";"-";"-";"-";"-";"-";"-";"-";"-";"-";"-";"-";"-";"-";"-";"-";"-";"-";"-";"-"
"26 Sty 2024 12:45:29";" Transakcja Kupna";"O2-CM-8V0MQ6";"T2-CM-59BHCX";"-";"Solana (USD)";"45 Jednost.";"92,105";"-";"-";"-";"-";"4,045775";"16 768,62";"0,00";"-";"-";"-";"-";"-";"-";"-";"-";"-";"-";"-";"-";"-";"-";"-";"-";"-";"-";"-";"-";"-";"-";"-";"-";"-"
"26 Sty 2024 12:36:51";"Stop Loss";"O2-CM-8V0KML";"T2-CM-59BH41";"-";"Solana (USD)";"45 Jednost.";"91,800";"-";"-";"-";"-";"4,00551";"16 713,09";"146,00";"9 787,46";"-";"-";"-";"-";"-";"-";"-";"-";"-";"-";"-";"-";"-";"-";"-";"-";"-";"-";"-";"-";"-";"-";"-";"-"
"26 Sty 2024 12:36:19";" Zmodyfikowano Transakcję Kupna";"O2-CM-8V0KML";"T2-CM-59BFL7";"-";"Solana (USD)";"45 Jednost.";"90,990";"-";"91,800";"-";"-";"-";"-";"0,00";"-";"-";"-";"-";"-";"-";"-";"-";"-";"-";"-";"-";"-";"-";"-";"-";"-";"-";"-";"-";"-";"-";"-";"-";"-"
"26 Sty 2024 12:02:02";" Transakcja Kupna";"O2-CM-8V0KML";"T2-CM-59BFL7";"-";"Solana (USD)";"45 Jednost.";"90,990";"-";"-";"-";"-";"4,045354";"16 563,90";"0,00";"-";"-";"-";"-";"-";"-";"-";"-";"-";"-";"-";"-";"-";"-";"-";"-";"-";"-";"-";"-";"-";"-";"-";"-";"-"
"26 Sty 2024 12:01:08";" Zamknięcie Transakcji";"O2-CM-8V0KJT";"T2-CM-59BFH3";"O2-CM-8V09YL";"Solana (USD)";"40 Jednost.";"90,960";"-";"-";"-";"-";"4,046426";"14 722,51";"-536,56";"9 641,46";"-";"-";"-";"-";"-";"-";"-";"-";"-";"-";"-";"-";"-";"-";"-";"-";"-";"-";"-";"-";"-";"-";"-";"-"
"26 Sty 2024 09:23:52";"Zmodyfikowano Transakcję Sprzedaży";"O2-CM-8V09YL";"T2-CM-59B6ZP";"-";"Solana (USD)";"40 Jednost.";"87,645";"-";"-";"86,950";"-";"-";"-";"0,00";"-";"-";"-";"-";"-";"-";"-";"-";"-";"-";"-";"-";"-";"-";"-";"-";"-";"-";"-";"-";"-";"-";"-";"-";"-"
"26 Sty 2024 09:22:26";"Transakcja Sprzedaży";"O2-CM-8V09YL";"T2-CM-59B6ZP";"-";"Solana (USD)";"40 Jednost.";"87,645";"-";"-";"-";"-";"4,06113";"14 237,50";"0,00";"-";"-";"-";"-";"-";"-";"-";"-";"-";"-";"-";"-";"-";"-";"-";"-";"-";"-";"-";"-";"-";"-";"-";"-";"-"
"26 Sty 2024 03:26:12";"Take Profit";"O2-CM-8TZXJ5";"T2-CM-59B03H";"-";"Solana (USD)";"40 Jednost.";"88,000";"-";"-";"-";"-";"4,01103";"14 260,71";"160,44";"10 178,02";"-";"-";"-";"-";"-";"-";"-";"-";"-";"-";"-";"-";"-";"-";"-";"-";"-";"-";"-";"-";"-";"-";"-";"-"
"25 Sty 2024 23:44:15";"Zmodyfikowano Take Profit";"O2-CM-8TZXJ5";"-";"O2-CM-8TZXJG";"Solana (USD)";"40 Jednost.";"87,000";"-";"-";"88,000";"-";"-";"-";"-";"-";"-";"-";"-";"-";"-";"-";"-";"-";"-";"-";"-";"-";"-";"-";"-";"-";"-";"-";"-";"-";"-";"-";"-";"-"
"25 Sty 2024 23:41:53";" Zmodyfikowano Transakcję Kupna";"O2-CM-8TZXJ5";"T2-CM-599WL9";"-";"Solana (USD)";"40 Jednost.";"87,000";"-";"-";"87,900";"-";"-";"-";"0,00";"-";"-";"-";"-";"-";"-";"-";"-";"-";"-";"-";"-";"-";"-";"-";"-";"-";"-";"-";"-";"-";"-";"-";"-";"-"
"25 Sty 2024 23:35:25";" Transakcja Kupna";"O2-CM-8TZXJ5";"T2-CM-599WL9";"-";"Solana (USD)";"40 Jednost.";"87,000";"-";"-";"-";"-";"4,05168";"14 099,84";"0,00";"-";"-";"-";"-";"-";"-";"-";"-";"-";"-";"-";"-";"-";"-";"-";"-";"-";"-";"-";"-";"-";"-";"-";"-";"-"
"25 Sty 2024 23:05:59";"Stop Loss";"O2-CM-8TZL0P";"T2-CM-599WHW";"-";"Solana (USD)";"50 Jednost.";"86,716";"-";"-";"-";"-";"4,05234";"17 570,13";"-34,65";"10 017,58";"-";"-";"-";"-";"-";"-";"-";"-";"-";"-";"-";"-";"-";"-";"-";"-";"-";"-";"-";"-";"-";"-";"-";"-"
"25 Sty 2024 23:05:16";"Zmodyfikowano Transakcję Sprzedaży";"O2-CM-8TZL0P";"T2-CM-599LJP";"-";"Solana (USD)";"50 Jednost.";"86,545";"-";"86,700";"-";"-";"-";"-";"0,00";"-";"-";"-";"-";"-";"-";"-";"-";"-";"-";"-";"-";"-";"-";"-";"-";"-";"-";"-";"-";"-";"-";"-";"-";"-"
"25 Sty 2024 23:01:30";"Koszty Utrzymania Pozycji";"1300756762";"-";"-";"Rachunek";"-";"-";"-";"-";"-";"-";"-";"-";"4,79";"10 052,23";"-";"-";"-";"-";"-";"4,79";"-";"-";"-";"-";"-";"-";"-";"-";"-";"-";"-";"-";"-";"-";"-";"-";"-";"-"
"25 Sty 2024 23:01:30";"Koszty Utrzymania Pozycji";"O2-CM-8TZL0P";"-";"-";"Solana (USD)";"-";"-";"-";"-";"-";"-";"-";"-";"-";"-";"-";"-";"4 353,50";"-10,00000%";"4,79";"4,79";"-";"-";"-";"-";"-";"-";"-";"-";"-";"-";"-";"-";"-";"-";"-";"-";"-";"-"
"25 Sty 2024 19:42:25";"Transakcja Sprzedaży";"O2-CM-8TZL0P";"T2-CM-599LJP";"-";"Solana (USD)";"50 Jednost.";"86,545";"-";"-";"-";"-";"4,058";"17 559,98";"0,00";"-";"-";"-";"-";"-";"-";"-";"-";"-";"-";"-";"-";"-";"-";"-";"-";"-";"-";"-";"-";"-";"-";"-";"-";"-"
"25 Sty 2024 19:11:50";"Stop Loss";"O2-CM-8TZ6DD";"T2-CM-599JY2";"-";"Solana (USD)";"50 Jednost.";"86,700";"-";"-";"-";"-";"4,01437";"17 577,12";"11,04";"10 047,44";"-";"-";"-";"-";"-";"-";"-";"-";"-";"-";"-";"-";"-";"-";"-";"-";"-";"-";"-";"-";"-";"-";"-";"-"
"25 Sty 2024 19:09:25";" Zmodyfikowano Transakcję Kupna";"O2-CM-8TZ6DD";"T2-CM-599918";"-";"Solana (USD)";"50 Jednost.";"86,645";"-";"86,700";"-";"-";"-";"-";"0,00";"-";"-";"-";"-";"-";"-";"-";"-";"-";"-";"-";"-";"-";"-";"-";"-";"-";"-";"-";"-";"-";"-";"-";"-";"-"
"25 Sty 2024 16:43:35";" Transakcja Kupna";"O2-CM-8TZ6DD";"T2-CM-599918";"-";"Solana (USD)";"50 Jednost.";"86,645";"-";"-";"-";"-";"4,05365";"17 561,42";"0,00";"-";"-";"-";"-";"-";"-";"-";"-";"-";"-";"-";"-";"-";"-";"-";"-";"-";"-";"-";"-";"-";"-";"-";"-";"-"
"25 Sty 2024 15:42:52";"Stop Loss";"O2-CM-8TYJ51";"T2-CM-5991ET";"-";"Solana (USD)";"50 Jednost.";"87,790";"-";"-";"-";"-";"4,01021";"17 779,71";"128,73";"10 036,40";"-";"-";"-";"-";"-";"-";"-";"-";"-";"-";"-";"-";"-";"-";"-";"-";"-";"-";"-";"-";"-";"-";"-";"-"
"25 Sty 2024 15:42:33";" Zmodyfikowano Transakcję Kupna";"O2-CM-8TYJ51";"T2-CM-598N1T";"-";"Solana (USD)";"50 Jednost.";"87,148";"-";"87,800";"-";"-";"-";"-";"0,00";"-";"-";"-";"-";"-";"-";"-";"-";"-";"-";"-";"-";"-";"-";"-";"-";"-";"-";"-";"-";"-";"-";"-";"-";"-"
"25 Sty 2024 13:54:44";" Transakcja Kupna";"O2-CM-8TYJ51";"T2-CM-598N1T";"-";"Solana (USD)";"50 Jednost.";"87,148";"-";"-";"-";"-";"4,03912";"17 600,06";"0,00";"-";"-";"-";"-";"-";"-";"-";"-";"-";"-";"-";"-";"-";"-";"-";"-";"-";"-";"-";"-";"-";"-";"-";"-";"-"
"25 Sty 2024 13:50:34";"Stop Loss";"O2-CM-8TXHSX";"T2-CM-598MX3";"-";"Solana (USD)";"50 Jednost.";"87,100";"-";"-";"-";"-";"4,03917";"17 590,58";"-45,84";"9 907,67";"-";"-";"-";"-";"-";"-";"-";"-";"-";"-";"-";"-";"-";"-";"-";"-";"-";"-";"-";"-";"-";"-";"-";"-"
"25 Sty 2024 13:50:25";"Zmodyfikowano Transakcję Sprzedaży";"O2-CM-8TXHSX";"T2-CM-597Y7N";"-";"Solana (USD)";"50 Jednost.";"86,873";"-";"87,100";"86,350";"-";"-";"-";"0,00";"-";"-";"-";"-";"-";"-";"-";"-";"-";"-";"-";"-";"-";"-";"-";"-";"-";"-";"-";"-";"-";"-";"-";"-";"-"
"25 Sty 2024 00:01:06";"Zmodyfikowano Transakcję Sprzedaży";"O2-CM-8TXHSX";"T2-CM-597Y7N";"-";"Solana (USD)";"50 Jednost.";"86,873";"-";"-";"86,350";"-";"-";"-";"0,00";"-";"-";"-";"-";"-";"-";"-";"-";"-";"-";"-";"-";"-";"-";"-";"-";"-";"-";"-";"-";"-";"-";"-";"-";"-"
"24 Sty 2024 23:12:03";"Transakcja Sprzedaży";"O2-CM-8TXHSX";"T2-CM-597Y7N";"-";"Solana (USD)";"50 Jednost.";"86,873";"-";"-";"-";"-";"4,04499";"17 570,02";"0,00";"-";"-";"-";"-";"-";"-";"-";"-";"-";"-";"-";"-";"-";"-";"-";"-";"-";"-";"-";"-";"-";"-";"-";"-";"-"
"24 Sty 2024 22:28:47";"Stop Loss";"O2-CM-8TXEGE";"T2-CM-597XM1";"-";"Solana (USD)";"51,5 Jednost.";"86,600";"-";"-";"-";"-";"4,00241";"18 029,77";"45,35";"9 953,51";"-";"-";"-";"-";"-";"-";"-";"-";"-";"-";"-";"-";"-";"-";"-";"-";"-";"-";"-";"-";"-";"-";"-";"-"
"24 Sty 2024 22:28:29";" Zmodyfikowano Transakcję Kupna";"O2-CM-8TXEGE";"T2-CM-597VKJ";"-";"Solana (USD)";"51,5 Jednost.";"86,380";"-";"86,600";"-";"-";"-";"-";"0,00";"-";"-";"-";"-";"-";"-";"-";"-";"-";"-";"-";"-";"-";"-";"-";"-";"-";"-";"-";"-";"-";"-";"-";"-";"-"
"24 Sty 2024 21:46:10";" Transakcja Kupna";"O2-CM-8TXEGE";"T2-CM-597VKJ";"-";"Solana (USD)";"51,5 Jednost.";"86,380";"-";"-";"-";"-";"4,04203";"17 981,25";"0,00";"-";"-";"-";"-";"-";"-";"-";"-";"-";"-";"-";"-";"-";"-";"-";"-";"-";"-";"-";"-";"-";"-";"-";"-";"-"
"24 Sty 2024 21:36:14";"Stop Loss";"O2-CM-8TXCPL";"T2-CM-597V6D";"-";"Solana (USD)";"50 Jednost.";"86,601";"-";"-";"-";"-";"4,002";"17 503,05";"58,63";"9 908,16";"-";"-";"-";"-";"-";"-";"-";"-";"-";"-";"-";"-";"-";"-";"-";"-";"-";"-";"-";"-";"-";"-";"-";"-"
"24 Sty 2024 21:35:27";"Zmodyfikowano Transakcję Sprzedaży";"O2-CM-8TXCPL";"T2-CM-597SVN";"-";"Solana (USD)";"50 Jednost.";"86,894";"-";"86,600";"-";"-";"-";"-";"0,00";"-";"-";"-";"-";"-";"-";"-";"-";"-";"-";"-";"-";"-";"-";"-";"-";"-";"-";"-";"-";"-";"-";"-";"-";"-"
"24 Sty 2024 21:14:35";"Transakcja Sprzedaży";"O2-CM-8TXCPL";"T2-CM-597SVN";"-";"Solana (USD)";"50 Jednost.";"86,894";"-";"-";"-";"-";"4,04249";"17 563,40";"0,00";"-";"-";"-";"-";"-";"-";"-";"-";"-";"-";"-";"-";"-";"-";"-";"-";"-";"-";"-";"-";"-";"-";"-";"-";"-"
"24 Sty 2024 21:12:46";"Stop Loss";"O2-CM-8TX4JQ";"T2-CM-597SR1";"-";"Solana (USD)";"50 Jednost.";"86,960";"-";"-";"-";"-";"4,00142";"17 573,00";"90,03";"9 849,53";"-";"-";"-";"-";"-";"-";"-";"-";"-";"-";"-";"-";"-";"-";"-";"-";"-";"-";"-";"-";"-";"-";"-";"-"
"24 Sty 2024 21:12:33";" Zmodyfikowano Transakcję Kupna";"O2-CM-8TX4JQ";"T2-CM-597LJ4";"-";"Solana (USD)";"50 Jednost.";"86,510";"-";"86,960";"-";"-";"-";"-";"0,00";"-";"-";"-";"-";"-";"-";"-";"-";"-";"-";"-";"-";"-";"-";"-";"-";"-";"-";"-";"-";"-";"-";"-";"-";"-"
"24 Sty 2024 19:17:47";" Transakcja Kupna";"O2-CM-8TX4JQ";"T2-CM-597LJ4";"-";"Solana (USD)";"50 Jednost.";"86,510";"-";"-";"-";"-";"4,04154";"17 481,68";"0,00";"-";"-";"-";"-";"-";"-";"-";"-";"-";"-";"-";"-";"-";"-";"-";"-";"-";"-";"-";"-";"-";"-";"-";"-";"-"
"24 Sty 2024 19:15:23";"Stop Loss";"O2-CM-8TWX00";"T2-CM-597L9X";"-";"Solana (USD)";"50 Jednost.";"86,501";"-";"-";"-";"-";"4,00145";"17 480,38";"32,81";"9 759,50";"-";"-";"-";"-";"-";"-";"-";"-";"-";"-";"-";"-";"-";"-";"-";"-";"-";"-";"-";"-";"-";"-";"-";"-"
"24 Sty 2024 19:15:01";"Zmodyfikowano Transakcję Sprzedaży";"O2-CM-8TWX00";"T2-CM-597DX9";"-";"Solana (USD)";"50 Jednost.";"86,665";"-";"86,500";"-";"-";"-";"-";"0,00";"-";"-";"-";"-";"-";"-";"-";"-";"-";"-";"-";"-";"-";"-";"-";"-";"-";"-";"-";"-";"-";"-";"-";"-";"-"
"24 Sty 2024 17:28:06";"Transakcja Sprzedaży";"O2-CM-8TWX00";"T2-CM-597DX9";"-";"Solana (USD)";"50 Jednost.";"86,665";"-";"-";"-";"-";"4,04108";"17 511,00";"0,00";"-";"-";"-";"-";"-";"-";"-";"-";"-";"-";"-";"-";"-";"-";"-";"-";"-";"-";"-";"-";"-";"-";"-";"-";"-"
"24 Sty 2024 17:24:57";"Stop Loss";"O2-CM-8TWW2G";"T2-CM-597DRH";"-";"Solana (USD)";"50 Jednost.";"86,600";"-";"-";"-";"-";"4,00176";"17 501,81";"22,01";"9 726,69";"-";"-";"-";"-";"-";"-";"-";"-";"-";"-";"-";"-";"-";"-";"-";"-";"-";"-";"-";"-";"-";"-";"-";"-"
"24 Sty 2024 17:24:44";" Zmodyfikowano Transakcję Kupna";"O2-CM-8TWW2G";"T2-CM-597D4D";"-";"Solana (USD)";"50 Jednost.";"86,490";"-";"86,600";"-";"-";"-";"-";"0,00";"-";"-";"-";"-";"-";"-";"-";"-";"-";"-";"-";"-";"-";"-";"-";"-";"-";"-";"-";"-";"-";"-";"-";"-";"-"
"24 Sty 2024 17:17:10";" Transakcja Kupna";"O2-CM-8TWW2G";"T2-CM-597D4D";"-";"Solana (USD)";"50 Jednost.";"86,490";"-";"-";"-";"-";"4,04248";"17 481,70";"0,00";"-";"-";"-";"-";"-";"-";"-";"-";"-";"-";"-";"-";"-";"-";"-";"-";"-";"-";"-";"-";"-";"-";"-";"-";"-"
"24 Sty 2024 16:51:48";"Stop Loss";"O2-CM-8TWC23";"T2-CM-597B0M";"-";"Solana (USD)";"50 Jednost.";"87,043";"-";"-";"-";"-";"3,99587";"17 565,45";"28,37";"9 704,68";"-";"-";"-";"-";"-";"-";"-";"-";"-";"-";"-";"-";"-";"-";"-";"-";"-";"-";"-";"-";"-";"-";"-";"-"
"24 Sty 2024 16:51:05";" Zmodyfikowano Transakcję Kupna";"O2-CM-8TWC23";"T2-CM-5975LD";"-";"Solana (USD)";"50 Jednost.";"86,901";"-";"87,050";"-";"-";"-";"-";"0,00";"-";"-";"-";"-";"-";"-";"-";"-";"-";"-";"-";"-";"-";"-";"-";"-";"-";"-";"-";"-";"-";"-";"-";"-";"-"
"24 Sty 2024 16:15:06";" Transakcja Kupna";"O2-CM-8TWC23";"T2-CM-5975LD";"-";"Solana (USD)";"50 Jednost.";"86,901";"-";"-";"-";"-";"4,0344";"17 529,66";"0,00";"-";"-";"-";"-";"-";"-";"-";"-";"-";"-";"-";"-";"-";"-";"-";"-";"-";"-";"-";"-";"-";"-";"-";"-";"-"
"23 Sty 2024 00:35:29";" Zamknięcie Transakcji";"O2-CM-8TRK63";"T2-CM-5949ED";"O2-CM-8TRJYG";"Solana (USD)";"50 Jednost.";"83,690";"-";"-";"-";"-";"3,98918";"16 860,48";"10,97";"9 676,31";"-";"-";"-";"-";"-";"-";"-";"-";"-";"-";"-";"-";"-";"-";"-";"-";"-";"-";"-";"-";"-";"-";"-";"-"
"23 Sty 2024 00:31:04";" Zmodyfikowano Transakcję Kupna";"O2-CM-8TRJYG";"T2-CM-59498H";"-";"Solana (USD)";"50 Jednost.";"83,635";"-";"-";"83,800";"-";"-";"-";"0,00";"-";"-";"-";"-";"-";"-";"-";"-";"-";"-";"-";"-";"-";"-";"-";"-";"-";"-";"-";"-";"-";"-";"-";"-";"-"
"23 Sty 2024 00:24:42";" Transakcja Kupna";"O2-CM-8TRJYG";"T2-CM-59498H";"-";"Solana (USD)";"50 Jednost.";"83,635";"-";"-";"-";"-";"4,02958";"16 850,69";"0,00";"-";"-";"-";"-";"-";"-";"-";"-";"-";"-";"-";"-";"-";"-";"-";"-";"-";"-";"-";"-";"-";"-";"-";"-";"-"
"23 Sty 2024 00:09:29";"Stop Loss";"O2-CM-8TRJ2M";"T2-CM-59491S";"-";"Solana (USD)";"50 Jednost.";"83,850";"-";"-";"-";"-";"3,98893";"16 891,66";"10,17";"9 665,34";"-";"-";"-";"-";"-";"-";"-";"-";"-";"-";"-";"-";"-";"-";"-";"-";"-";"-";"-";"-";"-";"-";"-";"-"
"23 Sty 2024 00:09:26";"Zmodyfikowano Transakcję Sprzedaży";"O2-CM-8TRJ2M";"T2-CM-5948PG";"-";"Solana (USD)";"50 Jednost.";"83,901";"-";"83,850";"83,000";"-";"-";"-";"0,00";"-";"-";"-";"-";"-";"-";"-";"-";"-";"-";"-";"-";"-";"-";"-";"-";"-";"-";"-";"-";"-";"-";"-";"-";"-"
"22 Sty 2024 23:51:49";"Zmodyfikowano Take Profit";"O2-CM-8TRJ2M";"-";"O2-CM-8TRJCM";"Solana (USD)";"50 Jednost.";"83,901";"-";"-";"83,000";"-";"-";"-";"-";"-";"-";"-";"-";"-";"-";"-";"-";"-";"-";"-";"-";"-";"-";"-";"-";"-";"-";"-";"-";"-";"-";"-";"-";"-"
"22 Sty 2024 23:50:39";"Zmodyfikowano Transakcję Sprzedaży";"O2-CM-8TRJ2M";"T2-CM-5948PG";"-";"Solana (USD)";"50 Jednost.";"83,901";"-";"-";"83,600";"-";"-";"-";"0,00";"-";"-";"-";"-";"-";"-";"-";"-";"-";"-";"-";"-";"-";"-";"-";"-";"-";"-";"-";"-";"-";"-";"-";"-";"-"
"22 Sty 2024 23:03:34";"Transakcja Sprzedaży";"O2-CM-8TRJ2M";"T2-CM-5948PG";"-";"Solana (USD)";"50 Jednost.";"83,901";"-";"-";"-";"-";"4,02815";"16 898,29";"0,00";"-";"-";"-";"-";"-";"-";"-";"-";"-";"-";"-";"-";"-";"-";"-";"-";"-";"-";"-";"-";"-";"-";"-";"-";"-"
"22 Sty 2024 22:41:41";"Stop Loss";"O2-CM-8TRGY2";"T2-CM-5948E7";"-";"Solana (USD)";"40 Jednost.";"84,510";"-";"-";"-";"-";"3,98904";"13 620,07";"177,91";"9 655,17";"-";"-";"-";"-";"-";"-";"-";"-";"-";"-";"-";"-";"-";"-";"-";"-";"-";"-";"-";"-";"-";"-";"-";"-"
"22 Sty 2024 22:41:33";"Zmodyfikowano Stop Loss";"O2-CM-8TRGY2";"-";"O2-CM-8TRHQ5";"Solana (USD)";"40 Jednost.";"85,625";"-";"84,500";"-";"-";"-";"-";"-";"-";"-";"-";"-";"-";"-";"-";"-";"-";"-";"-";"-";"-";"-";"-";"-";"-";"-";"-";"-";"-";"-";"-";"-";"-"
"22 Sty 2024 22:37:21";"Zmodyfikowano Transakcję Sprzedaży";"O2-CM-8TRGY2";"T2-CM-5947SW";"-";"Solana (USD)";"40 Jednost.";"85,625";"-";"84,900";"-";"-";"-";"-";"0,00";"-";"-";"-";"-";"-";"-";"-";"-";"-";"-";"-";"-";"-";"-";"-";"-";"-";"-";"-";"-";"-";"-";"-";"-";"-"
"22 Sty 2024 21:52:11";"Transakcja Sprzedaży";"O2-CM-8TRGY2";"T2-CM-5947SW";"-";"Solana (USD)";"40 Jednost.";"85,625";"-";"-";"-";"-";"4,02919";"13 799,97";"0,00";"-";"-";"-";"-";"-";"-";"-";"-";"-";"-";"-";"-";"-";"-";"-";"-";"-";"-";"-";"-";"-";"-";"-";"-";"-"
"22 Sty 2024 21:28:42";"Stop Loss";"O2-CM-8TRDVZ";"T2-CM-59475K";"-";"Solana (USD)";"45 Jednost.";"85,698";"-";"-";"-";"-";"3,98853";"15 535,97";"191,69";"9 477,26";"-";"-";"-";"-";"-";"-";"-";"-";"-";"-";"-";"-";"-";"-";"-";"-";"-";"-";"-";"-";"-";"-";"-";"-"
"22 Sty 2024 21:28:18";"Zmodyfikowano Stop Loss";"O2-CM-8TRDVZ";"-";"O2-CM-8TRFYB";"Solana (USD)";"45 Jednost.";"84,630";"-";"85,700";"-";"-";"-";"-";"-";"-";"-";"-";"-";"-";"-";"-";"-";"-";"-";"-";"-";"-";"-";"-";"-";"-";"-";"-";"-";"-";"-";"-";"-";"-"
"22 Sty 2024 21:26:11";"Zmodyfikowano Stop Loss";"O2-CM-8TRDVZ";"-";"O2-CM-8TRFYB";"Solana (USD)";"45 Jednost.";"84,630";"-";"85,600";"-";"-";"-";"-";"-";"-";"-";"-";"-";"-";"-";"-";"-";"-";"-";"-";"-";"-";"-";"-";"-";"-";"-";"-";"-";"-";"-";"-";"-";"-"
"22 Sty 2024 21:25:32";"Zmodyfikowano Stop Loss";"O2-CM-8TRDVZ";"-";"O2-CM-8TRFYB";"Solana (USD)";"45 Jednost.";"84,630";"-";"85,400";"-";"-";"-";"-";"-";"-";"-";"-";"-";"-";"-";"-";"-";"-";"-";"-";"-";"-";"-";"-";"-";"-";"-";"-";"-";"-";"-";"-";"-";"-"
"22 Sty 2024 21:24:37";"Zmodyfikowano Take Profit";"O2-CM-8TRDVZ";"-";"O2-CM-8TRDYQ";"Solana (USD)";"45 Jednost.";"84,630";"-";"-";"87,200";"-";"-";"-";"-";"-";"-";"-";"-";"-";"-";"-";"-";"-";"-";"-";"-";"-";"-";"-";"-";"-";"-";"-";"-";"-";"-";"-";"-";"-"
"22 Sty 2024 21:24:08";"Zmodyfikowano Stop Loss";"O2-CM-8TRDVZ";"-";"O2-CM-8TRFYB";"Solana (USD)";"45 Jednost.";"84,630";"-";"85,200";"-";"-";"-";"-";"-";"-";"-";"-";"-";"-";"-";"-";"-";"-";"-";"-";"-";"-";"-";"-";"-";"-";"-";"-";"-";"-";"-";"-";"-";"-"
"22 Sty 2024 21:23:40";"Zmodyfikowano Stop Loss";"O2-CM-8TRDVZ";"-";"O2-CM-8TRFYB";"Solana (USD)";"45 Jednost.";"84,630";"-";"85,000";"-";"-";"-";"-";"-";"-";"-";"-";"-";"-";"-";"-";"-";"-";"-";"-";"-";"-";"-";"-";"-";"-";"-";"-";"-";"-";"-";"-";"-";"-"
"22 Sty 2024 21:21:40";"Zmodyfikowano Stop Loss";"O2-CM-8TRDVZ";"-";"O2-CM-8TRFYB";"Solana (USD)";"45 Jednost.";"84,630";"-";"84,800";"-";"-";"-";"-";"-";"-";"-";"-";"-";"-";"-";"-";"-";"-";"-";"-";"-";"-";"-";"-";"-";"-";"-";"-";"-";"-";"-";"-";"-";"-"
"22 Sty 2024 21:18:34";" Zmodyfikowano Transakcję Kupna";"O2-CM-8TRDVZ";"T2-CM-59452X";"-";"Solana (USD)";"45 Jednost.";"84,630";"-";"84,700";"86,200";"-";"-";"-";"0,00";"-";"-";"-";"-";"-";"-";"-";"-";"-";"-";"-";"-";"-";"-";"-";"-";"-";"-";"-";"-";"-";"-";"-";"-";"-"
"22 Sty 2024 20:18:59";" Zmodyfikowano Transakcję Kupna";"O2-CM-8TRDVZ";"T2-CM-59452X";"-";"Solana (USD)";"45 Jednost.";"84,630";"-";"-";"86,200";"-";"-";"-";"0,00";"-";"-";"-";"-";"-";"-";"-";"-";"-";"-";"-";"-";"-";"-";"-";"-";"-";"-";"-";"-";"-";"-";"-";"-";"-"
"22 Sty 2024 20:17:07";" Transakcja Kupna";"O2-CM-8TRDVZ";"T2-CM-59452X";"-";"Solana (USD)";"45 Jednost.";"84,630";"-";"-";"-";"-";"4,02861";"15 342,35";"0,00";"-";"-";"-";"-";"-";"-";"-";"-";"-";"-";"-";"-";"-";"-";"-";"-";"-";"-";"-";"-";"-";"-";"-";"-";"-"
"22 Sty 2024 19:36:16";"Aktywowano";"-";"-";"-";" Akcja polska Notowania";"-";"-";"-";"-";"-";"-";"-";"-";"-";"-";"-";"-";"-";"-";"-";"-";"-";"-";"-";"-";"-";"-";"-";"-";"-";"-";"-";"-";"-";"-";"-";"-";"-";"-"
"22 Sty 2024 19:35:19";"Aktywowano";"-";"-";"-";" Akcja USA Notowania";"-";"-";"-";"-";"-";"-";"-";"-";"-";"-";"-";"-";"-";"-";"-";"-";"-";"-";"-";"-";"-";"-";"-";"-";"-";"-";"-";"-";"-";"-";"-";"-";"-";"-"
"22 Sty 2024 16:56:36";"Stop Loss";"O2-CL-8TLSLT";"T2-CM-593W6C";"-";"Bitcoin (USD)";"0,095 Jednost.";"40 645,580";"-";"-";"-";"-";"4,02879";"15 556,48";"-671,00";"9 285,57";"-";"-";"-";"-";"-";"-";"-";"-";"-";"-";"-";"-";"-";"-";"-";"-";"-";"-";"-";"-";"-";"-";"-";"-"
"22 Sty 2024 16:54:26";"Zmodyfikowano Take Profit";"O2-CL-8TLSLT";"-";"O2-CM-8TR1R9";"Bitcoin (USD)";"0,095 Jednost.";"42 398,755";"-";"-";"40 900,000";"-";"-";"-";"-";"-";"-";"-";"-";"-";"-";"-";"-";"-";"-";"-";"-";"-";"-";"-";"-";"-";"-";"-";"-";"-";"-";"-";"-";"-"
"22 Sty 2024 16:53:54";"Zmodyfikowano Stop Loss";"O2-CL-8TLSLT";"-";"O2-CM-8TR1R8";"Bitcoin (USD)";"0,095 Jednost.";"42 398,755";"-";"40 650,000";"-";"-";"-";"-";"-";"-";"-";"-";"-";"-";"-";"-";"-";"-";"-";"-";"-";"-";"-";"-";"-";"-";"-";"-";"-";"-";"-";"-";"-";"-"
"22 Sty 2024 16:52:30";"Zmodyfikowano Take Profit";"O2-CL-8TLSLT";"-";"O2-CM-8TR1R9";"Bitcoin (USD)";"0,095 Jednost.";"42 398,755";"-";"-";"40 850,000";"-";"-";"-";"-";"-";"-";"-";"-";"-";"-";"-";"-";"-";"-";"-";"-";"-";"-";"-";"-";"-";"-";"-";"-";"-";"-";"-";"-";"-"
"22 Sty 2024 16:51:59";"Zmodyfikowano Stop Loss";"O2-CL-8TLSLT";"-";"O2-CM-8TR1R8";"Bitcoin (USD)";"0,095 Jednost.";"42 398,755";"-";"40 600,000";"-";"-";"-";"-";"-";"-";"-";"-";"-";"-";"-";"-";"-";"-";"-";"-";"-";"-";"-";"-";"-";"-";"-";"-";"-";"-";"-";"-";"-";"-"
"22 Sty 2024 16:47:35";" Zmodyfikowano Transakcję Kupna";"O2-CL-8TLSLT";"T2-CL-5907H7";"-";"Bitcoin (USD)";"0,095 Jednost.";"42 398,755";"-";"40 550,000";"40 800,000";"-";"-";"-";"0,00";"-";"-";"-";"-";"-";"-";"-";"-";"-";"-";"-";"-";"-";"-";"-";"-";"-";"-";"-";"-";"-";"-";"-";"-";"-"
"19 Sty 2024 23:01:14";"Koszty Utrzymania Pozycji";"1298707766";"-";"-";"Rachunek";"-";"-";"-";"-";"-";"-";"-";"-";"-45,61";"9 956,57";"-";"-";"-";"-";"-";"-45,61";"-";"-";"-";"-";"-";"-";"-";"-";"-";"-";"-";"-";"-";"-";"-";"-";"-";"-"
"19 Sty 2024 23:01:14";"Koszty Utrzymania Pozycji";"O2-CL-8TLSLT";"-";"-";"Bitcoin (USD)";"-";"-";"-";"-";"-";"-";"-";"-";"-";"-";"-";"-";"3 948,78";"-35,00000%";"-45,61";"-45,61";"-";"-";"-";"-";"-";"-";"-";"-";"-";"-";"-";"-";"-";"-";"-";"-";"-";"-"
"18 Sty 2024 23:01:21";"Koszty Utrzymania Pozycji";"1298193519";"-";"-";"Rachunek";"-";"-";"-";"-";"-";"-";"-";"-";"-15,17";"10 002,18";"-";"-";"-";"-";"-";"-15,17";"-";"-";"-";"-";"-";"-";"-";"-";"-";"-";"-";"-";"-";"-";"-";"-";"-";"-"
"18 Sty 2024 23:01:21";"Koszty Utrzymania Pozycji";"O2-CL-8TLSLT";"-";"-";"Bitcoin (USD)";"-";"-";"-";"-";"-";"-";"-";"-";"-";"-";"-";"-";"3 901,71";"-35,00000%";"-15,17";"-15,17";"-";"-";"-";"-";"-";"-";"-";"-";"-";"-";"-";"-";"-";"-";"-";"-";"-";"-"
"18 Sty 2024 17:35:03";" Transakcja Kupna";"O2-CL-8TLSLT";"T2-CL-5907H7";"-";"Bitcoin (USD)";"0,095 Jednost.";"42 398,755";"-";"-";"-";"-";"4,06328";"16 366,41";"0,00";"-";"-";"-";"-";"-";"-";"-";"-";"-";"-";"-";"-";"-";"-";"-";"-";"-";"-";"-";"-";"-";"-";"-";"-";"-"
"18 Sty 2024 14:57:16";"Stop Loss";"O2-CL-8TKY1Y";"T2-CL-58ZSDE";"-";"Bitcoin (USD)";"0,095 Jednost.";"42 499,000";"-";"-";"-";"-";"4,03833";"16 468,25";"17,35";"10 017,35";"-";"-";"-";"-";"-";"-";"-";"-";"-";"-";"-";"-";"-";"-";"-";"-";"-";"-";"-";"-";"-";"-";"-";"-"
"18 Sty 2024 14:55:31";" Zmodyfikowano Transakcję Kupna";"O2-CL-8TKY1Y";"T2-CL-58ZG76";"-";"Bitcoin (USD)";"0,095 Jednost.";"42 453,775";"-";"42 500,000";"-";"-";"-";"-";"0,00";"-";"-";"-";"-";"-";"-";"-";"-";"-";"-";"-";"-";"-";"-";"-";"-";"-";"-";"-";"-";"-";"-";"-";"-";"-"
"18 Sty 2024 11:57:39";" Transakcja Kupna";"O2-CL-8TKY1Y";"T2-CL-58ZG76";"-";"Bitcoin (USD)";"0,095 Jednost.";"42 453,775";"-";"-";"-";"-";"4,06302";"16 386,60";"0,00";"-";"-";"-";"-";"-";"-";"-";"-";"-";"-";"-";"-";"-";"-";"-";"-";"-";"-";"-";"-";"-";"-";"-";"-";"-"
"17 Sty 2024 15:58:51";" Wpłata";"1297558016";"BD.33614782";"-";"Rachunek";"-";"-";"-";"-";"-";"-";"-";"-";"9 900,00";"10 000,00";"9 900,00";"0,00";"-";"-";"-";"-";"-";"-";"-";"-";"-";"-";"-";"-";"-";"-";"-";"-";"-";"-";"-";"-";"-";"-"
"16 Sty 2024 11:32:53";" Wpłata";"1296968409";"BD.29390876";"-";"Rachunek";"-";"-";"-";"-";"-";"-";"-";"-";"100,00";"100,00";"100,00";"0,00";"-";"-";"-";"-";"-";"-";"-";"-";"-";"-";"-";"-";"-";"-";"-";"-";"-";"-";"-";"-";"-";"-"